date,geography,geography code,Sex: All persons; measures: Value,Sex: Female; measures: Value,Sex: Male; measures: Value
2021,Bolton 001A,E01004768,1595,789,806
2021,Bolton 001B,E01004803,1620,839,781
2021,Bolton 001C,E01004804,1468,755,713
2021,Bolton 001D,E01004807,1377,677,700
2021,Bolton 001E,E01004808,1618,826,792
2021,Bolton 002A,E01004788,1356,697,659
2021,Bolton 002B,E01004790,1418,744,674
2021,Bolton 002C,E01004805,1565,805,760
2021,Bolton 002D,E01004806,1517,806,711
2021,Bolton 002E,E01004810,1557,805,752
2021,Bolton 003A,E01004769,1503,776,727
2021,Bolton 003B,E01004770,1521,785,736
2021,Bolton 003C,E01004771,1685,856,829
2021,Bolton 003D,E01004773,1965,990,975
2021,Bolton 003E,E01004809,1723,917,806
2021,Bolton 004A,E01004777,1723,914,809
2021,Bolton 004B,E01004881,1482,781,701
2021,Bolton 004C,E01004888,1281,631,650
2021,Bolton 004D,E01004889,1432,754,678
2021,Bolton 004E,E01004890,1381,698,683
2021,Bolton 005A,E01004766,1658,802,856
2021,Bolton 005B,E01004767,1887,928,959
2021,Bolton 005C,E01004772,1846,991,855
2021,Bolton 005D,E01004774,1765,892,873
2021,Bolton 005E,E01004824,1884,947,937
2021,Bolton 006A,E01004784,1193,585,608
2021,Bolton 006B,E01004785,1523,780,743
2021,Bolton 006C,E01004786,1450,769,681
2021,Bolton 006D,E01004789,1452,770,682
2021,Bolton 006E,E01004791,1323,699,624
2021,Bolton 006F,E01004792,1409,738,671
2021,Bolton 007A,E01004779,1631,805,826
2021,Bolton 007B,E01004781,2134,1067,1067
2021,Bolton 007C,E01004882,1350,677,673
2021,Bolton 007D,E01004883,1760,902,858
2021,Bolton 007E,E01004884,1476,767,709
2021,Bolton 008A,E01004864,1464,744,720
2021,Bolton 008B,E01004867,1551,804,747
2021,Bolton 008C,E01004921,1633,850,783
2021,Bolton 008D,E01004924,1575,803,772
2021,Bolton 008E,E01004925,1590,802,788
2021,Bolton 009A,E01004778,1190,619,571
2021,Bolton 009B,E01004780,2288,1145,1143
2021,Bolton 009C,E01004782,1348,717,631
2021,Bolton 009D,E01004783,1477,762,715
2021,Bolton 010A,E01004802,1973,1020,953
2021,Bolton 010B,E01004926,1432,768,664
2021,Bolton 010C,E01004927,2301,1186,1115
2021,Bolton 010D,E01004929,2728,1399,1329
2021,Bolton 011A,E01004820,1790,911,879
2021,Bolton 011B,E01004825,1971,972,999
2021,Bolton 011C,E01004826,1667,833,834
2021,Bolton 011D,E01004865,1581,794,787
2021,Bolton 011E,E01004866,2038,967,1071
2021,Bolton 012A,E01004840,1736,881,855
2021,Bolton 012B,E01004841,1746,891,855
2021,Bolton 012C,E01004842,1713,890,823
2021,Bolton 012D,E01004919,1509,764,745
2021,Bolton 012E,E01004920,1641,846,795
2021,Bolton 013A,E01004787,1708,888,820
2021,Bolton 013B,E01004793,1749,947,802
2021,Bolton 013C,E01004794,2122,1060,1062
2021,Bolton 013D,E01004795,1504,785,719
2021,Bolton 013E,E01004797,1492,759,733
2021,Bolton 014A,E01004775,2326,1176,1150
2021,Bolton 014B,E01004885,1425,720,705
2021,Bolton 014C,E01004886,1397,717,680
2021,Bolton 014D,E01004887,1327,710,617
2021,Bolton 015A,E01004868,2163,1040,1123
2021,Bolton 015B,E01004869,2188,1129,1059
2021,Bolton 015C,E01004870,2015,888,1127
2021,Bolton 015D,E01004871,1814,890,924
2021,Bolton 015E,E01004922,2254,1153,1101
2021,Bolton 016B,E01004822,1851,947,904
2021,Bolton 016C,E01004823,2047,1011,1036
2021,Bolton 016D,E01004848,2090,988,1102
2021,Bolton 016E,E01033217,1228,569,659
2021,Bolton 016F,E01033220,1314,595,719
2021,Bolton 017A,E01004818,1722,779,943
2021,Bolton 017B,E01004819,1518,745,773
2021,Bolton 017C,E01004928,1378,713,665
2021,Bolton 017D,E01004930,1514,776,738
2021,Bolton 017E,E01004931,1564,781,783
2021,Bolton 017F,E01004932,1482,726,756
2021,Bolton 018A,E01004834,1745,827,918
2021,Bolton 018B,E01004838,2008,1034,974
2021,Bolton 018C,E01004843,1558,808,750
2021,Bolton 018D,E01004845,1872,956,916
2021,Bolton 018E,E01004923,1675,838,837
2021,Bolton 019A,E01004796,1576,774,802
2021,Bolton 019B,E01004798,1613,857,756
2021,Bolton 019C,E01004799,1271,648,623
2021,Bolton 019D,E01004800,1295,646,649
2021,Bolton 019E,E01004801,1674,875,799
2021,Bolton 019F,E01004917,2298,1170,1128
2021,Bolton 020A,E01004835,1461,731,730
2021,Bolton 020B,E01004836,1746,900,846
2021,Bolton 020C,E01004837,1561,769,792
2021,Bolton 020D,E01004844,1573,821,752
2021,Bolton 020E,E01004897,1013,515,498
2021,Bolton 021A,E01004827,1990,977,1013
2021,Bolton 021B,E01004849,1794,930,864
2021,Bolton 021C,E01004850,2293,1040,1253
2021,Bolton 021D,E01004851,1691,842,849
2021,Bolton 021E,E01004853,1575,775,800
2021,Bolton 022A,E01004811,1845,956,889
2021,Bolton 022B,E01004812,2402,1204,1198
2021,Bolton 022C,E01004813,1748,906,842
2021,Bolton 022D,E01004815,1786,896,890
2021,Bolton 022E,E01004817,2064,989,1075
2021,Bolton 023A,E01004828,2017,1023,994
2021,Bolton 023B,E01004829,1458,741,717
2021,Bolton 023C,E01004832,1641,838,803
2021,Bolton 023D,E01004854,1658,845,813
2021,Bolton 023E,E01004878,1697,859,838
2021,Bolton 024A,E01004911,1539,786,753
2021,Bolton 024B,E01004912,1435,738,697
2021,Bolton 024C,E01004913,1955,991,964
2021,Bolton 024D,E01004914,1170,606,564
2021,Bolton 024E,E01004915,1274,647,627
2021,Bolton 024F,E01004916,1467,773,694
2021,Bolton 024G,E01004918,1225,616,609
2021,Bolton 025A,E01004846,1410,695,715
2021,Bolton 025B,E01004847,2282,1213,1069
2021,Bolton 025C,E01004852,1734,847,887
2021,Bolton 025D,E01004877,2074,1072,1002
2021,Bolton 025E,E01004879,1657,859,798
2021,Bolton 026A,E01004830,1754,913,841
2021,Bolton 026B,E01004831,1829,890,939
2021,Bolton 026C,E01004833,1530,760,770
2021,Bolton 026D,E01004839,2370,1213,1157
2021,Bolton 027A,E01004814,1604,810,794
2021,Bolton 027B,E01004855,1479,746,733
2021,Bolton 027C,E01004856,1537,775,762
2021,Bolton 027D,E01004857,1902,951,951
2021,Bolton 028A,E01004891,1540,807,733
2021,Bolton 028B,E01004893,1524,728,796
2021,Bolton 028C,E01004894,1925,969,956
2021,Bolton 028E,E01004901,1764,878,886
2021,Bolton 028F,E01033218,1571,811,760
2021,Bolton 028G,E01033219,1421,715,706
2021,Bolton 029A,E01004816,2939,1453,1486
2021,Bolton 029B,E01004872,1694,884,810
2021,Bolton 029C,E01004873,2021,1048,973
2021,Bolton 029D,E01004875,1669,856,813
2021,Bolton 029E,E01004880,1479,733,746
2021,Bolton 030A,E01004892,1580,823,757
2021,Bolton 030B,E01004896,1315,673,642
2021,Bolton 030C,E01004899,1596,809,787
2021,Bolton 030D,E01004900,1615,840,775
2021,Bolton 031A,E01004776,1822,906,916
2021,Bolton 031B,E01004895,1326,705,621
2021,Bolton 031C,E01004936,2170,1081,1089
2021,Bolton 031D,E01004938,1548,787,761
2021,Bolton 031E,E01004939,1599,796,803
2021,Bolton 032A,E01004858,1586,807,779
2021,Bolton 032B,E01004859,1506,767,739
2021,Bolton 032C,E01004860,1470,765,705
2021,Bolton 032D,E01004902,1847,955,892
2021,Bolton 032E,E01004906,1795,896,899
2021,Bolton 033A,E01004861,1962,1017,945
2021,Bolton 033B,E01004862,1436,732,704
2021,Bolton 033C,E01004863,1586,798,788
2021,Bolton 033D,E01004874,1755,905,850
2021,Bolton 033E,E01004876,1966,988,978
2021,Bolton 034A,E01004903,1445,734,711
2021,Bolton 034B,E01004904,1678,850,828
2021,Bolton 034C,E01004905,1596,812,784
2021,Bolton 034D,E01004907,1310,696,614
2021,Bolton 034E,E01004908,1297,673,624
2021,Bolton 034F,E01004909,1397,746,651
2021,Bolton 034G,E01004910,2051,1035,1016
2021,Bolton 035A,E01004933,1314,649,665
2021,Bolton 035B,E01004934,1442,728,714
2021,Bolton 035C,E01004935,1838,949,889
2021,Bolton 035D,E01004937,1637,800,837
2021,Bolton 035E,E01004940,1431,729,702
2021,Bury 001A,E01005014,1465,725,740
2021,Bury 001B,E01005015,1494,816,678
2021,Bury 001C,E01005016,1494,754,740
2021,Bury 001D,E01005017,1835,939,896
2021,Bury 001E,E01005018,1534,805,729
2021,Bury 001F,E01005021,1218,531,687
2021,Bury 002A,E01005019,1502,784,718
2021,Bury 002B,E01005023,1278,684,594
2021,Bury 002C,E01005046,1478,779,699
2021,Bury 002D,E01005048,1657,848,809
2021,Bury 003A,E01005020,1361,691,670
2021,Bury 003B,E01005022,1497,747,750
2021,Bury 003C,E01005047,1474,771,703
2021,Bury 003D,E01005049,1645,835,810
2021,Bury 003E,E01005051,1524,772,752
2021,Bury 004A,E01004976,1546,803,743
2021,Bury 004B,E01004977,1708,891,817
2021,Bury 004C,E01004978,1857,922,935
2021,Bury 004D,E01004981,1472,751,721
2021,Bury 004E,E01004982,1488,774,714
2021,Bury 005A,E01004961,1450,752,698
2021,Bury 005B,E01004965,1238,604,634
2021,Bury 005C,E01004966,1816,944,872
2021,Bury 005D,E01004967,1191,608,583
2021,Bury 006A,E01004963,1478,767,711
2021,Bury 006B,E01004968,1485,772,713
2021,Bury 006C,E01005050,2124,1123,1001
2021,Bury 006D,E01005052,1444,722,722
2021,Bury 006E,E01005053,1527,771,756
2021,Bury 007A,E01004954,1450,762,688
2021,Bury 007B,E01004955,1357,691,666
2021,Bury 007C,E01004956,1776,929,847
2021,Bury 007D,E01004957,1899,982,917
2021,Bury 007E,E01004960,1670,849,821
2021,Bury 008A,E01004958,1510,774,736
2021,Bury 008B,E01004959,1734,880,854
2021,Bury 008C,E01004979,1812,897,915
2021,Bury 008D,E01004980,1454,709,745
2021,Bury 008E,E01005024,2649,1290,1359
2021,Bury 008F,E01005026,2192,1077,1115
2021,Bury 009A,E01004947,1546,818,728
2021,Bury 009B,E01004948,1871,926,945
2021,Bury 009C,E01004962,2011,1006,1005
2021,Bury 009D,E01004964,1852,944,908
2021,Bury 010A,E01004949,1413,723,690
2021,Bury 010B,E01004950,1488,741,747
2021,Bury 010C,E01004951,1563,809,754
2021,Bury 010D,E01004952,1336,690,646
2021,Bury 010E,E01004953,1533,790,743
2021,Bury 011A,E01005025,1697,857,840
2021,Bury 011B,E01005027,1862,906,956
2021,Bury 011C,E01005028,2235,1143,1092
2021,Bury 011D,E01005029,1985,1010,975
2021,Bury 012A,E01005000,1471,756,715
2021,Bury 012B,E01005001,1278,638,640
2021,Bury 012C,E01005005,1409,747,662
2021,Bury 012D,E01005006,2022,1037,985
2021,Bury 013A,E01005030,1787,908,879
2021,Bury 013B,E01005054,1571,810,761
2021,Bury 013C,E01005059,1786,911,875
2021,Bury 013D,E01005060,1734,880,854
2021,Bury 014A,E01004997,1550,792,758
2021,Bury 014B,E01004998,1656,847,809
2021,Bury 014C,E01004999,1477,770,707
2021,Bury 014D,E01005002,1507,763,744
2021,Bury 014E,E01005003,1485,766,719
2021,Bury 015A,E01004991,1382,721,661
2021,Bury 015B,E01004992,1427,730,697
2021,Bury 015C,E01004993,1988,1002,986
2021,Bury 015D,E01004994,1383,700,683
2021,Bury 016A,E01004990,1586,833,753
2021,Bury 016B,E01004996,1511,739,772
2021,Bury 016C,E01005004,1579,786,793
2021,Bury 016D,E01005008,2172,1127,1045
2021,Bury 016E,E01005009,1766,842,924
2021,Bury 017A,E01004945,1534,789,745
2021,Bury 017B,E01005055,1448,730,718
2021,Bury 017C,E01005056,1272,640,632
2021,Bury 017D,E01005057,1618,843,775
2021,Bury 017E,E01005058,1347,683,664
2021,Bury 018A,E01004995,1501,769,732
2021,Bury 018B,E01005010,1605,835,770
2021,Bury 018C,E01005012,1756,901,855
2021,Bury 018D,E01005013,2622,1371,1251
2021,Bury 019A,E01004984,1393,702,691
2021,Bury 019B,E01004985,1462,716,746
2021,Bury 019C,E01004989,1421,721,700
2021,Bury 019D,E01005007,1509,778,731
2021,Bury 019E,E01005011,1430,706,724
2021,Bury 020A,E01004983,1355,664,691
2021,Bury 020B,E01004986,1627,843,784
2021,Bury 020C,E01004987,1310,672,638
2021,Bury 020D,E01004988,1387,712,675
2021,Bury 021A,E01004941,1869,984,885
2021,Bury 021B,E01004942,1700,914,786
2021,Bury 021C,E01004943,1837,954,883
2021,Bury 021D,E01004944,1517,765,752
2021,Bury 021E,E01004946,1679,922,757
2021,Bury 022A,E01004969,1509,740,769
2021,Bury 022B,E01004970,1626,828,798
2021,Bury 022C,E01004971,1480,715,765
2021,Bury 022D,E01005034,1789,876,913
2021,Bury 023A,E01004972,1494,769,725
2021,Bury 023B,E01004973,1544,773,771
2021,Bury 023C,E01004975,1498,767,731
2021,Bury 023D,E01005039,1575,832,743
2021,Bury 023E,E01005045,1619,839,780
2021,Bury 024A,E01004974,1411,711,700
2021,Bury 024B,E01005033,1675,851,824
2021,Bury 024C,E01005036,1982,942,1040
2021,Bury 024D,E01005037,1493,758,735
2021,Bury 025A,E01005031,1533,788,745
2021,Bury 025B,E01005032,1341,719,622
2021,Bury 025C,E01005035,1452,734,718
2021,Bury 025D,E01005038,1357,688,669
2021,Bury 026A,E01005040,1845,919,926
2021,Bury 026B,E01005041,1857,938,919
2021,Bury 026C,E01005042,1952,1013,939
2021,Bury 026D,E01005043,1947,978,969
2021,Bury 026E,E01005044,1964,957,1007
2021,Manchester 001A,E01005098,1631,863,768
2021,Manchester 001B,E01005099,1943,1093,850
2021,Manchester 001C,E01005100,1658,881,777
2021,Manchester 001D,E01005102,1370,700,670
2021,Manchester 001E,E01005103,1832,981,851
2021,Manchester 002A,E01005101,1871,971,900
2021,Manchester 002B,E01005135,1866,933,933
2021,Manchester 002C,E01005136,1512,752,760
2021,Manchester 002D,E01005138,2480,1294,1186
2021,Manchester 002F,E01034107,1412,726,686
2021,Manchester 002G,E01034108,2074,1054,1020
2021,Manchester 003B,E01005139,1966,1047,919
2021,Manchester 003C,E01005141,1974,1018,956
2021,Manchester 003D,E01005251,1678,863,815
2021,Manchester 003E,E01005252,1929,979,950
2021,Manchester 003F,E01033685,1586,779,807
2021,Manchester 003G,E01033687,1341,669,672
2021,Manchester 004A,E01005104,1975,961,1014
2021,Manchester 004B,E01005160,1974,992,982
2021,Manchester 004C,E01005161,1815,939,876
2021,Manchester 004D,E01005162,1897,933,964
2021,Manchester 004E,E01005163,1786,893,893
2021,Manchester 005A,E01005247,1421,749,672
2021,Manchester 005B,E01005248,1329,706,623
2021,Manchester 005C,E01005249,2199,1139,1060
2021,Manchester 005D,E01005250,2233,1205,1028
2021,Manchester 005E,E01005253,1704,886,818
2021,Manchester 005F,E01005254,1606,803,803
2021,Manchester 006A,E01005164,2343,1147,1196
2021,Manchester 006B,E01005205,2193,1175,1018
2021,Manchester 006C,E01005206,1875,900,975
2021,Manchester 006D,E01005207,2018,1033,985
2021,Manchester 007A,E01005223,1617,832,785
2021,Manchester 007B,E01005224,2118,1134,984
2021,Manchester 007C,E01005225,2094,1102,992
2021,Manchester 007D,E01005226,1939,985,954
2021,Manchester 007E,E01005229,1502,771,731
2021,Manchester 008A,E01005145,3003,1470,1533
2021,Manchester 008C,E01005149,2184,1109,1075
2021,Manchester 008D,E01005165,2348,1094,1254
2021,Manchester 008E,E01005166,2139,1045,1094
2021,Manchester 008F,E01005167,2315,1173,1142
2021,Manchester 008G,E01034109,1525,769,756
2021,Manchester 008H,E01034110,1497,753,744
2021,Manchester 009A,E01005202,2383,1196,1187
2021,Manchester 009B,E01005203,2024,1006,1018
2021,Manchester 009D,E01005227,2078,1064,1014
2021,Manchester 009E,E01005228,2250,1234,1016
2021,Manchester 009F,E01033678,1776,902,874
2021,Manchester 009G,E01033679,1399,707,692
2021,Manchester 011A,E01005256,2640,1343,1297
2021,Manchester 011B,E01005257,2009,1070,939
2021,Manchester 011C,E01005258,1798,910,888
2021,Manchester 011D,E01005259,1773,933,840
2021,Manchester 011E,E01005260,1468,753,715
2021,Manchester 012A,E01005093,1842,925,917
2021,Manchester 012B,E01005094,1694,898,796
2021,Manchester 012C,E01005097,1950,1006,944
2021,Manchester 012D,E01005255,1664,831,833
2021,Manchester 012E,E01005261,1786,943,843
2021,Manchester 015A,E01005092,1946,1031,915
2021,Manchester 015C,E01005105,2956,1456,1500
2021,Manchester 015D,E01005106,2334,1140,1194
2021,Manchester 015E,E01005107,2033,1049,984
2021,Manchester 015F,E01033668,1154,537,617
2021,Manchester 015G,E01033669,1427,720,707
2021,Manchester 017D,E01005189,1688,868,820
2021,Manchester 017E,E01005190,2449,1217,1232
2021,Manchester 017G,E01034111,1571,825,746
2021,Manchester 017H,E01034112,1851,950,901
2021,Manchester 017I,E01034113,1486,760,726
2021,Manchester 017J,E01034114,1917,962,955
2021,Manchester 018A,E01005061,1792,916,876
2021,Manchester 018C,E01005063,2118,1054,1064
2021,Manchester 018D,E01005065,2173,1069,1104
2021,Manchester 018E,E01005066,1051,441,610
2021,Manchester 018F,E01034115,1894,973,921
2021,Manchester 018G,E01034116,1109,519,590
2021,Manchester 019A,E01005208,2808,1491,1317
2021,Manchester 019C,E01005210,2646,1440,1206
2021,Manchester 019D,E01005214,2389,1146,1243
2021,Manchester 019E,E01034117,2202,1127,1075
2021,Manchester 019F,E01034118,1026,473,553
2021,Manchester 020A,E01005067,2075,1037,1038
2021,Manchester 020B,E01005186,2896,1452,1444
2021,Manchester 020C,E01005232,1926,943,983
2021,Manchester 020D,E01005235,2079,1052,1027
2021,Manchester 020E,E01005239,1803,951,852
2021,Manchester 021A,E01005187,2246,1151,1095
2021,Manchester 021B,E01005188,1919,988,931
2021,Manchester 021C,E01005191,1860,1000,860
2021,Manchester 021D,E01005192,1732,841,891
2021,Manchester 021E,E01005193,1770,872,898
2021,Manchester 022B,E01005230,2094,977,1117
2021,Manchester 022C,E01005231,2503,1279,1224
2021,Manchester 022D,E01005236,2267,1053,1214
2021,Manchester 022E,E01005237,2037,984,1053
2021,Manchester 022H,E01034119,2667,1418,1249
2021,Manchester 023A,E01005195,2447,1307,1140
2021,Manchester 023C,E01005197,1727,865,862
2021,Manchester 023D,E01005198,2052,1054,998
2021,Manchester 023E,E01005201,2127,1068,1059
2021,Manchester 023F,E01034120,1777,873,904
2021,Manchester 023G,E01034121,1422,731,691
2021,Manchester 024B,E01005243,2911,1510,1401
2021,Manchester 024C,E01005245,2806,1427,1379
2021,Manchester 024D,E01005246,2541,1332,1209
2021,Manchester 024E,E01034122,1870,963,907
2021,Manchester 024F,E01034123,1762,880,882
2021,Manchester 025C,E01005244,2993,1533,1460
2021,Manchester 025D,E01005285,1536,742,794
2021,Manchester 025E,E01005288,1823,889,934
2021,Manchester 025F,E01034124,1568,772,796
2021,Manchester 025G,E01034125,1557,796,761
2021,Manchester 025H,E01034126,1655,846,809
2021,Manchester 025I,E01034127,1362,668,694
2021,Manchester 026A,E01005280,2179,1113,1066
2021,Manchester 026B,E01005281,2572,1370,1202
2021,Manchester 026C,E01005284,2598,1157,1441
2021,Manchester 026D,E01005286,2300,1087,1213
2021,Manchester 026E,E01005287,2347,1186,1161
2021,Manchester 028A,E01005297,2436,1178,1258
2021,Manchester 028B,E01005298,1814,902,912
2021,Manchester 028C,E01005302,2109,1026,1083
2021,Manchester 028E,E01033680,1261,564,697
2021,Manchester 028F,E01033686,1319,624,695
2021,Manchester 029A,E01005150,1696,792,904
2021,Manchester 029B,E01005151,1477,708,769
2021,Manchester 029C,E01005152,1436,736,700
2021,Manchester 029D,E01005159,1610,847,763
2021,Manchester 029E,E01005296,1567,809,758
2021,Manchester 029F,E01005299,1579,793,786
2021,Manchester 030A,E01005178,2010,1064,946
2021,Manchester 030B,E01005179,2230,1143,1087
2021,Manchester 030C,E01005180,1920,1000,920
2021,Manchester 030D,E01005181,2227,1113,1114
2021,Manchester 030E,E01005182,1619,872,747
2021,Manchester 030F,E01005183,1792,879,913
2021,Manchester 031A,E01005219,2277,996,1281
2021,Manchester 031B,E01005220,2137,1092,1045
2021,Manchester 031C,E01005221,2557,1225,1332
2021,Manchester 031D,E01005222,2164,1093,1071
2021,Manchester 032A,E01005184,2295,1208,1087
2021,Manchester 032B,E01005185,3260,1695,1565
2021,Manchester 032C,E01005271,1985,998,987
2021,Manchester 032F,E01034128,3735,1913,1822
2021,Manchester 033A,E01005154,1427,730,697
2021,Manchester 033B,E01005156,1479,758,721
2021,Manchester 033C,E01005158,1492,785,707
2021,Manchester 033D,E01005300,1548,790,758
2021,Manchester 033E,E01005301,1482,756,726
2021,Manchester 034A,E01005118,1472,746,726
2021,Manchester 034B,E01005120,1901,973,928
2021,Manchester 034C,E01005215,2045,1016,1029
2021,Manchester 034D,E01005216,1529,783,746
2021,Manchester 034E,E01005217,2053,1036,1017
2021,Manchester 034F,E01005218,1689,842,847
2021,Manchester 035A,E01005270,1768,946,822
2021,Manchester 035B,E01005272,1973,1028,945
2021,Manchester 035C,E01005273,1667,857,810
2021,Manchester 035D,E01005278,1854,939,915
2021,Manchester 035E,E01005279,2199,1177,1022
2021,Manchester 036A,E01005305,1708,838,870
2021,Manchester 036B,E01005309,2229,1125,1104
2021,Manchester 036C,E01005310,1986,1061,925
2021,Manchester 036D,E01005311,1825,914,911
2021,Manchester 036E,E01005312,1982,952,1030
2021,Manchester 037A,E01005082,1799,934,865
2021,Manchester 037B,E01005153,1544,763,781
2021,Manchester 037C,E01005155,1434,751,683
2021,Manchester 037D,E01005157,1529,812,717
2021,Manchester 038A,E01005274,1751,911,840
2021,Manchester 038B,E01005275,1781,908,873
2021,Manchester 038C,E01005276,1464,766,698
2021,Manchester 038D,E01005277,1677,852,825
2021,Manchester 039A,E01005076,1348,684,664
2021,Manchester 039C,E01005081,1822,982,840
2021,Manchester 039D,E01005083,1838,852,986
2021,Manchester 039E,E01033670,1446,703,743
2021,Manchester 039F,E01033671,1788,941,847
2021,Manchester 040A,E01005125,1574,834,740
2021,Manchester 040B,E01005304,1959,963,996
2021,Manchester 040C,E01005306,1580,784,796
2021,Manchester 040D,E01005307,1803,914,889
2021,Manchester 040E,E01005308,1688,882,806
2021,Manchester 041A,E01005119,1738,916,822
2021,Manchester 041B,E01005121,1687,888,799
2021,Manchester 041C,E01005122,1913,996,917
2021,Manchester 041D,E01005123,1774,915,859
2021,Manchester 041E,E01005124,1862,983,879
2021,Manchester 042A,E01005077,1677,909,768
2021,Manchester 042B,E01005078,1553,722,831
2021,Manchester 042C,E01005079,1643,840,803
2021,Manchester 042D,E01005084,2010,1075,935
2021,Manchester 043A,E01005172,1532,728,804
2021,Manchester 043B,E01005173,1618,837,781
2021,Manchester 043C,E01005174,1556,782,774
2021,Manchester 043D,E01005175,1590,799,791
2021,Manchester 043E,E01005176,1682,858,824
2021,Manchester 043F,E01005177,1303,686,617
2021,Manchester 044A,E01005115,1898,969,929
2021,Manchester 044B,E01005262,1785,921,864
2021,Manchester 044C,E01005264,1649,864,785
2021,Manchester 044D,E01005265,1738,942,796
2021,Manchester 044E,E01005266,2054,1121,933
2021,Manchester 045A,E01005126,2003,1019,984
2021,Manchester 045B,E01005168,1404,714,690
2021,Manchester 045C,E01005169,1369,687,682
2021,Manchester 045D,E01005170,1520,773,747
2021,Manchester 045E,E01005171,1746,894,852
2021,Manchester 046A,E01005263,1736,790,946
2021,Manchester 046B,E01005267,1524,775,749
2021,Manchester 046C,E01005268,2187,1095,1092
2021,Manchester 046D,E01005269,1535,782,753
2021,Manchester 047A,E01005069,1418,740,678
2021,Manchester 047B,E01005111,1460,794,666
2021,Manchester 047C,E01005113,1672,842,830
2021,Manchester 047D,E01005114,1745,892,853
2021,Manchester 047E,E01005116,2089,1094,995
2021,Manchester 048A,E01005071,1735,901,834
2021,Manchester 048B,E01005072,1781,919,862
2021,Manchester 048C,E01005073,1536,776,760
2021,Manchester 048D,E01005112,1723,883,840
2021,Manchester 048E,E01005117,2455,1211,1244
2021,Manchester 049A,E01005085,1673,904,769
2021,Manchester 049B,E01005086,1912,1018,894
2021,Manchester 049C,E01005089,1970,1028,942
2021,Manchester 049D,E01005289,1701,894,807
2021,Manchester 049E,E01005295,2641,1354,1287
2021,Manchester 050A,E01005087,2304,1153,1151
2021,Manchester 050B,E01005088,1933,1041,892
2021,Manchester 050C,E01005090,1890,1009,881
2021,Manchester 050D,E01005091,2381,1263,1118
2021,Manchester 050E,E01005291,1481,758,723
2021,Manchester 051A,E01005068,1690,877,813
2021,Manchester 051B,E01005070,1847,947,900
2021,Manchester 051C,E01005074,1623,838,785
2021,Manchester 051D,E01005075,1550,855,695
2021,Manchester 051E,E01005319,2323,1254,1069
2021,Manchester 052A,E01005290,1688,884,804
2021,Manchester 052B,E01005292,1523,818,705
2021,Manchester 052C,E01005293,1174,600,574
2021,Manchester 052D,E01005294,1617,823,794
2021,Manchester 052E,E01005317,2020,999,1021
2021,Manchester 053A,E01005313,1514,808,706
2021,Manchester 053B,E01005314,1695,911,784
2021,Manchester 053C,E01005315,1724,889,835
2021,Manchester 053D,E01005316,1642,830,812
2021,Manchester 053E,E01005318,1990,1072,918
2021,Manchester 054A,E01005130,1447,672,775
2021,Manchester 054B,E01033651,1691,773,918
2021,Manchester 054C,E01033658,1394,613,781
2021,Manchester 054D,E01033664,1859,798,1061
2021,Manchester 054E,E01033667,1491,665,826
2021,Manchester 055A,E01005128,2026,1018,1008
2021,Manchester 055B,E01033653,1851,798,1053
2021,Manchester 055C,E01033654,1791,685,1106
2021,Manchester 055E,E01033661,1988,904,1084
2021,Manchester 055F,E01034129,1082,481,601
2021,Manchester 055G,E01034130,1391,576,815
2021,Manchester 056A,E01005143,3006,1500,1506
2021,Manchester 056B,E01033655,1267,538,729
2021,Manchester 056C,E01033665,1523,649,874
2021,Manchester 056D,E01033676,2006,1053,953
2021,Manchester 057A,E01005212,3127,1613,1514
2021,Manchester 057B,E01033656,2719,1418,1301
2021,Manchester 057C,E01033662,2014,956,1058
2021,Manchester 058A,E01005142,2291,1155,1136
2021,Manchester 058B,E01005147,2783,1407,1376
2021,Manchester 058C,E01033674,2080,685,1395
2021,Manchester 058D,E01033675,2207,1125,1082
2021,Manchester 059A,E01005213,2397,1138,1259
2021,Manchester 059B,E01033660,1438,665,773
2021,Manchester 059C,E01033672,1704,785,919
2021,Manchester 059D,E01033673,1444,600,844
2021,Manchester 060A,E01033677,1019,436,583
2021,Manchester 060B,E01033681,1330,602,728
2021,Manchester 060C,E01033682,1222,518,704
2021,Manchester 060E,E01034131,1025,399,626
2021,Manchester 060F,E01034132,1832,765,1067
2021,Manchester 061A,E01005129,1842,897,945
2021,Manchester 061B,E01005132,2137,1083,1054
2021,Manchester 061C,E01034133,1868,925,943
2021,Manchester 061D,E01034134,1193,554,639
2021,Manchester 062D,E01033684,1820,810,1010
2021,Manchester 062B,E01033688,1708,834,874
2021,Manchester 062A,E01034135,1114,477,637
2021,Manchester 062C,E01034136,1009,426,583
2021,Manchester 063B,E01005233,2937,1432,1505
2021,Manchester 063A,E01005234,2313,1150,1163
2021,Manchester 063D,E01005238,2298,1133,1165
2021,Manchester 063C,E01034137,1732,830,902
2021,Manchester 064C,E01005199,2512,1286,1226
2021,Manchester 064A,E01005200,2459,1292,1167
2021,Manchester 064B,E01034138,1385,682,703
2021,Oldham 001A,E01005357,1428,726,702
2021,Oldham 001B,E01005358,1568,803,765
2021,Oldham 001C,E01005359,1564,796,768
2021,Oldham 001D,E01005360,1380,701,679
2021,Oldham 002A,E01005441,1527,782,745
2021,Oldham 002B,E01005442,1329,675,654
2021,Oldham 002C,E01005444,1397,729,668
2021,Oldham 002D,E01005445,1425,731,694
2021,Oldham 003A,E01005361,1671,865,806
2021,Oldham 003B,E01005443,1314,693,621
2021,Oldham 003C,E01005446,1406,743,663
2021,Oldham 003D,E01005447,1645,877,768
2021,Oldham 004A,E01005390,1361,705,656
2021,Oldham 004B,E01005394,1450,740,710
2021,Oldham 004C,E01005395,1430,718,712
2021,Oldham 004D,E01005396,1433,715,718
2021,Oldham 005A,E01005355,1459,744,715
2021,Oldham 005B,E01005356,1252,635,617
2021,Oldham 005C,E01005399,1585,826,759
2021,Oldham 005D,E01005403,1734,864,870
2021,Oldham 006A,E01005410,1495,742,753
2021,Oldham 006B,E01005411,1565,806,759
2021,Oldham 006C,E01005414,1335,700,635
2021,Oldham 006D,E01005415,1109,582,527
2021,Oldham 007C,E01005452,1278,646,632
2021,Oldham 007D,E01005453,1555,781,774
2021,Oldham 007E,E01032558,1728,934,794
2021,Oldham 007F,E01032559,2751,1403,1348
2021,Oldham 008A,E01005391,1559,804,755
2021,Oldham 008B,E01005392,1588,839,749
2021,Oldham 008C,E01005393,1221,628,593
2021,Oldham 008D,E01005401,1585,818,767
2021,Oldham 009A,E01005397,1328,671,657
2021,Oldham 009B,E01005398,1530,799,731
2021,Oldham 009C,E01005400,1526,781,745
2021,Oldham 009D,E01005402,1645,839,806
2021,Oldham 010A,E01005335,1290,662,628
2021,Oldham 010B,E01005337,2548,1317,1231
2021,Oldham 010C,E01005339,1484,748,736
2021,Oldham 010D,E01005340,1600,812,788
2021,Oldham 011A,E01005421,1816,980,836
2021,Oldham 011B,E01005422,1551,841,710
2021,Oldham 011E,E01032920,2585,1338,1247
2021,Oldham 012A,E01005448,1643,805,838
2021,Oldham 012B,E01005449,1585,808,777
2021,Oldham 012C,E01005454,1379,709,670
2021,Oldham 012D,E01005455,1464,745,719
2021,Oldham 012E,E01005456,1681,869,812
2021,Oldham 013A,E01005407,1719,868,851
2021,Oldham 013B,E01005412,1684,869,815
2021,Oldham 013C,E01005416,1521,784,737
2021,Oldham 013D,E01005417,1554,790,764
2021,Oldham 014A,E01005348,2423,1095,1328
2021,Oldham 014B,E01005350,2408,1100,1308
2021,Oldham 014C,E01005432,1827,945,882
2021,Oldham 014D,E01005433,2477,1239,1238
2021,Oldham 015A,E01005329,1499,746,753
2021,Oldham 015B,E01005330,1735,849,886
2021,Oldham 015C,E01005333,1239,636,603
2021,Oldham 015D,E01005336,1521,772,749
2021,Oldham 016A,E01005349,2506,1230,1276
2021,Oldham 016B,E01005351,2085,1064,1021
2021,Oldham 016C,E01005352,1529,736,793
2021,Oldham 016D,E01005353,1510,743,767
2021,Oldham 016E,E01005354,1804,917,887
2021,Oldham 017A,E01005327,1968,1025,943
2021,Oldham 017B,E01005328,1790,896,894
2021,Oldham 017C,E01005331,1724,894,830
2021,Oldham 017D,E01005334,1426,748,678
2021,Oldham 017E,E01005338,1942,1008,934
2021,Oldham 018A,E01005387,1472,765,707
2021,Oldham 018B,E01005388,1339,718,621
2021,Oldham 018C,E01005389,1767,925,842
2021,Oldham 018D,E01005418,1411,710,701
2021,Oldham 019A,E01005428,2365,1237,1128
2021,Oldham 019B,E01005431,1862,955,907
2021,Oldham 019C,E01005450,2138,1106,1032
2021,Oldham 019D,E01005451,1547,787,760
2021,Oldham 020C,E01005408,2018,1041,977
2021,Oldham 020D,E01005409,1568,813,755
2021,Oldham 020E,E01032922,2414,1258,1156
2021,Oldham 021A,E01005406,1407,689,718
2021,Oldham 021B,E01005413,1591,793,798
2021,Oldham 021C,E01005419,1451,778,673
2021,Oldham 021D,E01005420,1615,854,761
2021,Oldham 022A,E01005321,2334,1133,1201
2021,Oldham 022B,E01005326,2997,1542,1455
2021,Oldham 022C,E01005427,2214,1112,1102
2021,Oldham 022D,E01005429,1920,930,990
2021,Oldham 022E,E01005430,2852,1407,1445
2021,Oldham 024A,E01005320,2700,1372,1328
2021,Oldham 024B,E01005434,2161,1057,1104
2021,Oldham 024C,E01005437,2048,1003,1045
2021,Oldham 024D,E01005459,1770,962,808
2021,Oldham 026A,E01005383,2191,1135,1056
2021,Oldham 026D,E01005386,1548,843,705
2021,Oldham 026E,E01032556,1502,798,704
2021,Oldham 026F,E01032557,1819,1006,813
2021,Oldham 027A,E01005342,1592,741,851
2021,Oldham 027B,E01005343,1415,734,681
2021,Oldham 027C,E01005344,1913,953,960
2021,Oldham 027D,E01005381,1956,1003,953
2021,Oldham 028A,E01005332,2296,1203,1093
2021,Oldham 028B,E01005341,1413,721,692
2021,Oldham 028C,E01005345,1503,743,760
2021,Oldham 028D,E01005346,1394,704,690
2021,Oldham 028E,E01005347,1311,666,645
2021,Oldham 029A,E01005322,1512,776,736
2021,Oldham 029B,E01005323,1568,826,742
2021,Oldham 029C,E01005324,1620,843,777
2021,Oldham 029D,E01005325,1497,750,747
2021,Oldham 029E,E01005438,2968,1433,1535
2021,Oldham 030A,E01005377,1749,918,831
2021,Oldham 030B,E01005379,1296,727,569
2021,Oldham 030C,E01005380,1514,797,717
2021,Oldham 030D,E01005382,1609,821,788
2021,Oldham 030E,E01005439,1586,821,765
2021,Oldham 031A,E01005362,1357,701,656
2021,Oldham 031B,E01005364,1584,817,767
2021,Oldham 031C,E01005368,1516,766,750
2021,Oldham 031D,E01005376,1444,756,688
2021,Oldham 031E,E01005378,1557,819,738
2021,Oldham 032A,E01005363,1774,892,882
2021,Oldham 032B,E01005369,1965,1079,886
2021,Oldham 032C,E01005370,1578,823,755
2021,Oldham 032D,E01005371,1473,746,727
2021,Oldham 033A,E01005365,1377,701,676
2021,Oldham 033B,E01005366,1557,870,687
2021,Oldham 033C,E01005367,1420,712,708
2021,Oldham 033D,E01005440,1450,761,689
2021,Oldham 034A,E01005372,1276,681,595
2021,Oldham 034B,E01005373,1193,632,561
2021,Oldham 034C,E01005374,1485,770,715
2021,Oldham 034D,E01005375,1502,761,741
2021,Oldham 036C,E01005460,2705,1398,1307
2021,Oldham 036D,E01005463,1687,884,803
2021,Oldham 036A,E01034232,1692,824,868
2021,Oldham 036B,E01034233,1609,753,856
2021,Oldham 037B,E01005435,2032,1000,1032
2021,Oldham 037D,E01005436,1827,969,858
2021,Oldham 037A,E01005461,2423,1237,1186
2021,Oldham 037C,E01005462,2204,1080,1124
2021,Rochdale 001A,E01005518,1592,815,777
2021,Rochdale 001B,E01005520,1715,903,812
2021,Rochdale 001C,E01005522,1486,746,740
2021,Rochdale 001D,E01005523,1832,936,896
2021,Rochdale 002A,E01005519,1563,765,798
2021,Rochdale 002B,E01005594,1512,751,761
2021,Rochdale 002C,E01005597,1979,1007,972
2021,Rochdale 002D,E01005598,1548,804,744
2021,Rochdale 003A,E01005516,1281,645,636
2021,Rochdale 003B,E01005517,1435,733,702
2021,Rochdale 003C,E01005521,1452,738,714
2021,Rochdale 003D,E01005596,2157,1098,1059
2021,Rochdale 004A,E01005578,1543,778,765
2021,Rochdale 004B,E01005579,1861,935,926
2021,Rochdale 004C,E01005586,1615,815,800
2021,Rochdale 004D,E01005593,2056,1044,1012
2021,Rochdale 004E,E01005595,1328,690,638
2021,Rochdale 005A,E01005489,1249,656,593
2021,Rochdale 005B,E01005490,1571,610,961
2021,Rochdale 005C,E01005491,1436,757,679
2021,Rochdale 005D,E01005493,1762,902,860
2021,Rochdale 005E,E01005494,1758,905,853
2021,Rochdale 005F,E01005495,1769,891,878
2021,Rochdale 006A,E01005488,1507,775,732
2021,Rochdale 006B,E01005492,1534,789,745
2021,Rochdale 006C,E01005499,1512,769,743
2021,Rochdale 006D,E01005571,1648,845,803
2021,Rochdale 007A,E01005570,1307,668,639
2021,Rochdale 007B,E01005572,1500,775,725
2021,Rochdale 007C,E01005573,1433,734,699
2021,Rochdale 007D,E01005574,1728,879,849
2021,Rochdale 007E,E01005587,1367,697,670
2021,Rochdale 007F,E01005588,1314,723,591
2021,Rochdale 008A,E01005580,1647,842,805
2021,Rochdale 008B,E01005581,1973,1014,959
2021,Rochdale 008D,E01005583,1746,859,887
2021,Rochdale 008F,E01005585,1569,765,804
2021,Rochdale 008H,E01034234,1763,870,893
2021,Rochdale 008I,E01034235,1667,836,831
2021,Rochdale 009A,E01005496,1321,691,630
2021,Rochdale 009B,E01005589,1700,858,842
2021,Rochdale 009C,E01005590,1904,954,950
2021,Rochdale 009D,E01005591,1586,824,762
2021,Rochdale 009E,E01005592,1638,843,795
2021,Rochdale 010A,E01005472,1648,851,797
2021,Rochdale 010B,E01005473,1699,862,837
2021,Rochdale 010C,E01005482,1661,704,957
2021,Rochdale 010D,E01005483,1485,725,760
2021,Rochdale 010E,E01005484,2032,1014,1018
2021,Rochdale 010F,E01005486,1701,848,853
2021,Rochdale 010G,E01005487,1789,912,877
2021,Rochdale 011A,E01005474,1318,690,628
2021,Rochdale 011B,E01005575,1714,881,833
2021,Rochdale 011C,E01005576,1525,790,735
2021,Rochdale 011D,E01005577,1459,741,718
2021,Rochdale 012A,E01005469,1822,929,893
2021,Rochdale 012B,E01005563,2170,1107,1063
2021,Rochdale 012C,E01005565,1571,794,777
2021,Rochdale 012D,E01005566,2346,1222,1124
2021,Rochdale 012E,E01005568,1940,983,957
2021,Rochdale 012F,E01005569,1793,944,849
2021,Rochdale 013A,E01005556,1529,778,751
2021,Rochdale 013B,E01005559,1469,764,705
2021,Rochdale 013C,E01005560,1462,746,716
2021,Rochdale 013D,E01005567,1879,958,921
2021,Rochdale 014A,E01005555,1386,707,679
2021,Rochdale 014B,E01005557,1139,585,554
2021,Rochdale 014C,E01005558,1594,828,766
2021,Rochdale 014D,E01005561,1412,720,692
2021,Rochdale 014E,E01005562,1509,745,764
2021,Rochdale 015A,E01005470,2036,1016,1020
2021,Rochdale 015B,E01005471,1696,845,851
2021,Rochdale 015C,E01005475,1778,892,886
2021,Rochdale 015D,E01005485,2376,1137,1239
2021,Rochdale 015E,E01005564,2410,1193,1217
2021,Rochdale 016A,E01005464,1969,1030,939
2021,Rochdale 016B,E01005465,1810,929,881
2021,Rochdale 016C,E01005466,2485,1301,1184
2021,Rochdale 016D,E01005467,1972,1041,931
2021,Rochdale 016E,E01005468,2166,1122,1044
2021,Rochdale 017A,E01005476,1796,857,939
2021,Rochdale 017B,E01005477,1771,913,858
2021,Rochdale 017C,E01005478,1588,823,765
2021,Rochdale 017D,E01005479,1976,1017,959
2021,Rochdale 017E,E01005480,1647,844,803
2021,Rochdale 017F,E01005481,1680,879,801
2021,Rochdale 018A,E01005497,1891,972,919
2021,Rochdale 018B,E01005501,1783,892,891
2021,Rochdale 018C,E01005502,1378,696,682
2021,Rochdale 018D,E01005504,1642,846,796
2021,Rochdale 018E,E01005505,2182,1168,1014
2021,Rochdale 018F,E01005509,1445,709,736
2021,Rochdale 019A,E01005510,1094,560,534
2021,Rochdale 019B,E01005511,1251,652,599
2021,Rochdale 019C,E01005512,1440,728,712
2021,Rochdale 019D,E01005513,1557,814,743
2021,Rochdale 019E,E01005514,1844,968,876
2021,Rochdale 019F,E01005515,1798,990,808
2021,Rochdale 020A,E01005498,1372,731,641
2021,Rochdale 020B,E01005500,1592,809,783
2021,Rochdale 020C,E01005503,1318,637,681
2021,Rochdale 020D,E01005506,1545,773,772
2021,Rochdale 020E,E01005507,2261,1142,1119
2021,Rochdale 020F,E01005508,2015,1042,973
2021,Rochdale 021A,E01005524,1470,750,720
2021,Rochdale 021B,E01005525,1886,951,935
2021,Rochdale 021C,E01005526,1907,973,934
2021,Rochdale 021D,E01005528,1548,765,783
2021,Rochdale 021E,E01005536,1713,898,815
2021,Rochdale 021F,E01005543,1252,638,614
2021,Rochdale 022A,E01005527,2059,1074,985
2021,Rochdale 022B,E01005529,1660,907,753
2021,Rochdale 022C,E01005551,2027,1072,955
2021,Rochdale 022D,E01005552,2342,1234,1108
2021,Rochdale 022E,E01005553,2037,1046,991
2021,Rochdale 022F,E01005554,2157,1095,1062
2021,Rochdale 023A,E01005534,1414,705,709
2021,Rochdale 023B,E01005535,1469,740,729
2021,Rochdale 023C,E01005537,1269,625,644
2021,Rochdale 023D,E01005538,1482,774,708
2021,Rochdale 023E,E01005540,1345,694,651
2021,Rochdale 023F,E01005541,1534,803,731
2021,Rochdale 023G,E01005542,1616,849,767
2021,Rochdale 024A,E01005533,1623,813,810
2021,Rochdale 024B,E01005539,1315,664,651
2021,Rochdale 024C,E01005546,1242,629,613
2021,Rochdale 024D,E01005547,1755,897,858
2021,Rochdale 024E,E01005548,1275,640,635
2021,Rochdale 025A,E01005530,1458,763,695
2021,Rochdale 025B,E01005531,1160,609,551
2021,Rochdale 025C,E01005532,1548,798,750
2021,Rochdale 025D,E01005544,1475,753,722
2021,Rochdale 025E,E01005545,1250,627,623
2021,Rochdale 025F,E01005549,1548,785,763
2021,Rochdale 025G,E01005550,1466,755,711
2021,Salford 001A,E01005659,1544,800,744
2021,Salford 001B,E01005660,1823,967,856
2021,Salford 001C,E01005663,1528,781,747
2021,Salford 001D,E01005664,1708,943,765
2021,Salford 001E,E01005665,2104,1120,984
2021,Salford 002A,E01005703,1746,905,841
2021,Salford 002B,E01005704,1344,693,651
2021,Salford 002C,E01005706,1537,812,725
2021,Salford 002D,E01005708,1434,708,726
2021,Salford 003A,E01005702,2637,1374,1263
2021,Salford 003C,E01005707,1751,898,853
2021,Salford 003D,E01033976,1965,1019,946
2021,Salford 003E,E01033977,1141,581,560
2021,Salford 004A,E01005661,1900,949,951
2021,Salford 004B,E01005662,1623,854,769
2021,Salford 004C,E01005709,1606,846,760
2021,Salford 004D,E01005710,2143,1103,1040
2021,Salford 005A,E01005670,1759,893,866
2021,Salford 005B,E01005672,1278,665,613
2021,Salford 005C,E01005676,1225,608,617
2021,Salford 005D,E01005677,1581,819,762
2021,Salford 006A,E01005686,1463,769,694
2021,Salford 006B,E01005688,1568,796,772
2021,Salford 006C,E01005691,1417,699,718
2021,Salford 006D,E01005692,1375,706,669
2021,Salford 007A,E01005711,1394,694,700
2021,Salford 007B,E01005712,1838,929,909
2021,Salford 007C,E01005713,1627,831,796
2021,Salford 007D,E01005714,1712,906,806
2021,Salford 007E,E01005715,1746,875,871
2021,Salford 007F,E01005718,1601,796,805
2021,Salford 008A,E01005673,1486,779,707
2021,Salford 008C,E01005678,1569,821,748
2021,Salford 008D,E01005679,1550,841,709
2021,Salford 008E,E01033978,1027,520,507
2021,Salford 008F,E01033979,2044,578,1466
2021,Salford 009A,E01005687,1802,920,882
2021,Salford 009B,E01005689,1366,702,664
2021,Salford 009C,E01005690,1568,799,769
2021,Salford 009D,E01005693,1433,757,676
2021,Salford 010A,E01005646,2252,1052,1200
2021,Salford 010B,E01005649,1723,861,862
2021,Salford 010C,E01005650,1993,905,1088
2021,Salford 010D,E01005651,2277,1072,1205
2021,Salford 011A,E01005647,1501,782,719
2021,Salford 011B,E01005648,2351,1193,1158
2021,Salford 011C,E01005652,1555,801,754
2021,Salford 011D,E01005653,1562,788,774
2021,Salford 012A,E01005671,1567,800,767
2021,Salford 012B,E01005674,1573,812,761
2021,Salford 012C,E01005694,1709,864,845
2021,Salford 012D,E01005696,1784,940,844
2021,Salford 012E,E01005698,1745,920,825
2021,Salford 012F,E01005700,1516,774,742
2021,Salford 013A,E01005716,1633,839,794
2021,Salford 013B,E01005717,1555,782,773
2021,Salford 013C,E01005734,1417,734,683
2021,Salford 013D,E01005735,1422,713,709
2021,Salford 013E,E01005736,1368,693,675
2021,Salford 013F,E01005737,1510,777,733
2021,Salford 013G,E01005739,1999,1049,950
2021,Salford 014A,E01005695,1556,772,784
2021,Salford 014B,E01005697,1531,758,773
2021,Salford 014C,E01005738,1931,965,966
2021,Salford 014D,E01005740,1599,811,788
2021,Salford 014E,E01005741,1680,853,827
2021,Salford 014F,E01005742,1555,787,768
2021,Salford 015A,E01005625,1370,687,683
2021,Salford 015B,E01005627,1172,604,568
2021,Salford 015C,E01005699,1791,887,904
2021,Salford 015D,E01005701,1826,935,891
2021,Salford 017A,E01005624,1839,949,890
2021,Salford 017B,E01005680,1732,816,916
2021,Salford 017C,E01005683,2149,1161,988
2021,Salford 017G,E01033980,1043,525,518
2021,Salford 017H,E01033981,2739,1327,1412
2021,Salford 018A,E01005622,1595,842,753
2021,Salford 018B,E01005623,1266,633,633
2021,Salford 018C,E01005626,1286,646,640
2021,Salford 018D,E01005628,1575,743,832
2021,Salford 019A,E01005725,1459,727,732
2021,Salford 019B,E01005726,1433,729,704
2021,Salford 019C,E01005727,1349,676,673
2021,Salford 019D,E01005728,1791,918,873
2021,Salford 019E,E01005733,1470,776,694
2021,Salford 020A,E01005631,1574,720,854
2021,Salford 020B,E01005632,2452,1187,1265
2021,Salford 020C,E01005633,1532,777,755
2021,Salford 020D,E01005634,1591,806,785
2021,Salford 020E,E01005635,1552,740,812
2021,Salford 020F,E01005636,1597,799,798
2021,Salford 020G,E01005637,1450,707,743
2021,Salford 021A,E01005629,1485,755,730
2021,Salford 021B,E01005630,1529,768,761
2021,Salford 021C,E01005719,2038,997,1041
2021,Salford 021E,E01005722,2029,996,1033
2021,Salford 021F,E01005723,1661,833,828
2021,Salford 021G,E01005724,1413,718,695
2021,Salford 021H,E01033982,1911,986,925
2021,Salford 021I,E01033983,1275,624,651
2021,Salford 023A,E01005654,1966,950,1016
2021,Salford 023B,E01005656,1697,857,840
2021,Salford 023C,E01005657,1802,889,913
2021,Salford 023D,E01005721,1552,772,780
2021,Salford 024C,E01005681,1502,688,814
2021,Salford 024D,E01005682,1741,804,937
2021,Salford 024E,E01033984,2443,1259,1184
2021,Salford 025A,E01005729,1535,707,828
2021,Salford 025B,E01005730,1668,864,804
2021,Salford 025C,E01005731,1566,785,781
2021,Salford 025D,E01005732,1207,608,599
2021,Salford 026A,E01005599,1903,888,1015
2021,Salford 026B,E01005600,2036,1015,1021
2021,Salford 026C,E01005601,1740,912,828
2021,Salford 026D,E01005602,1675,848,827
2021,Salford 027A,E01005603,1808,936,872
2021,Salford 027B,E01005604,1651,843,808
2021,Salford 027C,E01005605,1658,829,829
2021,Salford 027D,E01005638,2211,1083,1128
2021,Salford 029A,E01005639,1516,832,684
2021,Salford 029B,E01005640,1360,694,666
2021,Salford 029C,E01005641,1365,723,642
2021,Salford 029D,E01005642,1208,604,604
2021,Salford 029E,E01005643,1369,721,648
2021,Salford 029F,E01005644,1517,767,750
2021,Salford 029G,E01005645,1363,676,687
2021,Salford 030A,E01005616,1446,760,686
2021,Salford 030B,E01005617,1480,761,719
2021,Salford 030C,E01005618,2080,1110,970
2021,Salford 030D,E01005619,1231,599,632
2021,Salford 030E,E01005620,2550,1265,1285
2021,Salford 030F,E01005621,1768,905,863
2021,Salford 031B,E01005612,2481,1226,1255
2021,Salford 031A,E01005613,2698,1219,1479
2021,Salford 031C,E01005614,3103,1571,1532
2021,Salford 032C,E01005611,2515,1199,1316
2021,Salford 032D,E01005615,2372,1120,1252
2021,Salford 032A,E01033985,1664,829,835
2021,Salford 032B,E01033986,1524,735,789
2021,Salford 033F,E01032909,1716,844,872
2021,Salford 033E,E01033330,1541,613,928
2021,Salford 033A,E01033987,1137,506,631
2021,Salford 033B,E01033988,1311,606,705
2021,Salford 033C,E01033989,1133,486,647
2021,Salford 033D,E01033990,1186,613,573
2021,Salford 034C,E01005610,2939,1607,1332
2021,Salford 034D,E01032684,1386,624,762
2021,Salford 034E,E01032906,2043,890,1153
2021,Salford 034A,E01033991,1561,740,821
2021,Salford 034B,E01033992,1398,627,771
2021,Salford 035C,E01005667,2274,1136,1138
2021,Salford 035B,E01032912,2271,1143,1128
2021,Salford 035A,E01032914,2121,980,1141
2021,Salford 036C,E01032915,2139,1036,1103
2021,Salford 036A,E01033993,1813,820,993
2021,Salford 036B,E01033994,1168,497,671
2021,Salford 037A,E01033995,1205,553,652
2021,Salford 037B,E01033996,1218,521,697
2021,Salford 037C,E01033997,1030,445,585
2021,Salford 037D,E01033998,1330,573,757
2021,Salford 037E,E01033999,1223,522,701
2021,Stockport 001A,E01005886,1466,785,681
2021,Stockport 001B,E01005888,1530,801,729
2021,Stockport 001C,E01005889,1425,772,653
2021,Stockport 001D,E01005891,1221,608,613
2021,Stockport 001E,E01005894,1362,690,672
2021,Stockport 002A,E01005887,1729,891,838
2021,Stockport 002B,E01005890,1527,808,719
2021,Stockport 002C,E01005893,2187,1034,1153
2021,Stockport 002D,E01005896,1665,835,830
2021,Stockport 002E,E01005919,1542,835,707
2021,Stockport 003A,E01005862,1476,747,729
2021,Stockport 003B,E01005892,1272,639,633
2021,Stockport 003C,E01005895,1167,631,536
2021,Stockport 003D,E01005920,1601,813,788
2021,Stockport 003E,E01005921,1470,779,691
2021,Stockport 003F,E01005922,1314,684,630
2021,Stockport 004A,E01005753,1840,993,847
2021,Stockport 004B,E01005754,2005,926,1079
2021,Stockport 004C,E01005755,1736,946,790
2021,Stockport 004D,E01005756,2378,1180,1198
2021,Stockport 005A,E01005745,1375,696,679
2021,Stockport 005B,E01005746,1449,744,705
2021,Stockport 005C,E01005747,1403,729,674
2021,Stockport 005D,E01005748,1512,784,728
2021,Stockport 006A,E01005863,1719,867,852
2021,Stockport 006B,E01005864,1576,802,774
2021,Stockport 006C,E01005866,1669,805,864
2021,Stockport 006D,E01005869,1593,814,779
2021,Stockport 007A,E01005914,1418,708,710
2021,Stockport 007B,E01005915,1549,806,743
2021,Stockport 007C,E01005916,1614,812,802
2021,Stockport 007D,E01005917,1829,914,915
2021,Stockport 008A,E01005859,1411,686,725
2021,Stockport 008B,E01005865,1961,1025,936
2021,Stockport 008C,E01005867,1482,765,717
2021,Stockport 008D,E01005868,1522,746,776
2021,Stockport 009A,E01005743,1274,646,628
2021,Stockport 009B,E01005744,1554,828,726
2021,Stockport 009C,E01005749,1654,860,794
2021,Stockport 009D,E01005750,1669,857,812
2021,Stockport 009E,E01005751,1400,691,709
2021,Stockport 010A,E01005897,1528,784,744
2021,Stockport 010B,E01005898,1708,886,822
2021,Stockport 010C,E01005900,1608,819,789
2021,Stockport 010D,E01005903,1457,754,703
2021,Stockport 010E,E01005904,1530,797,733
2021,Stockport 011A,E01005853,1615,829,786
2021,Stockport 011B,E01005856,1600,824,776
2021,Stockport 011C,E01005860,1516,798,718
2021,Stockport 011D,E01005861,1543,790,753
2021,Stockport 012A,E01005752,1405,740,665
2021,Stockport 012B,E01005899,1619,868,751
2021,Stockport 012C,E01005901,1367,697,670
2021,Stockport 012D,E01005902,1620,856,764
2021,Stockport 012E,E01005905,1511,802,709
2021,Stockport 013A,E01005852,1484,764,720
2021,Stockport 013B,E01005854,1730,879,851
2021,Stockport 013C,E01005855,1482,740,742
2021,Stockport 013D,E01005857,1626,827,799
2021,Stockport 013E,E01005858,1580,819,761
2021,Stockport 014A,E01005757,1603,815,788
2021,Stockport 014C,E01005766,1779,864,915
2021,Stockport 014D,E01005918,1616,778,838
2021,Stockport 014E,E01033947,1540,769,771
2021,Stockport 014F,E01033948,1349,663,686
2021,Stockport 015A,E01005870,1374,687,687
2021,Stockport 015B,E01005871,1382,706,676
2021,Stockport 015C,E01005873,1469,775,694
2021,Stockport 015D,E01005875,1562,788,774
2021,Stockport 016A,E01005764,1607,848,759
2021,Stockport 016B,E01005816,1563,784,779
2021,Stockport 016C,E01005817,1392,710,682
2021,Stockport 016D,E01005822,1896,934,962
2021,Stockport 017A,E01005880,1488,768,720
2021,Stockport 017B,E01005881,1210,618,592
2021,Stockport 017C,E01005883,1519,784,735
2021,Stockport 017D,E01005908,1644,847,797
2021,Stockport 018A,E01005765,1379,718,661
2021,Stockport 018B,E01005818,1400,709,691
2021,Stockport 018C,E01005819,1595,826,769
2021,Stockport 018D,E01005820,1489,776,713
2021,Stockport 018E,E01005821,1412,738,674
2021,Stockport 018F,E01005823,1646,829,817
2021,Stockport 019A,E01005825,1676,921,755
2021,Stockport 019B,E01005872,1646,837,809
2021,Stockport 019C,E01005874,1875,918,957
2021,Stockport 019D,E01005876,1495,751,744
2021,Stockport 019E,E01005877,1738,901,837
2021,Stockport 020A,E01005878,1749,913,836
2021,Stockport 020B,E01005879,1318,672,646
2021,Stockport 020C,E01005882,1274,653,621
2021,Stockport 020D,E01005884,1435,752,683
2021,Stockport 020E,E01005885,1491,788,703
2021,Stockport 021A,E01005832,1421,716,705
2021,Stockport 021B,E01005833,1040,530,510
2021,Stockport 021C,E01005835,1393,696,697
2021,Stockport 021D,E01005837,1545,794,751
2021,Stockport 021E,E01005843,1450,740,710
2021,Stockport 022A,E01005769,1552,846,706
2021,Stockport 022B,E01005778,1408,730,678
2021,Stockport 022C,E01005779,1472,774,698
2021,Stockport 022D,E01005780,1482,750,732
2021,Stockport 022E,E01005781,1655,849,806
2021,Stockport 023A,E01005759,1677,855,822
2021,Stockport 023B,E01005760,1929,979,950
2021,Stockport 023C,E01005797,1414,759,655
2021,Stockport 023D,E01005800,1615,826,789
2021,Stockport 023E,E01005804,1134,594,540
2021,Stockport 024A,E01005824,1508,755,753
2021,Stockport 024B,E01005826,1611,882,729
2021,Stockport 024C,E01005827,1752,911,841
2021,Stockport 024D,E01005828,1375,709,666
2021,Stockport 024E,E01005829,1192,633,559
2021,Stockport 025A,E01005768,2066,1064,1002
2021,Stockport 025B,E01005770,1497,772,725
2021,Stockport 025C,E01005771,1439,745,694
2021,Stockport 025D,E01005775,1665,860,805
2021,Stockport 026A,E01005761,1409,700,709
2021,Stockport 026B,E01005762,1973,1040,933
2021,Stockport 026C,E01005763,1733,903,830
2021,Stockport 026D,E01005799,1874,965,909
2021,Stockport 027A,E01005798,1642,834,808
2021,Stockport 027B,E01005801,2216,1132,1084
2021,Stockport 027C,E01005802,1482,721,761
2021,Stockport 027D,E01005803,1394,715,679
2021,Stockport 027E,E01005830,1541,800,741
2021,Stockport 027F,E01005831,1645,844,801
2021,Stockport 028A,E01005767,1633,824,809
2021,Stockport 028B,E01005772,1550,798,752
2021,Stockport 028C,E01005773,1572,831,741
2021,Stockport 028D,E01005774,1550,831,719
2021,Stockport 028E,E01005776,1716,888,828
2021,Stockport 029A,E01005909,1532,805,727
2021,Stockport 029B,E01005910,1614,837,777
2021,Stockport 029C,E01005911,1330,680,650
2021,Stockport 029D,E01005912,1497,768,729
2021,Stockport 030A,E01005782,1278,656,622
2021,Stockport 030B,E01005783,1546,775,771
2021,Stockport 030C,E01005784,1494,771,723
2021,Stockport 030D,E01005785,1673,866,807
2021,Stockport 030E,E01005786,1848,929,919
2021,Stockport 031A,E01005834,1542,780,762
2021,Stockport 031B,E01005836,1833,952,881
2021,Stockport 031C,E01005838,1780,924,856
2021,Stockport 031D,E01005840,1603,827,776
2021,Stockport 032A,E01005927,1305,669,636
2021,Stockport 032B,E01005928,1619,840,779
2021,Stockport 032C,E01005929,1420,726,694
2021,Stockport 032D,E01005930,1678,875,803
2021,Stockport 033A,E01005806,1187,584,603
2021,Stockport 033B,E01005813,1365,704,661
2021,Stockport 033C,E01005814,1296,682,614
2021,Stockport 033D,E01005815,1436,730,706
2021,Stockport 034A,E01005777,1558,809,749
2021,Stockport 034B,E01005787,1331,670,661
2021,Stockport 034C,E01005788,1565,801,764
2021,Stockport 034D,E01005790,1221,624,597
2021,Stockport 035A,E01005805,1538,759,779
2021,Stockport 035B,E01005807,1550,781,769
2021,Stockport 035C,E01005839,1296,681,615
2021,Stockport 035D,E01005841,1480,733,747
2021,Stockport 036A,E01005844,1548,815,733
2021,Stockport 036B,E01005845,1657,848,809
2021,Stockport 036C,E01005849,1654,868,786
2021,Stockport 036D,E01005851,1622,822,800
2021,Stockport 037A,E01005808,1375,714,661
2021,Stockport 037B,E01005809,1226,637,589
2021,Stockport 037C,E01005810,1560,809,751
2021,Stockport 037D,E01005811,1300,690,610
2021,Stockport 037E,E01005812,1206,610,596
2021,Stockport 038A,E01005842,1579,816,763
2021,Stockport 038B,E01005906,1436,734,702
2021,Stockport 038C,E01005907,1348,690,658
2021,Stockport 038D,E01005913,1419,721,698
2021,Stockport 039A,E01005789,1671,868,803
2021,Stockport 039B,E01005791,1569,800,769
2021,Stockport 039C,E01005793,1525,808,717
2021,Stockport 039D,E01005795,1364,720,644
2021,Stockport 039E,E01005796,1247,645,602
2021,Stockport 040A,E01005846,1714,852,862
2021,Stockport 040B,E01005847,1577,808,769
2021,Stockport 040C,E01005848,2083,1059,1024
2021,Stockport 040D,E01005850,1806,928,878
2021,Stockport 041A,E01005792,1531,792,739
2021,Stockport 041B,E01005794,1267,647,620
2021,Stockport 041C,E01005923,1498,783,715
2021,Stockport 041D,E01005931,1394,737,657
2021,Stockport 042A,E01005924,1305,692,613
2021,Stockport 042B,E01005925,1433,748,685
2021,Stockport 042C,E01005926,2242,1115,1127
2021,Stockport 042D,E01005932,1279,664,615
2021,Tameside 001A,E01006053,1947,993,954
2021,Tameside 001B,E01006054,1807,952,855
2021,Tameside 001C,E01006055,1505,771,734
2021,Tameside 001D,E01006057,1529,782,747
2021,Tameside 001E,E01006058,2076,1017,1059
2021,Tameside 001F,E01006059,1447,727,720
2021,Tameside 002A,E01005938,1567,766,801
2021,Tameside 002B,E01005939,1271,639,632
2021,Tameside 002C,E01005940,1400,710,690
2021,Tameside 002D,E01005955,1633,824,809
2021,Tameside 003A,E01006056,1250,629,621
2021,Tameside 003B,E01006061,2479,1305,1174
2021,Tameside 003C,E01006062,1989,1019,970
2021,Tameside 003D,E01006063,1383,692,691
2021,Tameside 004A,E01005936,1516,771,745
2021,Tameside 004B,E01005937,1707,893,814
2021,Tameside 004C,E01005945,2043,1117,926
2021,Tameside 004D,E01005946,1587,828,759
2021,Tameside 004E,E01005947,1841,929,912
2021,Tameside 005A,E01005954,1496,753,743
2021,Tameside 005B,E01005956,1375,708,667
2021,Tameside 005C,E01005957,1561,796,765
2021,Tameside 005D,E01005958,1607,808,799
2021,Tameside 005E,E01005959,1952,1019,933
2021,Tameside 006A,E01005933,1574,815,759
2021,Tameside 006B,E01005934,1507,765,742
2021,Tameside 006C,E01005935,1465,762,703
2021,Tameside 006D,E01005949,1653,839,814
2021,Tameside 006E,E01005960,1746,894,852
2021,Tameside 007A,E01005941,1884,882,1002
2021,Tameside 007B,E01005942,1661,823,838
2021,Tameside 007C,E01005943,1817,918,899
2021,Tameside 007D,E01005944,1853,928,925
2021,Tameside 008A,E01006060,1510,744,766
2021,Tameside 008B,E01006064,1728,871,857
2021,Tameside 008C,E01006065,1460,766,694
2021,Tameside 008D,E01006066,1416,715,701
2021,Tameside 009A,E01006067,1875,960,915
2021,Tameside 009B,E01006068,1559,781,778
2021,Tameside 009C,E01006069,1740,937,803
2021,Tameside 009D,E01006073,2044,1029,1015
2021,Tameside 010A,E01005993,1350,703,647
2021,Tameside 010B,E01005995,1372,705,667
2021,Tameside 010C,E01005996,1948,974,974
2021,Tameside 010D,E01005997,1536,783,753
2021,Tameside 010E,E01006000,1787,900,887
2021,Tameside 011A,E01005994,1508,794,714
2021,Tameside 011B,E01005999,2190,1054,1136
2021,Tameside 011C,E01006002,1370,728,642
2021,Tameside 011D,E01006004,1524,780,744
2021,Tameside 011E,E01006005,1393,753,640
2021,Tameside 011F,E01006007,1553,800,753
2021,Tameside 012A,E01005998,1881,967,914
2021,Tameside 012B,E01006001,1546,750,796
2021,Tameside 012C,E01006003,1530,791,739
2021,Tameside 012D,E01006006,1426,701,725
2021,Tameside 013A,E01005948,2315,1030,1285
2021,Tameside 013B,E01005950,2174,1105,1069
2021,Tameside 013C,E01005951,1857,942,915
2021,Tameside 013E,E01005953,2297,1163,1134
2021,Tameside 013F,E01033949,1190,578,612
2021,Tameside 013G,E01033950,1371,657,714
2021,Tameside 014A,E01005961,2962,1512,1450
2021,Tameside 014B,E01005962,1419,739,680
2021,Tameside 014C,E01005968,1377,717,660
2021,Tameside 014D,E01005969,1299,671,628
2021,Tameside 015A,E01006022,1936,927,1009
2021,Tameside 015B,E01006023,1577,763,814
2021,Tameside 015C,E01006070,1399,714,685
2021,Tameside 015D,E01006071,1710,847,863
2021,Tameside 015E,E01006072,1615,841,774
2021,Tameside 016A,E01006009,1329,666,663
2021,Tameside 016B,E01006017,1398,699,699
2021,Tameside 016C,E01006018,1316,668,648
2021,Tameside 016D,E01006021,1366,695,671
2021,Tameside 017A,E01006008,1386,678,708
2021,Tameside 017B,E01006010,1403,712,691
2021,Tameside 017C,E01006012,1961,1004,957
2021,Tameside 017D,E01006015,1344,709,635
2021,Tameside 017E,E01006016,1944,930,1014
2021,Tameside 018A,E01006011,1709,888,821
2021,Tameside 018B,E01006013,1307,684,623
2021,Tameside 018C,E01006014,1282,660,622
2021,Tameside 018D,E01006019,1503,776,727
2021,Tameside 018E,E01006020,1638,892,746
2021,Tameside 019A,E01005963,1161,599,562
2021,Tameside 019B,E01005964,1522,786,736
2021,Tameside 019C,E01005965,1733,916,817
2021,Tameside 019D,E01005966,1578,807,771
2021,Tameside 019E,E01005967,1424,673,751
2021,Tameside 020A,E01006031,2255,1140,1115
2021,Tameside 020B,E01006032,1528,777,751
2021,Tameside 020C,E01006033,1768,905,863
2021,Tameside 020D,E01006034,2132,1085,1047
2021,Tameside 020E,E01006035,2147,1091,1056
2021,Tameside 020F,E01006036,2152,1131,1021
2021,Tameside 021A,E01005970,1413,703,710
2021,Tameside 021B,E01005972,1720,898,822
2021,Tameside 021C,E01005974,1692,861,831
2021,Tameside 021D,E01005975,1546,832,714
2021,Tameside 022A,E01006024,1764,888,876
2021,Tameside 022B,E01006026,1527,797,730
2021,Tameside 022C,E01006037,1601,806,795
2021,Tameside 022D,E01006038,1586,820,766
2021,Tameside 023A,E01006047,1326,661,665
2021,Tameside 023B,E01006048,1596,808,788
2021,Tameside 023C,E01006049,1545,766,779
2021,Tameside 023D,E01006051,1628,839,789
2021,Tameside 024A,E01005985,1554,786,768
2021,Tameside 024B,E01005987,1518,802,716
2021,Tameside 024C,E01005988,1600,818,782
2021,Tameside 024D,E01005990,1373,693,680
2021,Tameside 024E,E01005991,1496,774,722
2021,Tameside 025A,E01005971,1354,676,678
2021,Tameside 025B,E01005986,1245,638,607
2021,Tameside 025C,E01005989,1206,609,597
2021,Tameside 025D,E01005992,1207,630,577
2021,Tameside 026A,E01005973,1367,686,681
2021,Tameside 026B,E01005976,1482,769,713
2021,Tameside 026C,E01005977,1450,751,699
2021,Tameside 026D,E01005978,1335,705,630
2021,Tameside 027A,E01006025,1917,980,937
2021,Tameside 027B,E01006027,2343,1201,1142
2021,Tameside 027C,E01006050,1841,991,850
2021,Tameside 027D,E01006052,1580,798,782
2021,Tameside 028A,E01006028,1776,857,919
2021,Tameside 028B,E01006029,1934,1025,909
2021,Tameside 028C,E01006030,1869,965,904
2021,Tameside 028D,E01006039,1353,668,685
2021,Tameside 028E,E01006040,1891,983,908
2021,Tameside 028F,E01006041,1721,873,848
2021,Tameside 029A,E01005979,1586,820,766
2021,Tameside 029B,E01005980,1449,762,687
2021,Tameside 029C,E01005981,1647,881,766
2021,Tameside 029D,E01005982,1326,694,632
2021,Tameside 029E,E01005983,1506,792,714
2021,Tameside 029F,E01005984,1604,809,795
2021,Tameside 030A,E01006042,1696,865,831
2021,Tameside 030B,E01006043,1437,755,682
2021,Tameside 030C,E01006044,1523,799,724
2021,Tameside 030D,E01006045,1253,636,617
2021,Tameside 030E,E01006046,1528,784,744
2021,Trafford 001A,E01006109,1149,497,652
2021,Trafford 001B,E01006110,1876,987,889
2021,Trafford 001C,E01006111,1775,938,837
2021,Trafford 001D,E01006112,2049,1066,983
2021,Trafford 001F,E01006188,1990,1005,985
2021,Trafford 001G,E01034000,1233,595,638
2021,Trafford 001H,E01034001,1647,775,872
2021,Trafford 002A,E01006116,1328,679,649
2021,Trafford 002B,E01006117,1704,881,823
2021,Trafford 002C,E01006118,1462,750,712
2021,Trafford 002D,E01006119,1639,838,801
2021,Trafford 002E,E01006121,1448,758,690
2021,Trafford 003A,E01006141,1791,915,876
2021,Trafford 003B,E01006186,2160,1096,1064
2021,Trafford 003C,E01006187,2599,1314,1285
2021,Trafford 003D,E01006189,2328,1147,1181
2021,Trafford 004A,E01006113,1619,834,785
2021,Trafford 004B,E01006114,1693,879,814
2021,Trafford 004C,E01006115,1518,777,741
2021,Trafford 004D,E01006145,2051,1060,991
2021,Trafford 004E,E01006146,1793,880,913
2021,Trafford 005A,E01006122,1785,894,891
2021,Trafford 005B,E01006123,1671,855,816
2021,Trafford 005C,E01006124,1479,765,714
2021,Trafford 005D,E01006128,1929,1023,906
2021,Trafford 005E,E01006131,1529,763,766
2021,Trafford 006A,E01006155,1749,890,859
2021,Trafford 006B,E01006157,1701,852,849
2021,Trafford 006C,E01006159,1875,1009,866
2021,Trafford 006D,E01006182,1606,835,771
2021,Trafford 006E,E01006183,1724,845,879
2021,Trafford 007A,E01006125,1511,783,728
2021,Trafford 007B,E01006126,1838,989,849
2021,Trafford 007C,E01006127,1545,819,726
2021,Trafford 007D,E01006130,1760,891,869
2021,Trafford 007E,E01006132,1539,769,770
2021,Trafford 008A,E01006156,1674,891,783
2021,Trafford 008B,E01006158,1749,923,826
2021,Trafford 008C,E01006179,1802,916,886
2021,Trafford 008D,E01006184,1699,863,836
2021,Trafford 009A,E01006198,1463,762,701
2021,Trafford 009B,E01006199,1535,838,697
2021,Trafford 009C,E01006200,1481,791,690
2021,Trafford 009D,E01006201,1467,717,750
2021,Trafford 009E,E01006202,1299,650,649
2021,Trafford 010A,E01006120,1430,732,698
2021,Trafford 010B,E01006129,1384,729,655
2021,Trafford 010C,E01006133,1416,743,673
2021,Trafford 010D,E01006197,1478,792,686
2021,Trafford 010E,E01006203,1332,672,660
2021,Trafford 011A,E01006142,1716,882,834
2021,Trafford 011B,E01006143,1668,832,836
2021,Trafford 011C,E01006144,1386,741,645
2021,Trafford 011D,E01006180,1840,946,894
2021,Trafford 011E,E01006181,1745,871,874
2021,Trafford 012A,E01006147,1443,726,717
2021,Trafford 012B,E01006149,1578,834,744
2021,Trafford 012C,E01006150,1919,974,945
2021,Trafford 012D,E01006154,1603,791,812
2021,Trafford 012E,E01006165,2007,1036,971
2021,Trafford 013A,E01006166,1640,873,767
2021,Trafford 013B,E01006169,1647,851,796
2021,Trafford 013C,E01006170,1602,832,770
2021,Trafford 013D,E01006171,1755,898,857
2021,Trafford 014A,E01006098,1337,689,648
2021,Trafford 014B,E01006099,1324,685,639
2021,Trafford 014C,E01006164,1762,890,872
2021,Trafford 014D,E01006174,1788,896,892
2021,Trafford 014E,E01006178,1813,916,897
2021,Trafford 015A,E01006097,1783,888,895
2021,Trafford 015B,E01006160,2140,1062,1078
2021,Trafford 015C,E01006161,2158,1071,1087
2021,Trafford 015D,E01006162,1622,809,813
2021,Trafford 015E,E01006163,1832,945,887
2021,Trafford 016A,E01006148,1698,857,841
2021,Trafford 016B,E01006151,1583,812,771
2021,Trafford 016C,E01006152,1639,841,798
2021,Trafford 016D,E01006153,1600,833,767
2021,Trafford 016E,E01006172,1540,790,750
2021,Trafford 017A,E01006104,1687,882,805
2021,Trafford 017B,E01006105,1767,935,832
2021,Trafford 017C,E01006106,1474,789,685
2021,Trafford 017D,E01006107,1594,843,751
2021,Trafford 017E,E01006108,1667,881,786
2021,Trafford 018A,E01006102,1404,751,653
2021,Trafford 018B,E01006173,1550,781,769
2021,Trafford 018C,E01006175,1776,967,809
2021,Trafford 018D,E01006176,1734,905,829
2021,Trafford 018E,E01006177,1653,857,796
2021,Trafford 019A,E01006091,2970,1528,1442
2021,Trafford 019B,E01006092,1331,717,614
2021,Trafford 019C,E01006095,1658,837,821
2021,Trafford 019D,E01006167,1579,819,760
2021,Trafford 019E,E01006168,1812,977,835
2021,Trafford 020A,E01006090,2300,1156,1144
2021,Trafford 020B,E01006094,1603,795,808
2021,Trafford 020C,E01006096,1610,811,799
2021,Trafford 020D,E01006100,1488,747,741
2021,Trafford 020E,E01006103,1694,838,856
2021,Trafford 021A,E01006101,1495,727,768
2021,Trafford 021B,E01006190,1687,862,825
2021,Trafford 021C,E01006195,1795,894,901
2021,Trafford 021D,E01006196,1700,850,850
2021,Trafford 021E,E01006210,1609,820,789
2021,Trafford 022A,E01006204,1620,871,749
2021,Trafford 022B,E01006206,1869,973,896
2021,Trafford 022C,E01006207,1748,898,850
2021,Trafford 022D,E01006208,1551,805,746
2021,Trafford 022E,E01006211,1613,848,765
2021,Trafford 023A,E01006093,1527,795,732
2021,Trafford 023B,E01006191,1708,895,813
2021,Trafford 023C,E01006192,1517,804,713
2021,Trafford 023D,E01006205,1342,687,655
2021,Trafford 023E,E01006209,1642,848,794
2021,Trafford 024A,E01006078,2122,1065,1057
2021,Trafford 024B,E01006080,1968,1027,941
2021,Trafford 024C,E01006089,2014,1032,982
2021,Trafford 024D,E01006193,1569,816,753
2021,Trafford 024E,E01006194,2430,1255,1175
2021,Trafford 025A,E01006074,1642,844,798
2021,Trafford 025B,E01006075,2146,1063,1083
2021,Trafford 025C,E01006076,1675,867,808
2021,Trafford 025D,E01006079,2598,1308,1290
2021,Trafford 025E,E01006087,1452,728,724
2021,Trafford 026A,E01006083,1279,645,634
2021,Trafford 026B,E01006084,1742,895,847
2021,Trafford 026C,E01006088,1630,824,806
2021,Trafford 026D,E01006139,1803,914,889
2021,Trafford 026E,E01006140,1697,867,830
2021,Trafford 027A,E01006077,1644,861,783
2021,Trafford 027B,E01006081,1385,708,677
2021,Trafford 027C,E01006082,1498,772,726
2021,Trafford 027D,E01006085,1542,821,721
2021,Trafford 027E,E01006086,1688,886,802
2021,Trafford 028A,E01006134,1493,747,746
2021,Trafford 028B,E01006135,1768,936,832
2021,Trafford 028C,E01006136,1703,876,827
2021,Trafford 028D,E01006137,1421,756,665
2021,Trafford 028E,E01006138,1893,991,902
2021,Wigan 001A,E01006315,1503,740,763
2021,Wigan 001B,E01006316,2002,1024,978
2021,Wigan 001C,E01006317,1549,819,730
2021,Wigan 001D,E01006319,1573,801,772
2021,Wigan 002A,E01006229,1377,702,675
2021,Wigan 002B,E01006230,2122,1043,1079
2021,Wigan 002C,E01006233,1404,720,684
2021,Wigan 002D,E01006237,1922,951,971
2021,Wigan 002E,E01006238,1509,806,703
2021,Wigan 003A,E01006259,1316,670,646
2021,Wigan 003B,E01006312,1370,714,656
2021,Wigan 003C,E01006313,1458,732,726
2021,Wigan 003D,E01006314,1724,876,848
2021,Wigan 003E,E01006318,1426,719,707
2021,Wigan 003F,E01006320,1279,653,626
2021,Wigan 003G,E01006321,1601,786,815
2021,Wigan 004A,E01006231,1467,764,703
2021,Wigan 004B,E01006232,1989,1026,963
2021,Wigan 004C,E01006234,1145,570,575
2021,Wigan 004D,E01006235,1528,799,729
2021,Wigan 005A,E01006253,1523,770,753
2021,Wigan 005B,E01006254,1574,799,775
2021,Wigan 005C,E01006255,1492,764,728
2021,Wigan 005D,E01006256,1709,853,856
2021,Wigan 005E,E01006260,1517,792,725
2021,Wigan 006A,E01006370,1886,828,1058
2021,Wigan 006B,E01006372,1609,824,785
2021,Wigan 006C,E01006373,1459,733,726
2021,Wigan 006D,E01006374,1463,753,710
2021,Wigan 006E,E01006390,1613,848,765
2021,Wigan 007A,E01006236,1573,820,753
2021,Wigan 007B,E01006388,1837,923,914
2021,Wigan 007C,E01006389,1318,680,638
2021,Wigan 007D,E01006391,1530,781,749
2021,Wigan 008A,E01006257,1204,619,585
2021,Wigan 008B,E01006258,1601,823,778
2021,Wigan 008C,E01006369,2031,972,1059
2021,Wigan 008D,E01006371,1476,720,756
2021,Wigan 008E,E01006375,1683,829,854
2021,Wigan 009A,E01006306,1479,700,779
2021,Wigan 009B,E01006307,1374,671,703
2021,Wigan 009C,E01006386,1587,709,878
2021,Wigan 009D,E01006387,1316,679,637
2021,Wigan 009E,E01006392,1476,736,740
2021,Wigan 010A,E01006350,1858,953,905
2021,Wigan 010B,E01006351,2022,1071,951
2021,Wigan 010C,E01006357,1832,932,900
2021,Wigan 010D,E01006360,1680,864,816
2021,Wigan 010E,E01006361,1661,850,811
2021,Wigan 011A,E01006356,1434,689,745
2021,Wigan 011B,E01006396,1480,744,736
2021,Wigan 011C,E01006397,1080,563,517
2021,Wigan 011D,E01006398,1008,514,494
2021,Wigan 011E,E01006399,1603,809,794
2021,Wigan 012A,E01006305,1710,883,827
2021,Wigan 012B,E01006308,1620,814,806
2021,Wigan 012C,E01006309,1669,838,831
2021,Wigan 012D,E01006310,1589,781,808
2021,Wigan 012E,E01006311,1534,797,737
2021,Wigan 013A,E01006269,1737,891,846
2021,Wigan 013B,E01006271,1681,845,836
2021,Wigan 013C,E01006272,1635,804,831
2021,Wigan 013D,E01006273,1482,750,732
2021,Wigan 013E,E01006276,2154,1103,1051
2021,Wigan 014A,E01006353,1458,727,731
2021,Wigan 014B,E01006354,1440,716,724
2021,Wigan 014C,E01006355,1473,762,711
2021,Wigan 014D,E01006358,2133,1106,1027
2021,Wigan 014E,E01006359,1384,686,698
2021,Wigan 015A,E01006349,2037,997,1040
2021,Wigan 015B,E01006352,2034,1036,998
2021,Wigan 015C,E01006404,1781,888,893
2021,Wigan 015D,E01006405,1747,889,858
2021,Wigan 015E,E01006411,1433,737,696
2021,Wigan 016A,E01006270,1444,722,722
2021,Wigan 016B,E01006274,1531,795,736
2021,Wigan 016C,E01006275,1572,798,774
2021,Wigan 016D,E01006277,1877,934,943
2021,Wigan 016E,E01006286,1558,792,766
2021,Wigan 017A,E01006239,2082,1039,1043
2021,Wigan 017B,E01006240,1573,816,757
2021,Wigan 017C,E01006241,2539,1281,1258
2021,Wigan 017D,E01006287,1145,581,564
2021,Wigan 017E,E01006289,1689,844,845
2021,Wigan 018A,E01006362,1634,827,807
2021,Wigan 018B,E01006363,1516,765,751
2021,Wigan 018C,E01006364,1831,946,885
2021,Wigan 018D,E01006365,2266,1160,1106
2021,Wigan 018E,E01006366,1850,937,913
2021,Wigan 018F,E01006367,1781,922,859
2021,Wigan 018G,E01006368,1884,956,928
2021,Wigan 019A,E01006278,1631,841,790
2021,Wigan 019B,E01006279,1577,786,791
2021,Wigan 019C,E01006280,1455,755,700
2021,Wigan 019D,E01006281,1938,986,952
2021,Wigan 019E,E01006285,1916,970,946
2021,Wigan 020A,E01006406,1377,698,679
2021,Wigan 020B,E01006407,1453,732,721
2021,Wigan 020C,E01006408,1749,906,843
2021,Wigan 020D,E01006409,1298,647,651
2021,Wigan 020E,E01006410,1272,652,620
2021,Wigan 021A,E01006393,1382,694,688
2021,Wigan 021B,E01006394,1540,810,730
2021,Wigan 021C,E01006395,2628,1338,1290
2021,Wigan 021D,E01006400,1995,1025,970
2021,Wigan 021E,E01006401,1354,688,666
2021,Wigan 021F,E01006402,1128,562,566
2021,Wigan 021G,E01006403,1626,827,799
2021,Wigan 022A,E01006290,1389,714,675
2021,Wigan 022B,E01006291,1463,758,705
2021,Wigan 022C,E01006292,1500,748,752
2021,Wigan 022D,E01006293,1618,810,808
2021,Wigan 023A,E01006242,1929,998,931
2021,Wigan 023B,E01006243,2120,1064,1056
2021,Wigan 023C,E01006244,1676,868,808
2021,Wigan 023D,E01006245,2629,1320,1309
2021,Wigan 024A,E01006213,1518,772,746
2021,Wigan 024B,E01006215,1712,850,862
2021,Wigan 024C,E01006217,2378,1210,1168
2021,Wigan 024D,E01006218,2432,1221,1211
2021,Wigan 024E,E01006219,1184,604,580
2021,Wigan 025A,E01006288,1824,958,866
2021,Wigan 025B,E01006294,1940,964,976
2021,Wigan 025C,E01006295,1568,768,800
2021,Wigan 025D,E01006377,1557,804,753
2021,Wigan 025E,E01006378,1303,661,642
2021,Wigan 026A,E01006212,1392,682,710
2021,Wigan 026B,E01006214,1379,700,679
2021,Wigan 026C,E01006216,2190,1107,1083
2021,Wigan 026D,E01006322,2089,1037,1052
2021,Wigan 026E,E01006329,1637,564,1073
2021,Wigan 027A,E01006282,1857,924,933
2021,Wigan 027B,E01006283,1584,779,805
2021,Wigan 027C,E01006284,1577,774,803
2021,Wigan 027D,E01006336,1658,861,797
2021,Wigan 027E,E01006337,1496,758,738
2021,Wigan 028A,E01006376,1771,900,871
2021,Wigan 028B,E01006381,2050,1019,1031
2021,Wigan 028C,E01006382,1257,639,618
2021,Wigan 028D,E01006383,1609,819,790
2021,Wigan 028E,E01006384,1321,664,657
2021,Wigan 029A,E01006250,2138,1087,1051
2021,Wigan 029B,E01006251,1544,769,775
2021,Wigan 029C,E01006379,1581,795,786
2021,Wigan 029D,E01006380,2731,1403,1328
2021,Wigan 029E,E01006385,1445,750,695
2021,Wigan 030A,E01006328,1525,760,765
2021,Wigan 030B,E01006333,2087,978,1109
2021,Wigan 030C,E01006334,2076,1014,1062
2021,Wigan 030D,E01006338,1668,845,823
2021,Wigan 031A,E01006248,2280,1130,1150
2021,Wigan 031B,E01006249,1655,877,778
2021,Wigan 031C,E01006330,1535,771,764
2021,Wigan 031D,E01006331,1515,749,766
2021,Wigan 031E,E01006332,2015,1018,997
2021,Wigan 032A,E01006262,1710,844,866
2021,Wigan 032B,E01006263,1490,759,731
2021,Wigan 032C,E01006266,1373,708,665
2021,Wigan 032D,E01006267,1620,794,826
2021,Wigan 032E,E01006268,1639,832,807
2021,Wigan 033A,E01006323,1552,765,787
2021,Wigan 033B,E01006324,1291,635,656
2021,Wigan 033C,E01006325,1505,755,750
2021,Wigan 033D,E01006326,1412,689,723
2021,Wigan 033E,E01006327,2562,1281,1281
2021,Wigan 034A,E01006246,1535,789,746
2021,Wigan 034B,E01006247,1282,654,628
2021,Wigan 034C,E01006252,1399,739,660
2021,Wigan 034D,E01006297,1595,843,752
2021,Wigan 034E,E01006335,1578,804,774
2021,Wigan 035A,E01006220,1742,894,848
2021,Wigan 035B,E01006221,1560,788,772
2021,Wigan 035C,E01006222,1556,782,774
2021,Wigan 035D,E01006224,1433,712,721
2021,Wigan 035E,E01006226,1714,869,845
2021,Wigan 036A,E01006223,1586,792,794
2021,Wigan 036B,E01006225,1507,782,725
2021,Wigan 036C,E01006261,1487,792,695
2021,Wigan 036D,E01006264,1230,618,612
2021,Wigan 036E,E01006265,1396,727,669
2021,Wigan 037A,E01006296,1503,766,737
2021,Wigan 037B,E01006298,1424,749,675
2021,Wigan 037C,E01006299,1935,958,977
2021,Wigan 037D,E01006300,1359,689,670
2021,Wigan 037E,E01006301,1484,767,717
2021,Wigan 038A,E01006227,1581,800,781
2021,Wigan 038B,E01006228,1628,785,843
2021,Wigan 038C,E01006342,1556,775,781
2021,Wigan 038D,E01006344,1440,784,656
2021,Wigan 038E,E01006346,2062,1006,1056
2021,Wigan 039A,E01006339,1254,659,595
2021,Wigan 039B,E01006340,1888,949,939
2021,Wigan 039C,E01006343,1612,817,795
2021,Wigan 039D,E01006345,1559,820,739
2021,Wigan 039E,E01006348,2643,1336,1307
2021,Wigan 040A,E01006302,1835,923,912
2021,Wigan 040B,E01006303,1625,807,818
2021,Wigan 040C,E01006304,1521,772,749
2021,Wigan 040D,E01006341,1664,862,802
2021,Wigan 040E,E01006347,1518,778,740
2021,Birmingham 001A,E01009417,1612,827,785
2021,Birmingham 001B,E01009418,1586,860,726
2021,Birmingham 001C,E01009419,1464,747,717
2021,Birmingham 001D,E01009433,1789,934,855
2021,Birmingham 002A,E01009415,1747,878,869
2021,Birmingham 002B,E01009422,2001,1039,962
2021,Birmingham 002C,E01009423,1672,884,788
2021,Birmingham 002D,E01009425,1722,902,820
2021,Birmingham 003A,E01009416,2795,1449,1346
2021,Birmingham 003B,E01009420,1702,889,813
2021,Birmingham 003C,E01009426,1477,766,711
2021,Birmingham 003D,E01009429,1496,757,739
2021,Birmingham 003E,E01009431,1689,863,826
2021,Birmingham 004A,E01009421,1715,895,820
2021,Birmingham 004B,E01009424,1582,810,772
2021,Birmingham 004C,E01009427,1489,728,761
2021,Birmingham 004D,E01009428,1681,853,828
2021,Birmingham 004E,E01009430,1724,867,857
2021,Birmingham 004F,E01009468,1495,780,715
2021,Birmingham 005A,E01009445,1892,1063,829
2021,Birmingham 005B,E01009446,2488,1325,1163
2021,Birmingham 005C,E01009447,1651,842,809
2021,Birmingham 005D,E01009448,1651,863,788
2021,Birmingham 005E,E01009452,1706,899,807
2021,Birmingham 005F,E01009455,1295,658,637
2021,Birmingham 006A,E01009432,1499,763,736
2021,Birmingham 006B,E01009435,1717,897,820
2021,Birmingham 006C,E01009437,1792,920,872
2021,Birmingham 006D,E01009444,1499,741,758
2021,Birmingham 006E,E01009454,1424,721,703
2021,Birmingham 007A,E01009221,1527,767,760
2021,Birmingham 007B,E01009464,1411,696,715
2021,Birmingham 007C,E01009465,1434,727,707
2021,Birmingham 007D,E01009467,1564,793,771
2021,Birmingham 008A,E01009220,1557,824,733
2021,Birmingham 008B,E01009222,1522,783,739
2021,Birmingham 008C,E01009224,1408,737,671
2021,Birmingham 008D,E01009233,1623,854,769
2021,Birmingham 009A,E01009449,2156,1098,1058
2021,Birmingham 009B,E01009451,1434,738,696
2021,Birmingham 009C,E01009453,1373,687,686
2021,Birmingham 009D,E01009466,1691,889,802
2021,Birmingham 009E,E01009471,1819,939,880
2021,Birmingham 010A,E01009135,1406,695,711
2021,Birmingham 010B,E01009469,1461,759,702
2021,Birmingham 010C,E01009470,1439,731,708
2021,Birmingham 010D,E01009472,1670,864,806
2021,Birmingham 010E,E01009473,1563,799,764
2021,Birmingham 010F,E01009474,1565,793,772
2021,Birmingham 011A,E01009127,1543,804,739
2021,Birmingham 011B,E01009128,1376,697,679
2021,Birmingham 011C,E01009130,1501,771,730
2021,Birmingham 011D,E01009131,1471,743,728
2021,Birmingham 011E,E01009133,1485,780,705
2021,Birmingham 011F,E01009134,1683,852,831
2021,Birmingham 011G,E01009137,1606,844,762
2021,Birmingham 012A,E01009434,1652,858,794
2021,Birmingham 012B,E01009436,1382,698,684
2021,Birmingham 012C,E01009438,1355,694,661
2021,Birmingham 012D,E01009440,1576,845,731
2021,Birmingham 012E,E01009450,1605,812,793
2021,Birmingham 013A,E01009223,1591,853,738
2021,Birmingham 013B,E01009225,1632,874,758
2021,Birmingham 013C,E01009227,1659,850,809
2021,Birmingham 013D,E01009228,1558,797,761
2021,Birmingham 014B,E01009122,1635,860,775
2021,Birmingham 014C,E01009129,1600,824,776
2021,Birmingham 014D,E01009132,1547,780,767
2021,Birmingham 014E,E01009136,1759,935,824
2021,Birmingham 014F,E01034913,1160,637,523
2021,Birmingham 014G,E01034914,1901,1035,866
2021,Birmingham 015A,E01009457,1506,775,731
2021,Birmingham 015B,E01009459,1591,821,770
2021,Birmingham 015C,E01009461,1305,656,649
2021,Birmingham 015D,E01009463,1560,814,746
2021,Birmingham 016A,E01009235,1662,841,821
2021,Birmingham 016B,E01009243,1815,959,856
2021,Birmingham 016C,E01009245,1472,721,751
2021,Birmingham 016D,E01009246,1559,794,765
2021,Birmingham 016E,E01009247,1558,820,738
2021,Birmingham 017A,E01009226,1459,733,726
2021,Birmingham 017B,E01009229,1590,804,786
2021,Birmingham 017C,E01009230,1654,852,802
2021,Birmingham 017D,E01009231,1936,998,938
2021,Birmingham 018A,E01009001,1679,876,803
2021,Birmingham 018B,E01009003,1765,884,881
2021,Birmingham 018C,E01009456,1718,865,853
2021,Birmingham 018D,E01009458,1385,757,628
2021,Birmingham 018E,E01009460,1585,794,791
2021,Birmingham 018F,E01009462,1583,815,768
2021,Birmingham 019A,E01009234,1465,793,672
2021,Birmingham 019B,E01009236,1553,789,764
2021,Birmingham 019C,E01009244,1885,989,896
2021,Birmingham 019D,E01009248,1759,907,852
2021,Birmingham 020A,E01009403,1578,811,767
2021,Birmingham 020B,E01009404,1593,832,761
2021,Birmingham 020C,E01009405,1487,773,714
2021,Birmingham 020D,E01009406,1750,901,849
2021,Birmingham 020E,E01009407,1749,880,869
2021,Birmingham 021A,E01009439,1446,733,713
2021,Birmingham 021B,E01009441,1476,727,749
2021,Birmingham 021C,E01009442,1461,745,716
2021,Birmingham 021D,E01009443,1213,642,571
2021,Birmingham 022A,E01009123,1625,854,771
2021,Birmingham 022B,E01009124,2097,1181,916
2021,Birmingham 022C,E01009125,2037,1046,991
2021,Birmingham 022D,E01009232,1561,819,742
2021,Birmingham 023A,E01009002,2050,1104,946
2021,Birmingham 023C,E01009006,1556,760,796
2021,Birmingham 023D,E01009007,1820,854,966
2021,Birmingham 023G,E01034915,1871,1029,842
2021,Birmingham 023H,E01034916,1495,729,766
2021,Birmingham 024A,E01009237,1472,769,703
2021,Birmingham 024B,E01009238,1756,882,874
2021,Birmingham 024C,E01009240,1524,794,730
2021,Birmingham 024D,E01009241,1781,897,884
2021,Birmingham 024E,E01009242,2072,1001,1071
2021,Birmingham 025A,E01009005,1755,889,866
2021,Birmingham 025B,E01009009,1487,748,739
2021,Birmingham 025C,E01009098,2112,1093,1019
2021,Birmingham 025D,E01009100,1934,1032,902
2021,Birmingham 025E,E01009105,1796,924,872
2021,Birmingham 026A,E01009126,1487,766,721
2021,Birmingham 026B,E01009408,1777,922,855
2021,Birmingham 026C,E01009409,1847,879,968
2021,Birmingham 026D,E01009410,1919,970,949
2021,Birmingham 029A,E01009096,1675,858,817
2021,Birmingham 029B,E01009097,2048,1114,934
2021,Birmingham 029C,E01009099,1759,974,785
2021,Birmingham 029D,E01009101,1520,852,668
2021,Birmingham 029E,E01009103,1575,866,709
2021,Birmingham 029F,E01009106,1358,715,643
2021,Birmingham 030A,E01008915,1781,893,888
2021,Birmingham 030B,E01009411,1899,1001,898
2021,Birmingham 030C,E01009412,1788,851,937
2021,Birmingham 030D,E01009413,1812,886,926
2021,Birmingham 030E,E01009414,2358,1198,1160
2021,Birmingham 031A,E01008998,1914,992,922
2021,Birmingham 031B,E01008999,1586,786,800
2021,Birmingham 031C,E01009000,1738,830,908
2021,Birmingham 031D,E01009013,2018,1011,1007
2021,Birmingham 031E,E01009400,1687,832,855
2021,Birmingham 031F,E01009401,1854,881,973
2021,Birmingham 031H,E01033630,1227,591,636
2021,Birmingham 031I,E01033646,1831,871,960
2021,Birmingham 032A,E01009049,1642,831,811
2021,Birmingham 032B,E01009056,2251,1126,1125
2021,Birmingham 032C,E01009263,1631,811,820
2021,Birmingham 032D,E01009264,1829,981,848
2021,Birmingham 032E,E01009265,1795,878,917
2021,Birmingham 033A,E01009051,1814,902,912
2021,Birmingham 033B,E01009053,1628,807,821
2021,Birmingham 033C,E01009054,1641,850,791
2021,Birmingham 033D,E01009058,1975,942,1033
2021,Birmingham 033E,E01009061,1868,982,886
2021,Birmingham 033F,E01009239,1472,711,761
2021,Birmingham 034A,E01009266,1781,892,889
2021,Birmingham 034B,E01009269,1474,724,750
2021,Birmingham 034C,E01009270,2009,997,1012
2021,Birmingham 034D,E01009271,1621,833,788
2021,Birmingham 034E,E01009273,1587,797,790
2021,Birmingham 035A,E01009050,2264,1165,1099
2021,Birmingham 035D,E01009057,1984,1006,978
2021,Birmingham 035E,E01009059,1796,833,963
2021,Birmingham 035F,E01009060,1753,850,903
2021,Birmingham 035H,E01034917,1673,828,845
2021,Birmingham 035I,E01034918,1738,837,901
2021,Birmingham 036A,E01009268,1471,748,723
2021,Birmingham 036B,E01009272,1394,741,653
2021,Birmingham 036C,E01009274,2065,1010,1055
2021,Birmingham 036D,E01009349,1665,863,802
2021,Birmingham 036E,E01009351,1723,868,855
2021,Birmingham 036F,E01009354,1559,781,778
2021,Birmingham 037A,E01008899,1295,641,654
2021,Birmingham 037C,E01008901,1811,874,937
2021,Birmingham 037E,E01008916,1754,865,889
2021,Birmingham 037G,E01034919,1663,831,832
2021,Birmingham 037H,E01034920,1883,909,974
2021,Birmingham 039A,E01009275,1789,884,905
2021,Birmingham 039B,E01009350,1632,808,824
2021,Birmingham 039C,E01009352,1808,865,943
2021,Birmingham 039D,E01009353,1711,842,869
2021,Birmingham 039E,E01009355,1435,716,719
2021,Birmingham 039I,E01034921,1426,681,745
2021,Birmingham 039J,E01034922,1600,823,777
2021,Birmingham 040A,E01008905,1946,956,990
2021,Birmingham 040B,E01008907,1804,877,927
2021,Birmingham 040C,E01009047,1798,871,927
2021,Birmingham 040D,E01009048,2048,902,1146
2021,Birmingham 040E,E01009062,1856,948,908
2021,Birmingham 041D,E01008909,2124,1122,1002
2021,Birmingham 041H,E01034923,1757,848,909
2021,Birmingham 041I,E01034924,1558,738,820
2021,Birmingham 041J,E01034925,1689,859,830
2021,Birmingham 041K,E01034926,1540,785,755
2021,Birmingham 042A,E01009084,1987,1028,959
2021,Birmingham 042B,E01009085,2098,1086,1012
2021,Birmingham 042C,E01009087,1792,897,895
2021,Birmingham 042D,E01009089,1791,858,933
2021,Birmingham 042E,E01009090,2150,1077,1073
2021,Birmingham 043A,E01009201,1951,997,954
2021,Birmingham 043B,E01009202,1783,945,838
2021,Birmingham 043D,E01034927,1770,954,816
2021,Birmingham 043E,E01034928,1505,785,720
2021,Birmingham 044A,E01009082,1514,797,717
2021,Birmingham 044B,E01009086,2210,1098,1112
2021,Birmingham 044C,E01009480,2092,1070,1022
2021,Birmingham 044D,E01009481,2752,1369,1383
2021,Birmingham 044E,E01009486,2229,1156,1073
2021,Birmingham 044F,E01009487,2196,1130,1066
2021,Birmingham 045A,E01009088,1592,859,733
2021,Birmingham 045B,E01009091,1677,885,792
2021,Birmingham 045C,E01009305,1676,879,797
2021,Birmingham 045D,E01009307,1561,803,758
2021,Birmingham 045E,E01009309,1833,986,847
2021,Birmingham 046A,E01009304,1847,962,885
2021,Birmingham 046B,E01009306,1684,878,806
2021,Birmingham 046C,E01009308,1895,1039,856
2021,Birmingham 046D,E01009310,1997,1109,888
2021,Birmingham 047A,E01009348,2097,1108,989
2021,Birmingham 047B,E01009358,2248,1060,1188
2021,Birmingham 047C,E01009359,2067,1031,1036
2021,Birmingham 047D,E01009360,2785,1475,1310
2021,Birmingham 047E,E01009361,2192,1106,1086
2021,Birmingham 048A,E01009478,2116,1091,1025
2021,Birmingham 048B,E01009479,2236,1136,1100
2021,Birmingham 048C,E01009482,1745,880,865
2021,Birmingham 048D,E01009484,1814,892,922
2021,Birmingham 048E,E01009485,2052,1056,996
2021,Birmingham 049A,E01008906,1987,998,989
2021,Birmingham 049B,E01008911,1943,1002,941
2021,Birmingham 049D,E01009347,1581,835,746
2021,Birmingham 049E,E01033559,1482,636,846
2021,Birmingham 049F,E01033638,1968,992,976
2021,Birmingham 050A,E01008910,1755,897,858
2021,Birmingham 050B,E01008913,2257,1182,1075
2021,Birmingham 050E,E01033561,2592,1380,1212
2021,Birmingham 050F,E01033617,5671,3164,2507
2021,Birmingham 050G,E01034929,1584,836,748
2021,Birmingham 050H,E01034930,2226,1095,1131
2021,Birmingham 051B,E01009483,2071,1010,1061
2021,Birmingham 051C,E01009488,2561,1290,1271
2021,Birmingham 051D,E01009489,2118,1076,1042
2021,Birmingham 051E,E01009491,2201,1102,1099
2021,Birmingham 051F,E01034931,1917,974,943
2021,Birmingham 051G,E01034932,1528,789,739
2021,Birmingham 052B,E01009192,2777,1390,1387
2021,Birmingham 052D,E01009199,1439,729,710
2021,Birmingham 052E,E01009204,2168,1124,1044
2021,Birmingham 052G,E01034933,1499,735,764
2021,Birmingham 052H,E01034934,1639,826,813
2021,Birmingham 053A,E01009151,2146,1132,1014
2021,Birmingham 053B,E01009152,1942,924,1018
2021,Birmingham 053C,E01009153,2103,988,1115
2021,Birmingham 053D,E01009345,2099,857,1242
2021,Birmingham 053E,E01009346,1736,892,844
2021,Birmingham 054A,E01009092,1762,940,822
2021,Birmingham 054B,E01009093,1731,921,810
2021,Birmingham 054C,E01009094,1611,870,741
2021,Birmingham 054D,E01009298,1632,872,760
2021,Birmingham 054E,E01009311,1617,836,781
2021,Birmingham 054F,E01009511,1684,821,863
2021,Birmingham 055A,E01009475,2325,1207,1118
2021,Birmingham 055B,E01009476,2101,1036,1065
2021,Birmingham 055C,E01009477,1883,978,905
2021,Birmingham 055D,E01009490,2161,1079,1082
2021,Birmingham 055E,E01009492,2025,992,1033
2021,Birmingham 056A,E01009095,1842,936,906
2021,Birmingham 056B,E01009507,1621,809,812
2021,Birmingham 056C,E01009508,1647,862,785
2021,Birmingham 056D,E01009509,2053,1002,1051
2021,Birmingham 056E,E01009510,1754,941,813
2021,Birmingham 057A,E01009297,1820,948,872
2021,Birmingham 057B,E01009299,1582,825,757
2021,Birmingham 057C,E01009300,1935,980,955
2021,Birmingham 057D,E01009301,1671,880,791
2021,Birmingham 057E,E01009303,1507,773,734
2021,Birmingham 058A,E01009195,2759,1433,1326
2021,Birmingham 058C,E01009197,1922,977,945
2021,Birmingham 058F,E01033649,2100,1055,1045
2021,Birmingham 058G,E01034935,3407,1691,1716
2021,Birmingham 060A,E01009138,2216,1123,1093
2021,Birmingham 060B,E01009139,1602,800,802
2021,Birmingham 060C,E01009140,2201,1017,1184
2021,Birmingham 060D,E01009145,1968,986,982
2021,Birmingham 060E,E01009147,1908,845,1063
2021,Birmingham 062A,E01009512,2016,1044,972
2021,Birmingham 062B,E01009514,1734,926,808
2021,Birmingham 062C,E01009516,1438,743,695
2021,Birmingham 062D,E01009517,1993,1023,970
2021,Birmingham 063A,E01009325,1997,1036,961
2021,Birmingham 063D,E01009342,1826,877,949
2021,Birmingham 063E,E01009343,1852,916,936
2021,Birmingham 063F,E01033642,3378,1692,1686
2021,Birmingham 064A,E01008986,1550,753,797
2021,Birmingham 064B,E01008987,1595,812,783
2021,Birmingham 064C,E01008988,2077,976,1101
2021,Birmingham 064D,E01008989,1693,830,863
2021,Birmingham 064E,E01008990,1178,580,598
2021,Birmingham 064F,E01008991,1881,970,911
2021,Birmingham 066A,E01008882,2055,1064,991
2021,Birmingham 066B,E01008896,1897,962,935
2021,Birmingham 066C,E01008898,1789,926,863
2021,Birmingham 066D,E01009326,2110,1076,1034
2021,Birmingham 066E,E01009341,1648,851,797
2021,Birmingham 066F,E01009513,2088,1082,1006
2021,Birmingham 067A,E01008881,1747,896,851
2021,Birmingham 067B,E01008897,1980,1012,968
2021,Birmingham 067C,E01009515,1701,857,844
2021,Birmingham 067D,E01009518,1738,852,886
2021,Birmingham 067E,E01009521,1658,836,822
2021,Birmingham 069A,E01009302,1460,757,703
2021,Birmingham 069B,E01009314,1945,1030,915
2021,Birmingham 069C,E01009321,1963,1051,912
2021,Birmingham 069D,E01009322,1753,906,847
2021,Birmingham 069E,E01009323,1832,983,849
2021,Birmingham 070A,E01009329,2683,1354,1329
2021,Birmingham 070B,E01009334,1837,902,935
2021,Birmingham 070C,E01009337,1979,996,983
2021,Birmingham 070D,E01009338,1807,957,850
2021,Birmingham 070E,E01009380,1854,935,919
2021,Birmingham 071A,E01009362,1444,748,696
2021,Birmingham 071B,E01009363,1781,889,892
2021,Birmingham 071C,E01009364,1655,871,784
2021,Birmingham 071D,E01009365,1850,951,899
2021,Birmingham 071E,E01009379,1899,891,1008
2021,Birmingham 072A,E01009312,1590,808,782
2021,Birmingham 072B,E01009324,1735,904,831
2021,Birmingham 072C,E01009519,1461,736,725
2021,Birmingham 072D,E01009520,1772,872,900
2021,Birmingham 073A,E01009066,1938,989,949
2021,Birmingham 073B,E01009070,1629,861,768
2021,Birmingham 073C,E01009252,1627,833,794
2021,Birmingham 073D,E01009260,1592,812,780
2021,Birmingham 073E,E01009261,1747,908,839
2021,Birmingham 074A,E01008984,1705,813,892
2021,Birmingham 074B,E01008994,1587,766,821
2021,Birmingham 074C,E01008996,1880,898,982
2021,Birmingham 074D,E01008997,1538,773,765
2021,Birmingham 075A,E01009065,1633,793,840
2021,Birmingham 075B,E01009067,1506,785,721
2021,Birmingham 075C,E01009068,1586,874,712
2021,Birmingham 075D,E01009069,1641,869,772
2021,Birmingham 075E,E01009072,1776,910,866
2021,Birmingham 076A,E01008885,1352,708,644
2021,Birmingham 076B,E01008886,1599,776,823
2021,Birmingham 076C,E01008888,1645,829,816
2021,Birmingham 076D,E01009313,1661,858,803
2021,Birmingham 077A,E01009368,1522,727,795
2021,Birmingham 077D,E01009371,1946,955,991
2021,Birmingham 077E,E01009397,1775,924,851
2021,Birmingham 077F,E01033650,2832,1432,1400
2021,Birmingham 078A,E01008883,1998,1013,985
2021,Birmingham 078B,E01008884,2209,1144,1065
2021,Birmingham 078C,E01008887,1730,904,826
2021,Birmingham 078D,E01008889,1790,874,916
2021,Birmingham 079A,E01008982,1677,862,815
2021,Birmingham 079C,E01008992,1685,909,776
2021,Birmingham 079E,E01009283,1766,891,875
2021,Birmingham 079G,E01034936,2702,1522,1180
2021,Birmingham 079H,E01034937,2444,1320,1124
2021,Birmingham 080A,E01009249,1595,823,772
2021,Birmingham 080B,E01009250,1715,884,831
2021,Birmingham 080C,E01009251,1490,769,721
2021,Birmingham 080D,E01009253,1602,821,781
2021,Birmingham 080E,E01009255,1543,857,686
2021,Birmingham 080F,E01009257,1624,822,802
2021,Birmingham 081A,E01009315,1727,876,851
2021,Birmingham 081B,E01009316,1900,934,966
2021,Birmingham 081C,E01009317,2072,1056,1016
2021,Birmingham 081D,E01009318,1537,762,775
2021,Birmingham 081E,E01009319,1550,782,768
2021,Birmingham 081F,E01009320,1627,793,834
2021,Birmingham 082A,E01009372,1736,851,885
2021,Birmingham 082B,E01009373,1763,894,869
2021,Birmingham 082D,E01009396,2148,1057,1091
2021,Birmingham 082F,E01033643,3307,1619,1688
2021,Birmingham 083A,E01009367,1791,867,924
2021,Birmingham 083B,E01009375,1972,996,976
2021,Birmingham 083C,E01009377,1470,760,710
2021,Birmingham 083D,E01009383,1413,666,747
2021,Birmingham 083E,E01009399,1644,854,790
2021,Birmingham 084A,E01009366,1708,838,870
2021,Birmingham 084B,E01009374,1215,611,604
2021,Birmingham 084C,E01009376,1561,714,847
2021,Birmingham 084F,E01033648,2748,1364,1384
2021,Birmingham 085A,E01009073,1824,989,835
2021,Birmingham 085B,E01009074,1772,884,888
2021,Birmingham 085C,E01009254,1941,995,946
2021,Birmingham 085D,E01009256,1677,864,813
2021,Birmingham 085E,E01009258,1524,789,735
2021,Birmingham 087B,E01009071,1695,834,861
2021,Birmingham 087C,E01009075,1663,849,814
2021,Birmingham 087E,E01009078,1534,811,723
2021,Birmingham 087F,E01033562,2550,1302,1248
2021,Birmingham 088C,E01009183,1659,816,843
2021,Birmingham 088D,E01009186,1786,870,916
2021,Birmingham 088F,E01034938,1937,972,965
2021,Birmingham 088G,E01034939,1678,828,850
2021,Birmingham 089A,E01008890,1849,924,925
2021,Birmingham 089B,E01008891,1578,801,777
2021,Birmingham 089C,E01008892,1484,742,742
2021,Birmingham 089D,E01008893,1706,825,881
2021,Birmingham 089E,E01008894,1597,750,847
2021,Birmingham 089F,E01008895,1895,974,921
2021,Birmingham 089G,E01009015,1850,935,915
2021,Birmingham 090A,E01009014,2612,1341,1271
2021,Birmingham 090B,E01009018,1862,841,1021
2021,Birmingham 090C,E01009026,1988,992,996
2021,Birmingham 090D,E01009028,1867,987,880
2021,Birmingham 090E,E01009029,1567,833,734
2021,Birmingham 092A,E01009182,1607,781,826
2021,Birmingham 092B,E01009184,1535,761,774
2021,Birmingham 092C,E01009187,1487,718,769
2021,Birmingham 092D,E01009188,1479,744,735
2021,Birmingham 092E,E01009384,1355,659,696
2021,Birmingham 092F,E01009385,1188,566,622
2021,Birmingham 093A,E01009185,1729,896,833
2021,Birmingham 093B,E01009389,1877,916,961
2021,Birmingham 093C,E01009390,1580,774,806
2021,Birmingham 093D,E01009394,1755,869,886
2021,Birmingham 094A,E01008918,1748,990,758
2021,Birmingham 094B,E01008920,1312,674,638
2021,Birmingham 094C,E01008921,1446,746,700
2021,Birmingham 094D,E01008931,1448,772,676
2021,Birmingham 094E,E01009259,1700,854,846
2021,Birmingham 095A,E01008919,1640,842,798
2021,Birmingham 095B,E01009064,1499,791,708
2021,Birmingham 095C,E01009077,1609,810,799
2021,Birmingham 095D,E01009291,1476,770,706
2021,Birmingham 095E,E01009500,1515,806,709
2021,Birmingham 096A,E01009284,4344,2342,2002
2021,Birmingham 096C,E01009286,2405,1354,1051
2021,Birmingham 096E,E01009289,2523,1366,1157
2021,Birmingham 096F,E01009290,2434,1313,1121
2021,Birmingham 096H,E01034940,2182,1248,934
2021,Birmingham 096I,E01034941,2100,1128,972
2021,Birmingham 097A,E01009017,1799,947,852
2021,Birmingham 097B,E01009043,1995,1004,991
2021,Birmingham 097C,E01009044,1764,887,877
2021,Birmingham 097D,E01009045,2046,1064,982
2021,Birmingham 097E,E01009046,1819,927,892
2021,Birmingham 097F,E01009395,1695,838,857
2021,Birmingham 098A,E01009016,1652,829,823
2021,Birmingham 098B,E01009022,1830,920,910
2021,Birmingham 098C,E01009023,1710,882,828
2021,Birmingham 098D,E01009030,1885,986,899
2021,Birmingham 099A,E01009281,1544,810,734
2021,Birmingham 099B,E01009292,1567,761,806
2021,Birmingham 099C,E01009294,1933,981,952
2021,Birmingham 099D,E01009295,1691,918,773
2021,Birmingham 100A,E01009280,1726,901,825
2021,Birmingham 100B,E01009282,1712,805,907
2021,Birmingham 100C,E01009288,1346,689,657
2021,Birmingham 100D,E01009293,1546,819,727
2021,Birmingham 100E,E01009296,1499,721,778
2021,Birmingham 101A,E01008924,1491,743,748
2021,Birmingham 101B,E01009501,1521,805,716
2021,Birmingham 101C,E01009502,1447,786,661
2021,Birmingham 101D,E01009503,1568,820,748
2021,Birmingham 101E,E01009505,1639,894,745
2021,Birmingham 102A,E01008917,1247,637,610
2021,Birmingham 102B,E01008923,1516,821,695
2021,Birmingham 102C,E01008925,1176,610,566
2021,Birmingham 102D,E01008927,1303,695,608
2021,Birmingham 102E,E01008928,1576,845,731
2021,Birmingham 103A,E01009019,1799,888,911
2021,Birmingham 103B,E01009020,1590,848,742
2021,Birmingham 103C,E01009021,1757,906,851
2021,Birmingham 103D,E01009024,1832,950,882
2021,Birmingham 103E,E01009025,1607,858,749
2021,Birmingham 103F,E01009033,1922,989,933
2021,Birmingham 104A,E01009175,1451,723,728
2021,Birmingham 104B,E01009177,1535,804,731
2021,Birmingham 104C,E01009178,1648,856,792
2021,Birmingham 104D,E01009179,1659,837,822
2021,Birmingham 104E,E01009189,1412,735,677
2021,Birmingham 105A,E01008933,1620,813,807
2021,Birmingham 105B,E01008934,1502,775,727
2021,Birmingham 105C,E01009031,1817,913,904
2021,Birmingham 105D,E01009037,1909,958,951
2021,Birmingham 105E,E01009176,1740,909,831
2021,Birmingham 106C,E01008929,1596,876,720
2021,Birmingham 106D,E01008930,1965,996,969
2021,Birmingham 106E,E01009495,1312,687,625
2021,Birmingham 106F,E01033629,2549,1398,1151
2021,Birmingham 107A,E01008953,1574,829,745
2021,Birmingham 107B,E01008963,1489,769,720
2021,Birmingham 107C,E01008964,1452,766,686
2021,Birmingham 107D,E01008965,1459,761,698
2021,Birmingham 107E,E01008966,1745,879,866
2021,Birmingham 108A,E01009032,1902,980,922
2021,Birmingham 108B,E01009034,1772,923,849
2021,Birmingham 108C,E01009035,1888,960,928
2021,Birmingham 108D,E01009036,1584,770,814
2021,Birmingham 109A,E01009494,1689,952,737
2021,Birmingham 109B,E01009496,1474,754,720
2021,Birmingham 109C,E01009497,1794,938,856
2021,Birmingham 109D,E01009504,1628,842,786
2021,Birmingham 109E,E01009506,1492,774,718
2021,Birmingham 110A,E01008967,1588,804,784
2021,Birmingham 110B,E01008968,1804,901,903
2021,Birmingham 110C,E01008970,1456,783,673
2021,Birmingham 110D,E01008981,1534,793,741
2021,Birmingham 111A,E01008932,1609,855,754
2021,Birmingham 111B,E01008935,1771,911,860
2021,Birmingham 111C,E01008936,1647,818,829
2021,Birmingham 111D,E01008938,1692,866,826
2021,Birmingham 111E,E01008939,1665,867,798
2021,Birmingham 112A,E01008951,1410,731,679
2021,Birmingham 112B,E01008952,1768,866,902
2021,Birmingham 112C,E01008955,1675,865,810
2021,Birmingham 112D,E01008956,1414,744,670
2021,Birmingham 112E,E01008957,1604,813,791
2021,Birmingham 113A,E01008950,1428,750,678
2021,Birmingham 113B,E01008954,1432,737,695
2021,Birmingham 113C,E01008958,1551,884,667
2021,Birmingham 113D,E01009493,1883,1001,882
2021,Birmingham 115A,E01008937,1604,886,718
2021,Birmingham 115B,E01008940,1610,846,764
2021,Birmingham 115C,E01008941,1592,788,804
2021,Birmingham 115D,E01008944,1741,877,864
2021,Birmingham 116A,E01008959,1732,937,795
2021,Birmingham 116B,E01008960,1545,780,765
2021,Birmingham 116C,E01008961,1411,695,716
2021,Birmingham 116D,E01008962,2093,1118,975
2021,Birmingham 117A,E01008942,1613,813,800
2021,Birmingham 117B,E01008943,1457,756,701
2021,Birmingham 117C,E01008969,1667,837,830
2021,Birmingham 117D,E01008971,1738,892,846
2021,Birmingham 118A,E01008972,1871,969,902
2021,Birmingham 118B,E01008973,1923,972,951
2021,Birmingham 118C,E01008974,2795,1464,1331
2021,Birmingham 118D,E01008975,1479,760,719
2021,Birmingham 119A,E01009172,1466,766,700
2021,Birmingham 119B,E01009173,1754,902,852
2021,Birmingham 119C,E01009174,1221,641,580
2021,Birmingham 119D,E01009498,1707,869,838
2021,Birmingham 119E,E01009499,1745,906,839
2021,Birmingham 120A,E01009205,1535,783,752
2021,Birmingham 120B,E01009206,1517,751,766
2021,Birmingham 120C,E01009211,1443,720,723
2021,Birmingham 120D,E01009218,1623,827,796
2021,Birmingham 120E,E01009219,1465,765,700
2021,Birmingham 121A,E01008976,1539,827,712
2021,Birmingham 121B,E01008978,1406,731,675
2021,Birmingham 121C,E01008979,1581,830,751
2021,Birmingham 121D,E01008980,1713,885,828
2021,Birmingham 122A,E01008945,1813,951,862
2021,Birmingham 122B,E01008946,1542,760,782
2021,Birmingham 122C,E01008947,1363,696,667
2021,Birmingham 122D,E01008948,1439,754,685
2021,Birmingham 122E,E01008949,1189,604,585
2021,Birmingham 123A,E01008977,1560,832,728
2021,Birmingham 123B,E01009109,1408,749,659
2021,Birmingham 123C,E01009119,1430,747,683
2021,Birmingham 123D,E01009120,1763,930,833
2021,Birmingham 124A,E01009162,1604,834,770
2021,Birmingham 124B,E01009207,1624,850,774
2021,Birmingham 124C,E01009208,1689,864,825
2021,Birmingham 124D,E01009209,2044,1070,974
2021,Birmingham 124E,E01009213,1608,834,774
2021,Birmingham 125B,E01009155,1325,687,638
2021,Birmingham 125D,E01009157,1448,767,681
2021,Birmingham 125E,E01009160,1632,862,770
2021,Birmingham 125F,E01009161,1443,757,686
2021,Birmingham 125H,E01034942,1864,1016,848
2021,Birmingham 125I,E01034943,1718,901,817
2021,Birmingham 126A,E01009117,2073,1121,952
2021,Birmingham 126B,E01009210,1818,957,861
2021,Birmingham 126C,E01009212,1774,918,856
2021,Birmingham 126D,E01009214,1648,846,802
2021,Birmingham 126E,E01009215,1815,900,915
2021,Birmingham 127A,E01009108,1023,524,499
2021,Birmingham 127B,E01009111,1545,800,745
2021,Birmingham 127C,E01009112,1617,847,770
2021,Birmingham 127D,E01009116,1369,717,652
2021,Birmingham 127E,E01009118,1558,797,761
2021,Birmingham 128A,E01009107,1675,927,748
2021,Birmingham 128B,E01009110,1362,695,667
2021,Birmingham 128C,E01009113,1709,908,801
2021,Birmingham 128D,E01009114,1411,760,651
2021,Birmingham 128E,E01009115,1424,742,682
2021,Birmingham 129A,E01009158,2256,1185,1071
2021,Birmingham 129C,E01009165,1382,688,694
2021,Birmingham 129D,E01009169,1670,823,847
2021,Birmingham 129E,E01034944,1297,738,559
2021,Birmingham 129F,E01034945,1488,752,736
2021,Birmingham 130A,E01009159,2282,1189,1093
2021,Birmingham 130B,E01009164,1424,728,696
2021,Birmingham 130C,E01009167,1494,774,720
2021,Birmingham 130D,E01009171,1648,832,816
2021,Birmingham 131A,E01009166,1320,670,650
2021,Birmingham 131B,E01009168,1440,748,692
2021,Birmingham 131C,E01009170,1483,768,715
2021,Birmingham 131D,E01009216,2066,1125,941
2021,Birmingham 131E,E01009217,1569,797,772
2021,Birmingham 132A,E01009039,1790,892,898
2021,Birmingham 132B,E01009040,1817,912,905
2021,Birmingham 132C,E01009041,1708,866,842
2021,Birmingham 132D,E01009042,1363,702,661
2021,Birmingham 132E,E01032589,1529,800,729
2021,Birmingham 133A,E01009262,1787,879,908
2021,Birmingham 133B,E01009267,1796,907,889
2021,Birmingham 133C,E01009276,1659,871,788
2021,Birmingham 133D,E01009278,1737,873,864
2021,Birmingham 133E,E01009279,1591,817,774
2021,Birmingham 133F,E01032591,1583,792,791
2021,Birmingham 134A,E01008995,2431,1271,1160
2021,Birmingham 134B,E01033557,2119,1055,1064
2021,Birmingham 134C,E01033624,1594,765,829
2021,Birmingham 134D,E01033626,1214,610,604
2021,Birmingham 134E,E01033640,2001,1004,997
2021,Birmingham 135B,E01033567,1109,533,576
2021,Birmingham 135C,E01033615,1105,515,590
2021,Birmingham 135D,E01033616,1277,536,741
2021,Birmingham 135E,E01034946,1051,473,578
2021,Birmingham 135F,E01034947,1582,774,808
2021,Birmingham 136A,E01009143,1884,976,908
2021,Birmingham 136B,E01009146,2304,1169,1135
2021,Birmingham 136C,E01033564,1172,539,633
2021,Birmingham 136E,E01034948,1787,887,900
2021,Birmingham 136F,E01034949,1308,617,691
2021,Birmingham 137A,E01009141,1922,957,965
2021,Birmingham 137B,E01033565,1405,689,716
2021,Birmingham 137C,E01033618,1220,533,687
2021,Birmingham 137E,E01033627,1126,526,600
2021,Birmingham 137F,E01034950,1124,554,570
2021,Birmingham 137G,E01034951,1107,507,600
2021,Birmingham 138A,E01033620,1073,495,578
2021,Birmingham 138B,E01033622,1894,851,1043
2021,Birmingham 138C,E01033623,1465,612,853
2021,Birmingham 138D,E01033625,1713,836,877
2021,Birmingham 139A,E01009200,1844,959,885
2021,Birmingham 139B,E01009327,1662,838,824
2021,Birmingham 139C,E01009328,2419,1267,1152
2021,Birmingham 139D,E01009331,2437,1223,1214
2021,Birmingham 139E,E01009332,1931,948,983
2021,Birmingham 139F,E01009333,1619,837,782
2021,Birmingham 139G,E01009335,1982,1002,980
2021,Birmingham 139H,E01009344,1828,874,954
2021,Birmingham 141A,E01009008,1426,739,687
2021,Birmingham 141B,E01009011,1738,867,871
2021,Birmingham 141C,E01009012,1501,751,750
2021,Birmingham 141G,E01009079,1371,682,689
2021,Birmingham 141F,E01009080,1349,712,637
2021,Birmingham 141H,E01009081,1371,679,692
2021,Birmingham 141I,E01009083,1608,826,782
2021,Birmingham 141E,E01009102,1615,850,765
2021,Birmingham 141D,E01009104,1712,897,815
2021,Birmingham 142A,E01009339,1669,856,813
2021,Birmingham 142D,E01009382,2004,988,1016
2021,Birmingham 142E,E01009392,1723,881,842
2021,Birmingham 142B,E01034952,1290,645,645
2021,Birmingham 142C,E01034953,1619,804,815
2021,Birmingham 143C,E01009391,1915,998,917
2021,Birmingham 143D,E01009393,1799,892,907
2021,Birmingham 143A,E01034954,1735,848,887
2021,Birmingham 143B,E01034955,2149,1089,1060
2021,Coventry 001A,E01009589,1699,867,832
2021,Coventry 001F,E01032536,2171,1070,1101
2021,Coventry 001G,E01032537,1975,1018,957
2021,Coventry 001H,E01032538,2227,1107,1120
2021,Coventry 002A,E01009590,1533,762,771
2021,Coventry 002B,E01009591,1589,810,779
2021,Coventry 002C,E01009593,1665,864,801
2021,Coventry 002D,E01009598,2142,1102,1040
2021,Coventry 004A,E01009604,1438,716,722
2021,Coventry 004B,E01009605,1749,914,835
2021,Coventry 004C,E01009607,1621,806,815
2021,Coventry 004D,E01009608,1634,832,802
2021,Coventry 004E,E01009610,1525,776,749
2021,Coventry 005A,E01009564,2093,1072,1021
2021,Coventry 005B,E01009575,1311,646,665
2021,Coventry 005C,E01009606,2237,1148,1089
2021,Coventry 005D,E01009609,1571,821,750
2021,Coventry 006A,E01009524,1523,776,747
2021,Coventry 006B,E01009525,1519,749,770
2021,Coventry 006C,E01009527,1619,824,795
2021,Coventry 006D,E01009594,1479,751,728
2021,Coventry 007A,E01009577,1734,879,855
2021,Coventry 007B,E01009579,2257,1209,1048
2021,Coventry 007C,E01009581,1761,894,867
2021,Coventry 007D,E01009584,2136,1109,1027
2021,Coventry 007E,E01009585,1861,999,862
2021,Coventry 007F,E01009709,1262,678,584
2021,Coventry 008A,E01009576,1605,808,797
2021,Coventry 008B,E01009578,1385,689,696
2021,Coventry 008C,E01009582,1678,870,808
2021,Coventry 008D,E01009583,1582,816,766
2021,Coventry 008E,E01009586,1830,941,889
2021,Coventry 009A,E01009565,1783,917,866
2021,Coventry 009B,E01009566,1987,977,1010
2021,Coventry 009C,E01009567,1723,875,848
2021,Coventry 009D,E01009568,1862,919,943
2021,Coventry 010A,E01009523,1640,831,809
2021,Coventry 010B,E01009526,1563,838,725
2021,Coventry 010C,E01009528,2165,1076,1089
2021,Coventry 010D,E01009531,1594,819,775
2021,Coventry 011A,E01009587,2318,1196,1122
2021,Coventry 011B,E01009624,1544,805,739
2021,Coventry 011C,E01009625,2408,1178,1230
2021,Coventry 011D,E01009626,1689,853,836
2021,Coventry 012A,E01009622,1836,998,838
2021,Coventry 012B,E01009623,1563,777,786
2021,Coventry 012C,E01009627,1813,918,895
2021,Coventry 012D,E01009628,1563,807,756
2021,Coventry 013A,E01009599,1089,560,529
2021,Coventry 013B,E01009663,1442,736,706
2021,Coventry 013C,E01009710,1299,655,644
2021,Coventry 013D,E01009711,1925,992,933
2021,Coventry 014A,E01009522,1910,1019,891
2021,Coventry 014B,E01009529,1523,758,765
2021,Coventry 014C,E01009530,1405,731,674
2021,Coventry 014D,E01009645,1450,740,710
2021,Coventry 015A,E01009569,1360,691,669
2021,Coventry 015B,E01009570,2282,1145,1137
2021,Coventry 015C,E01009571,1590,770,820
2021,Coventry 015E,E01009573,1500,756,744
2021,Coventry 015F,E01009574,1610,815,795
2021,Coventry 015G,E01034735,1658,831,827
2021,Coventry 015H,E01034736,1719,836,883
2021,Coventry 016A,E01009655,2040,1046,994
2021,Coventry 016B,E01009656,1627,796,831
2021,Coventry 016C,E01009659,1870,957,913
2021,Coventry 016D,E01009662,1416,681,735
2021,Coventry 016E,E01009664,1582,794,788
2021,Coventry 017A,E01009643,1410,723,687
2021,Coventry 017B,E01009644,1606,824,782
2021,Coventry 017C,E01009647,1882,939,943
2021,Coventry 017D,E01009648,1504,770,734
2021,Coventry 017E,E01009652,1464,734,730
2021,Coventry 017F,E01009653,1595,814,781
2021,Coventry 018A,E01009613,1303,674,629
2021,Coventry 018B,E01009657,1629,799,830
2021,Coventry 018C,E01009712,1524,750,774
2021,Coventry 018D,E01009714,1493,798,695
2021,Coventry 018E,E01009716,1688,857,831
2021,Coventry 019A,E01009580,1336,695,641
2021,Coventry 019B,E01009713,1450,729,721
2021,Coventry 019C,E01009715,1411,732,679
2021,Coventry 019D,E01009717,1472,748,724
2021,Coventry 019E,E01009718,1830,915,915
2021,Coventry 020B,E01009630,1845,951,894
2021,Coventry 020C,E01009631,1567,789,778
2021,Coventry 020D,E01009632,1810,828,982
2021,Coventry 020E,E01009650,1517,648,869
2021,Coventry 020F,E01034737,1841,872,969
2021,Coventry 020G,E01034738,1434,699,735
2021,Coventry 021A,E01009614,1456,773,683
2021,Coventry 021B,E01009654,1839,894,945
2021,Coventry 021C,E01009658,1783,826,957
2021,Coventry 021D,E01009660,1732,863,869
2021,Coventry 022A,E01009646,1514,756,758
2021,Coventry 022B,E01009692,1178,620,558
2021,Coventry 022C,E01009693,1484,784,700
2021,Coventry 022D,E01009694,1428,730,698
2021,Coventry 023A,E01009695,1584,802,782
2021,Coventry 023B,E01009696,1438,733,705
2021,Coventry 023C,E01009704,1418,730,688
2021,Coventry 023D,E01009705,1352,681,671
2021,Coventry 024A,E01009636,2530,1218,1312
2021,Coventry 024B,E01009637,1853,932,921
2021,Coventry 024C,E01009638,1886,897,989
2021,Coventry 024D,E01009639,1741,845,896
2021,Coventry 024E,E01009640,2146,1084,1062
2021,Coventry 024F,E01009641,3286,1567,1719
2021,Coventry 025A,E01009697,2045,1015,1030
2021,Coventry 025B,E01009698,1479,756,723
2021,Coventry 025D,E01009706,1476,759,717
2021,Coventry 025E,E01034739,1600,805,795
2021,Coventry 025F,E01034740,1808,949,859
2021,Coventry 026A,E01009649,1430,726,704
2021,Coventry 026B,E01009684,1482,749,733
2021,Coventry 026C,E01009685,1619,809,810
2021,Coventry 026D,E01009686,1683,836,847
2021,Coventry 026E,E01009687,1397,696,701
2021,Coventry 027A,E01009615,1703,796,907
2021,Coventry 027B,E01009616,1559,787,772
2021,Coventry 027C,E01009617,1258,623,635
2021,Coventry 027D,E01009618,1676,852,824
2021,Coventry 027E,E01009620,2801,1449,1352
2021,Coventry 027F,E01009621,1474,831,643
2021,Coventry 028A,E01009633,2044,873,1171
2021,Coventry 028B,E01009634,2095,863,1232
2021,Coventry 028D,E01009661,2031,900,1131
2021,Coventry 028E,E01034741,1922,811,1111
2021,Coventry 028F,E01034742,1149,465,684
2021,Coventry 029A,E01009674,1733,850,883
2021,Coventry 029B,E01009699,1433,726,707
2021,Coventry 029C,E01009700,1665,831,834
2021,Coventry 029D,E01009701,1498,769,729
2021,Coventry 029E,E01009702,1652,833,819
2021,Coventry 030A,E01009688,1501,694,807
2021,Coventry 030B,E01009689,1658,840,818
2021,Coventry 030C,E01009690,1461,721,740
2021,Coventry 030D,E01009691,1291,603,688
2021,Coventry 031A,E01009548,2774,1356,1418
2021,Coventry 031B,E01009553,1927,824,1103
2021,Coventry 031D,E01009651,1538,710,828
2021,Coventry 031E,E01034743,2043,919,1124
2021,Coventry 031F,E01034744,2870,1380,1490
2021,Coventry 032A,E01009676,1639,828,811
2021,Coventry 032B,E01009681,1315,676,639
2021,Coventry 032C,E01009682,1435,706,729
2021,Coventry 032D,E01009683,1906,956,950
2021,Coventry 033A,E01009532,1345,719,626
2021,Coventry 033B,E01009535,1369,705,664
2021,Coventry 033C,E01009536,1463,721,742
2021,Coventry 033D,E01009543,1789,886,903
2021,Coventry 033E,E01009707,1811,924,887
2021,Coventry 033F,E01009708,1406,740,666
2021,Coventry 034A,E01009554,1344,678,666
2021,Coventry 034B,E01009555,1474,743,731
2021,Coventry 034C,E01009556,1522,752,770
2021,Coventry 034D,E01009557,1384,686,698
2021,Coventry 034E,E01009558,1408,679,729
2021,Coventry 034F,E01009559,1343,674,669
2021,Coventry 035C,E01009537,1494,766,728
2021,Coventry 035D,E01009538,1535,785,750
2021,Coventry 035F,E01009612,1533,792,741
2021,Coventry 035G,E01032527,1610,816,794
2021,Coventry 035H,E01032528,1566,815,751
2021,Coventry 035I,E01034745,1388,723,665
2021,Coventry 035J,E01034746,1660,908,752
2021,Coventry 036C,E01009679,2223,1048,1175
2021,Coventry 036F,E01032532,1495,725,770
2021,Coventry 036G,E01032533,1913,953,960
2021,Coventry 036H,E01034747,1999,977,1022
2021,Coventry 036I,E01034748,1355,702,653
2021,Coventry 037B,E01009549,1621,832,789
2021,Coventry 037C,E01009550,1718,830,888
2021,Coventry 037E,E01009552,1578,816,762
2021,Coventry 037F,E01032534,1796,916,880
2021,Coventry 037G,E01032535,1248,634,614
2021,Coventry 038A,E01009544,1556,769,787
2021,Coventry 038E,E01032529,1259,660,599
2021,Coventry 038F,E01032530,1887,933,954
2021,Coventry 038G,E01034749,1925,1026,899
2021,Coventry 038H,E01034750,2797,1387,1410
2021,Coventry 039A,E01009539,2076,1057,1019
2021,Coventry 039B,E01009540,2033,1071,962
2021,Coventry 039C,E01009541,1675,828,847
2021,Coventry 039D,E01009542,1904,965,939
2021,Coventry 040A,E01009560,1482,765,717
2021,Coventry 040B,E01009561,1602,805,797
2021,Coventry 040C,E01009562,1590,805,785
2021,Coventry 040D,E01009563,1711,881,830
2021,Coventry 040E,E01009672,2124,1078,1046
2021,Coventry 041A,E01009666,1388,681,707
2021,Coventry 041B,E01009667,1313,673,640
2021,Coventry 041C,E01009668,1654,851,803
2021,Coventry 041D,E01009670,1683,829,854
2021,Coventry 042A,E01009665,1271,633,638
2021,Coventry 042B,E01009669,1284,638,646
2021,Coventry 042C,E01009671,4120,2085,2035
2021,Coventry 042F,E01033058,2430,1175,1255
2021,Coventry 043A,E01009588,1585,815,770
2021,Coventry 043B,E01009592,1723,869,854
2021,Coventry 043C,E01009596,2083,1031,1052
2021,Coventry 043D,E01009597,1884,959,925
2021,Coventry 043E,E01032587,1813,911,902
2021,Dudley 001A,E01009763,2239,1226,1013
2021,Dudley 001B,E01009764,1481,751,730
2021,Dudley 001C,E01009767,1530,796,734
2021,Dudley 001D,E01009769,1841,938,903
2021,Dudley 001E,E01009770,1458,732,726
2021,Dudley 002A,E01009773,1536,785,751
2021,Dudley 002B,E01009777,1565,779,786
2021,Dudley 002C,E01009778,1583,785,798
2021,Dudley 002D,E01009895,1380,697,683
2021,Dudley 003A,E01009896,1447,740,707
2021,Dudley 003B,E01009897,1408,698,710
2021,Dudley 003C,E01009898,1447,761,686
2021,Dudley 003D,E01009901,1391,708,683
2021,Dudley 003E,E01009902,1210,626,584
2021,Dudley 004A,E01009765,1601,804,797
2021,Dudley 004B,E01009766,1558,775,783
2021,Dudley 004C,E01009768,1378,692,686
2021,Dudley 004D,E01009771,1420,738,682
2021,Dudley 004E,E01009775,1500,760,740
2021,Dudley 004F,E01009776,1562,761,801
2021,Dudley 005A,E01009758,1778,910,868
2021,Dudley 005B,E01009760,1334,675,659
2021,Dudley 005C,E01009772,1283,688,595
2021,Dudley 005D,E01009774,1608,864,744
2021,Dudley 005E,E01009788,1577,818,759
2021,Dudley 006B,E01009756,1538,832,706
2021,Dudley 006C,E01009757,2165,1097,1068
2021,Dudley 006D,E01009759,1264,634,630
2021,Dudley 006F,E01009762,1476,776,700
2021,Dudley 006H,E01034306,1712,890,822
2021,Dudley 006I,E01034307,1733,897,836
2021,Dudley 007A,E01009781,1981,1017,964
2021,Dudley 007B,E01009786,1456,750,706
2021,Dudley 007C,E01009789,1442,712,730
2021,Dudley 007D,E01009790,1602,802,800
2021,Dudley 008A,E01009779,1412,734,678
2021,Dudley 008B,E01009782,1871,933,938
2021,Dudley 008C,E01009783,1479,765,714
2021,Dudley 008D,E01009785,1487,750,737
2021,Dudley 008E,E01009899,1381,690,691
2021,Dudley 008F,E01009900,1396,715,681
2021,Dudley 009A,E01009780,2153,1081,1072
2021,Dudley 009B,E01009784,1563,778,785
2021,Dudley 009C,E01009787,1480,769,711
2021,Dudley 009D,E01009880,1537,784,753
2021,Dudley 009E,E01009882,1430,752,678
2021,Dudley 010A,E01009891,1865,970,895
2021,Dudley 010B,E01009892,1628,811,817
2021,Dudley 010C,E01009893,1908,997,911
2021,Dudley 010D,E01009894,1713,860,853
2021,Dudley 011A,E01009844,1605,768,837
2021,Dudley 011B,E01009879,2383,1176,1207
2021,Dudley 011D,E01009885,1615,794,821
2021,Dudley 011E,E01034308,1475,753,722
2021,Dudley 011F,E01034309,1294,569,725
2021,Dudley 012A,E01009816,1662,838,824
2021,Dudley 012B,E01009817,1250,642,608
2021,Dudley 012C,E01009819,1495,759,736
2021,Dudley 012D,E01009820,1498,761,737
2021,Dudley 013A,E01009748,1658,858,800
2021,Dudley 013B,E01009839,1821,919,902
2021,Dudley 013C,E01009883,1548,828,720
2021,Dudley 013D,E01009884,1430,722,708
2021,Dudley 013E,E01009886,1956,1007,949
2021,Dudley 014A,E01009814,1284,669,615
2021,Dudley 014B,E01009815,1272,642,630
2021,Dudley 014C,E01009818,1226,631,595
2021,Dudley 014D,E01009821,1303,668,635
2021,Dudley 014E,E01009822,1487,780,707
2021,Dudley 015A,E01009887,1840,903,937
2021,Dudley 015B,E01009888,1767,895,872
2021,Dudley 015C,E01009889,2856,1453,1403
2021,Dudley 015D,E01009890,1849,933,916
2021,Dudley 016A,E01009749,2374,1183,1191
2021,Dudley 016B,E01009750,1485,735,750
2021,Dudley 016C,E01009823,1303,663,640
2021,Dudley 016D,E01009824,1897,984,913
2021,Dudley 017A,E01009751,1513,769,744
2021,Dudley 017B,E01009752,1642,859,783
2021,Dudley 017C,E01009753,1593,825,768
2021,Dudley 017D,E01009754,1716,905,811
2021,Dudley 017E,E01009841,1583,826,757
2021,Dudley 018A,E01009840,1510,753,757
2021,Dudley 018B,E01009842,1534,760,774
2021,Dudley 018C,E01009843,1487,765,722
2021,Dudley 018D,E01009871,1988,1003,985
2021,Dudley 018E,E01009875,1551,822,729
2021,Dudley 019A,E01009825,1438,720,718
2021,Dudley 019B,E01009826,1428,738,690
2021,Dudley 019C,E01009827,1624,818,806
2021,Dudley 019D,E01009828,1291,676,615
2021,Dudley 019E,E01009829,1492,796,696
2021,Dudley 019F,E01009830,1658,860,798
2021,Dudley 020A,E01009872,1351,703,648
2021,Dudley 020B,E01009873,1538,778,760
2021,Dudley 020C,E01009874,1609,799,810
2021,Dudley 020D,E01009876,1641,840,801
2021,Dudley 020E,E01009877,1659,844,815
2021,Dudley 021A,E01009911,1231,621,610
2021,Dudley 021B,E01009912,2022,1018,1004
2021,Dudley 021C,E01009913,1526,791,735
2021,Dudley 021D,E01009914,1337,684,653
2021,Dudley 021E,E01009915,1683,881,802
2021,Dudley 021F,E01009916,1686,858,828
2021,Dudley 022A,E01009741,2038,930,1108
2021,Dudley 022B,E01009744,2150,1100,1050
2021,Dudley 022C,E01009746,1980,984,996
2021,Dudley 022D,E01009747,1541,781,760
2021,Dudley 023A,E01009731,1595,757,838
2021,Dudley 023B,E01009740,2175,1121,1054
2021,Dudley 023C,E01009742,1578,844,734
2021,Dudley 023D,E01009743,1817,929,888
2021,Dudley 023E,E01009745,1714,872,842
2021,Dudley 024A,E01009917,1186,594,592
2021,Dudley 024B,E01009918,1430,758,672
2021,Dudley 024C,E01009919,1138,561,577
2021,Dudley 024D,E01009920,1604,813,791
2021,Dudley 025A,E01009864,1531,784,747
2021,Dudley 025B,E01009865,1585,837,748
2021,Dudley 025C,E01009866,1665,848,817
2021,Dudley 025D,E01009867,1720,841,879
2021,Dudley 025E,E01009878,2240,1127,1113
2021,Dudley 026A,E01009791,1546,769,777
2021,Dudley 026B,E01009792,1591,803,788
2021,Dudley 026C,E01009795,1717,877,840
2021,Dudley 026D,E01009796,1640,847,793
2021,Dudley 026E,E01009798,2402,1202,1200
2021,Dudley 027A,E01009719,1393,691,702
2021,Dudley 027B,E01009722,1293,646,647
2021,Dudley 027C,E01009727,1324,696,628
2021,Dudley 027D,E01009728,1226,604,622
2021,Dudley 027E,E01009729,1549,776,773
2021,Dudley 028A,E01009720,1293,674,619
2021,Dudley 028B,E01009723,1182,579,603
2021,Dudley 028C,E01009724,1442,733,709
2021,Dudley 028D,E01009730,1462,714,748
2021,Dudley 029A,E01009903,1400,729,671
2021,Dudley 029B,E01009904,1366,708,658
2021,Dudley 029C,E01009909,1422,718,704
2021,Dudley 029D,E01009910,1548,778,770
2021,Dudley 030A,E01009793,1575,807,768
2021,Dudley 030B,E01009794,1519,793,726
2021,Dudley 030C,E01009797,1373,710,663
2021,Dudley 030D,E01009801,1761,944,817
2021,Dudley 031A,E01009721,2384,1155,1229
2021,Dudley 031B,E01009725,1511,785,726
2021,Dudley 031C,E01009726,1265,619,646
2021,Dudley 031D,E01009834,1655,836,819
2021,Dudley 032A,E01009833,1567,759,808
2021,Dudley 032B,E01009835,1727,869,858
2021,Dudley 032C,E01009869,1531,790,741
2021,Dudley 032D,E01009870,1439,688,751
2021,Dudley 033A,E01009809,1695,884,811
2021,Dudley 033B,E01009813,1585,819,766
2021,Dudley 033C,E01009861,1639,820,819
2021,Dudley 033D,E01009862,1848,967,881
2021,Dudley 033E,E01009863,1951,1001,950
2021,Dudley 033F,E01009868,1495,757,738
2021,Dudley 034A,E01009734,1578,819,759
2021,Dudley 034B,E01009735,1649,864,785
2021,Dudley 034C,E01009736,1386,700,686
2021,Dudley 034D,E01009737,1519,747,772
2021,Dudley 034E,E01009738,1683,857,826
2021,Dudley 035A,E01009856,2018,982,1036
2021,Dudley 035B,E01009905,1426,725,701
2021,Dudley 035C,E01009906,1696,818,878
2021,Dudley 035D,E01009907,1457,771,686
2021,Dudley 035E,E01009908,1571,793,778
2021,Dudley 036A,E01009800,1512,794,718
2021,Dudley 036B,E01009802,1755,900,855
2021,Dudley 036C,E01009803,1589,812,777
2021,Dudley 036D,E01009804,1259,639,620
2021,Dudley 037A,E01009831,1446,706,740
2021,Dudley 037B,E01009836,1926,868,1058
2021,Dudley 037C,E01009837,1602,795,807
2021,Dudley 037D,E01009838,1694,835,859
2021,Dudley 038A,E01009847,1477,770,707
2021,Dudley 038B,E01009848,1358,695,663
2021,Dudley 038C,E01009849,1590,814,776
2021,Dudley 038D,E01009851,1498,778,720
2021,Dudley 039A,E01009732,1865,920,945
2021,Dudley 039B,E01009733,1849,940,909
2021,Dudley 039C,E01009739,1530,804,726
2021,Dudley 039D,E01009799,1460,742,718
2021,Dudley 039E,E01009805,1443,717,726
2021,Dudley 039F,E01009806,1469,738,731
2021,Dudley 040A,E01009854,1505,768,737
2021,Dudley 040B,E01009857,1689,874,815
2021,Dudley 040C,E01009858,1475,644,831
2021,Dudley 040D,E01009859,1538,796,742
2021,Dudley 041A,E01009845,1550,783,767
2021,Dudley 041B,E01009846,1496,757,739
2021,Dudley 041C,E01009850,1477,753,724
2021,Dudley 041D,E01009852,1410,724,686
2021,Dudley 042A,E01009832,1744,972,772
2021,Dudley 042B,E01009853,1374,729,645
2021,Dudley 042C,E01009855,1652,850,802
2021,Dudley 042D,E01009860,1501,781,720
2021,Dudley 043A,E01009807,1871,965,906
2021,Dudley 043B,E01009808,1360,694,666
2021,Dudley 043C,E01009810,1805,946,859
2021,Dudley 043D,E01009811,1482,771,711
2021,Dudley 043E,E01009812,1511,740,771
2021,Sandwell 001A,E01010085,1841,907,934
2021,Sandwell 001B,E01010086,1761,913,848
2021,Sandwell 001C,E01010087,1664,824,840
2021,Sandwell 001D,E01010088,1619,811,808
2021,Sandwell 001E,E01010089,1875,957,918
2021,Sandwell 002A,E01009969,2125,1105,1020
2021,Sandwell 002B,E01009970,1816,923,893
2021,Sandwell 002C,E01009971,1709,921,788
2021,Sandwell 002D,E01009973,2402,1251,1151
2021,Sandwell 003A,E01009960,1584,851,733
2021,Sandwell 003B,E01009961,1244,614,630
2021,Sandwell 003C,E01009966,1225,626,599
2021,Sandwell 003D,E01009967,1880,998,882
2021,Sandwell 003E,E01010092,1877,972,905
2021,Sandwell 004A,E01009962,1363,715,648
2021,Sandwell 004B,E01009963,1371,693,678
2021,Sandwell 004C,E01009964,1628,842,786
2021,Sandwell 004D,E01009965,1352,698,654
2021,Sandwell 005A,E01010090,2125,1051,1074
2021,Sandwell 005B,E01010091,1707,808,899
2021,Sandwell 005C,E01010096,1822,919,903
2021,Sandwell 005D,E01010097,1901,972,929
2021,Sandwell 006A,E01009968,1535,811,724
2021,Sandwell 006B,E01009972,1919,1009,910
2021,Sandwell 006C,E01009974,1681,885,796
2021,Sandwell 006D,E01009975,1694,851,843
2021,Sandwell 007A,E01010030,1738,896,842
2021,Sandwell 007B,E01010034,1239,613,626
2021,Sandwell 007C,E01010035,1331,678,653
2021,Sandwell 007D,E01010036,2002,1015,987
2021,Sandwell 009A,E01009982,1590,800,790
2021,Sandwell 009B,E01009983,1595,852,743
2021,Sandwell 009C,E01010029,1650,882,768
2021,Sandwell 009D,E01010037,1334,690,644
2021,Sandwell 010A,E01009991,2358,1213,1145
2021,Sandwell 010B,E01009994,1772,909,863
2021,Sandwell 010C,E01009995,1623,849,774
2021,Sandwell 010D,E01009996,1637,849,788
2021,Sandwell 010E,E01009997,1801,916,885
2021,Sandwell 010F,E01009998,2171,1134,1037
2021,Sandwell 011A,E01010008,1649,855,794
2021,Sandwell 011B,E01010010,1485,778,707
2021,Sandwell 011C,E01010011,1756,909,847
2021,Sandwell 011D,E01010012,1438,747,691
2021,Sandwell 012A,E01010007,1373,745,628
2021,Sandwell 012B,E01010009,1450,754,696
2021,Sandwell 012C,E01010013,1340,678,662
2021,Sandwell 012D,E01010014,1655,880,775
2021,Sandwell 013A,E01010093,1617,791,826
2021,Sandwell 013B,E01010094,1677,880,797
2021,Sandwell 013C,E01010095,2094,1110,984
2021,Sandwell 013D,E01010098,1884,971,913
2021,Sandwell 013E,E01010099,1821,932,889
2021,Sandwell 013F,E01010100,2033,1036,997
2021,Sandwell 014A,E01009978,1850,946,904
2021,Sandwell 014B,E01010031,1542,772,770
2021,Sandwell 014C,E01010032,1658,851,807
2021,Sandwell 014D,E01010033,1651,832,819
2021,Sandwell 014F,E01033886,1645,864,781
2021,Sandwell 014G,E01033887,1535,763,772
2021,Sandwell 015A,E01010066,1708,852,856
2021,Sandwell 015B,E01010067,1761,867,894
2021,Sandwell 015C,E01010068,1868,965,903
2021,Sandwell 015D,E01010070,1772,872,900
2021,Sandwell 015E,E01010075,1547,776,771
2021,Sandwell 015F,E01010076,2066,1056,1010
2021,Sandwell 016A,E01009976,2745,1394,1351
2021,Sandwell 016B,E01009977,2025,1027,998
2021,Sandwell 016C,E01009979,2041,1025,1016
2021,Sandwell 016D,E01009980,2344,1196,1148
2021,Sandwell 016E,E01010069,2648,1287,1361
2021,Sandwell 016F,E01010071,1767,876,891
2021,Sandwell 017A,E01009947,2393,1219,1174
2021,Sandwell 017B,E01009992,1800,920,880
2021,Sandwell 017C,E01009993,1953,1003,950
2021,Sandwell 017D,E01010103,2235,1071,1164
2021,Sandwell 017E,E01010104,1756,901,855
2021,Sandwell 017F,E01010105,1654,786,868
2021,Sandwell 018A,E01009981,2069,1030,1039
2021,Sandwell 018C,E01009985,1817,916,901
2021,Sandwell 018F,E01033888,1522,756,766
2021,Sandwell 018G,E01033889,1949,979,970
2021,Sandwell 019A,E01009986,1682,850,832
2021,Sandwell 019B,E01009987,1483,723,760
2021,Sandwell 019C,E01009989,1979,1011,968
2021,Sandwell 019D,E01010106,1915,996,919
2021,Sandwell 020A,E01009988,2830,1442,1388
2021,Sandwell 020B,E01010101,2058,1019,1039
2021,Sandwell 020C,E01010102,1883,915,968
2021,Sandwell 020D,E01010107,2187,1116,1071
2021,Sandwell 021A,E01010015,2030,995,1035
2021,Sandwell 021B,E01010016,1840,910,930
2021,Sandwell 021C,E01010018,2441,1226,1215
2021,Sandwell 021D,E01010072,2352,1100,1252
2021,Sandwell 021E,E01010073,1664,884,780
2021,Sandwell 022A,E01010077,1631,851,780
2021,Sandwell 022B,E01010079,1493,713,780
2021,Sandwell 022C,E01010080,1990,977,1013
2021,Sandwell 022D,E01010081,1563,794,769
2021,Sandwell 022E,E01010082,2315,1170,1145
2021,Sandwell 022F,E01010083,1869,933,936
2021,Sandwell 022G,E01010084,1635,827,808
2021,Sandwell 023A,E01010046,2941,1529,1412
2021,Sandwell 023B,E01010047,2150,1044,1106
2021,Sandwell 023C,E01010048,1869,900,969
2021,Sandwell 023D,E01010049,1719,848,871
2021,Sandwell 023E,E01010050,1739,856,883
2021,Sandwell 023F,E01010052,1481,755,726
2021,Sandwell 023G,E01010053,2270,1143,1127
2021,Sandwell 024A,E01010017,1976,921,1055
2021,Sandwell 024B,E01010019,1999,963,1036
2021,Sandwell 024C,E01010020,2257,1175,1082
2021,Sandwell 024D,E01010021,2026,1053,973
2021,Sandwell 025A,E01010039,2153,1094,1059
2021,Sandwell 025B,E01010043,1401,717,684
2021,Sandwell 025C,E01010044,1544,809,735
2021,Sandwell 025D,E01010078,1222,642,580
2021,Sandwell 027A,E01009934,1448,760,688
2021,Sandwell 027B,E01009935,2369,1172,1197
2021,Sandwell 027C,E01009936,1557,790,767
2021,Sandwell 027D,E01010004,1870,936,934
2021,Sandwell 028A,E01010054,2077,970,1107
2021,Sandwell 028B,E01010055,2018,1023,995
2021,Sandwell 028C,E01010056,1887,957,930
2021,Sandwell 028D,E01010057,2240,1104,1136
2021,Sandwell 028E,E01010060,2116,1090,1026
2021,Sandwell 029A,E01010038,1849,935,914
2021,Sandwell 029B,E01010040,1424,744,680
2021,Sandwell 029C,E01010041,1744,923,821
2021,Sandwell 029D,E01010045,1700,866,834
2021,Sandwell 030A,E01010000,1822,910,912
2021,Sandwell 030B,E01010002,2197,1113,1084
2021,Sandwell 030C,E01010003,1529,786,743
2021,Sandwell 030D,E01010005,1643,818,825
2021,Sandwell 030E,E01010006,1733,876,857
2021,Sandwell 031A,E01009938,1835,927,908
2021,Sandwell 031B,E01009943,1629,873,756
2021,Sandwell 031C,E01009944,1846,950,896
2021,Sandwell 031D,E01010051,1423,729,694
2021,Sandwell 031E,E01010058,1678,844,834
2021,Sandwell 032A,E01009937,1631,845,786
2021,Sandwell 032B,E01009939,1705,864,841
2021,Sandwell 032C,E01009940,1538,796,742
2021,Sandwell 032D,E01009941,1575,786,789
2021,Sandwell 032E,E01009942,1755,913,842
2021,Sandwell 033A,E01009929,1752,925,827
2021,Sandwell 033B,E01009930,1555,847,708
2021,Sandwell 033C,E01009931,2371,1190,1181
2021,Sandwell 033D,E01009932,1598,777,821
2021,Sandwell 033E,E01009999,1457,734,723
2021,Sandwell 034A,E01009921,1783,903,880
2021,Sandwell 034B,E01009922,1366,693,673
2021,Sandwell 034C,E01009924,1415,740,675
2021,Sandwell 034D,E01009925,1453,749,704
2021,Sandwell 034E,E01009926,1408,726,682
2021,Sandwell 034F,E01009927,1513,751,762
2021,Sandwell 034G,E01009928,1730,916,814
2021,Sandwell 035A,E01009933,1422,732,690
2021,Sandwell 035B,E01009952,2185,1159,1026
2021,Sandwell 035C,E01009955,2329,1085,1244
2021,Sandwell 035D,E01009956,1643,828,815
2021,Sandwell 035E,E01009959,1430,723,707
2021,Sandwell 035F,E01010042,1875,945,930
2021,Sandwell 036A,E01009923,1520,778,742
2021,Sandwell 036B,E01010024,1585,814,771
2021,Sandwell 036C,E01010026,1846,962,884
2021,Sandwell 036D,E01010027,1619,847,772
2021,Sandwell 037A,E01010001,1933,989,944
2021,Sandwell 037B,E01010022,1575,780,795
2021,Sandwell 037C,E01010023,1829,916,913
2021,Sandwell 037D,E01010025,1736,906,830
2021,Sandwell 037E,E01010028,1586,843,743
2021,Sandwell 038A,E01009953,2094,1031,1063
2021,Sandwell 038B,E01009954,1854,953,901
2021,Sandwell 038C,E01009957,1850,1000,850
2021,Sandwell 038D,E01009958,1582,804,778
2021,Sandwell 039A,E01009946,1809,915,894
2021,Sandwell 039B,E01009948,1494,739,755
2021,Sandwell 039C,E01009949,1613,826,787
2021,Sandwell 039D,E01009950,1718,841,877
2021,Sandwell 039E,E01009951,2267,1140,1127
2021,Sandwell 039F,E01032592,1786,915,871
2021,Sandwell 040A,E01010062,2279,1131,1148
2021,Sandwell 040D,E01010064,2170,1125,1045
2021,Sandwell 040B,E01033890,1477,746,731
2021,Sandwell 040C,E01033891,1670,830,840
2021,Sandwell 041D,E01010059,2290,1118,1172
2021,Sandwell 041B,E01010061,2041,1014,1027
2021,Sandwell 041A,E01033892,2054,1059,995
2021,Sandwell 041C,E01033893,1690,840,850
2021,Solihull 001A,E01010118,1214,627,587
2021,Solihull 001B,E01010120,1254,674,580
2021,Solihull 001C,E01010121,1539,764,775
2021,Solihull 001D,E01010122,1427,725,702
2021,Solihull 002A,E01010235,1478,775,703
2021,Solihull 002B,E01010236,1421,730,691
2021,Solihull 002C,E01010239,1553,825,728
2021,Solihull 002D,E01010240,1388,740,648
2021,Solihull 003A,E01010117,1455,737,718
2021,Solihull 003B,E01010119,1538,782,756
2021,Solihull 003C,E01010123,1516,783,733
2021,Solihull 003D,E01010124,1520,778,742
2021,Solihull 004A,E01010146,1689,907,782
2021,Solihull 004B,E01010234,1807,963,844
2021,Solihull 004C,E01010237,1859,963,896
2021,Solihull 004D,E01010238,1391,726,665
2021,Solihull 005A,E01010145,1674,868,806
2021,Solihull 005B,E01010147,1601,867,734
2021,Solihull 005C,E01010148,1845,978,867
2021,Solihull 005D,E01010149,1538,808,730
2021,Solihull 006A,E01010125,1880,968,912
2021,Solihull 006B,E01010129,1646,876,770
2021,Solihull 006C,E01010139,1086,575,511
2021,Solihull 006D,E01010141,1311,671,640
2021,Solihull 007A,E01010140,1466,772,694
2021,Solihull 007B,E01010142,1493,809,684
2021,Solihull 007C,E01010143,1610,857,753
2021,Solihull 007D,E01010144,1728,890,838
2021,Solihull 008A,E01010111,1448,749,699
2021,Solihull 008B,E01010126,1454,784,670
2021,Solihull 008C,E01010127,1850,941,909
2021,Solihull 008D,E01010128,1495,798,697
2021,Solihull 008E,E01010130,1851,991,860
2021,Solihull 008F,E01010131,1487,791,696
2021,Solihull 009A,E01010109,1661,837,824
2021,Solihull 009B,E01010110,1596,802,794
2021,Solihull 009C,E01010112,1565,850,715
2021,Solihull 009D,E01010113,1353,676,677
2021,Solihull 009E,E01010114,1892,939,953
2021,Solihull 010A,E01010157,1437,715,722
2021,Solihull 010B,E01010159,1452,713,739
2021,Solihull 010C,E01010162,1553,762,791
2021,Solihull 010D,E01010163,1520,771,749
2021,Solihull 011A,E01010132,1542,808,734
2021,Solihull 011B,E01010133,1703,874,829
2021,Solihull 011C,E01010134,1480,765,715
2021,Solihull 011D,E01010135,1524,763,761
2021,Solihull 011E,E01010138,1405,711,694
2021,Solihull 012A,E01010136,1274,634,640
2021,Solihull 012B,E01010137,1376,685,691
2021,Solihull 012C,E01010158,1556,840,716
2021,Solihull 012D,E01010160,1487,743,744
2021,Solihull 012E,E01010161,1575,804,771
2021,Solihull 013A,E01010174,1685,848,837
2021,Solihull 013B,E01010175,1723,885,838
2021,Solihull 013C,E01010177,1342,684,658
2021,Solihull 013D,E01010178,1944,925,1019
2021,Solihull 014A,E01010172,1576,814,762
2021,Solihull 014B,E01010173,1426,705,721
2021,Solihull 014C,E01010176,1404,703,701
2021,Solihull 014D,E01010179,1572,815,757
2021,Solihull 015A,E01010115,1554,778,776
2021,Solihull 015B,E01010116,1373,712,661
2021,Solihull 015C,E01010227,1886,992,894
2021,Solihull 015D,E01010228,1613,831,782
2021,Solihull 015E,E01010232,2199,1159,1040
2021,Solihull 016A,E01010195,1596,808,788
2021,Solihull 016B,E01010226,1740,933,807
2021,Solihull 016C,E01010229,1599,804,795
2021,Solihull 016D,E01010230,1824,965,859
2021,Solihull 016E,E01010231,1671,823,848
2021,Solihull 016F,E01010233,1943,1006,937
2021,Solihull 017A,E01010108,2169,1094,1075
2021,Solihull 017B,E01010164,1715,856,859
2021,Solihull 017C,E01010165,1806,926,880
2021,Solihull 017D,E01010167,1654,863,791
2021,Solihull 018A,E01010199,1927,951,976
2021,Solihull 018B,E01010200,1448,756,692
2021,Solihull 018C,E01010201,1740,907,833
2021,Solihull 018D,E01010204,1366,711,655
2021,Solihull 018E,E01010205,1485,760,725
2021,Solihull 018F,E01010206,1770,904,866
2021,Solihull 019A,E01010192,1799,897,902
2021,Solihull 019B,E01010196,1755,869,886
2021,Solihull 019C,E01010197,1687,857,830
2021,Solihull 019D,E01010198,1660,881,779
2021,Solihull 021A,E01010218,1341,702,639
2021,Solihull 021B,E01010219,1569,824,745
2021,Solihull 021C,E01010221,2011,1061,950
2021,Solihull 021D,E01010222,1386,692,694
2021,Solihull 022A,E01010191,1935,992,943
2021,Solihull 022B,E01010202,1591,807,784
2021,Solihull 022C,E01010203,1746,874,872
2021,Solihull 022D,E01010209,1730,881,849
2021,Solihull 022E,E01010213,1774,929,845
2021,Solihull 023A,E01010208,1573,834,739
2021,Solihull 023B,E01010210,1528,789,739
2021,Solihull 023C,E01010211,1441,768,673
2021,Solihull 023D,E01010217,1541,781,760
2021,Solihull 024A,E01010190,1608,841,767
2021,Solihull 024B,E01010193,1244,632,612
2021,Solihull 024C,E01010194,1557,807,750
2021,Solihull 024D,E01010207,1439,753,686
2021,Solihull 025A,E01010166,1880,972,908
2021,Solihull 025B,E01010168,1807,926,881
2021,Solihull 025C,E01010169,1676,828,848
2021,Solihull 025D,E01010170,1482,756,726
2021,Solihull 025E,E01010171,1420,762,658
2021,Solihull 026A,E01010151,1636,874,762
2021,Solihull 026B,E01010152,1296,666,630
2021,Solihull 026C,E01010153,1784,924,860
2021,Solihull 026D,E01010154,1658,853,805
2021,Solihull 026E,E01010155,1825,953,872
2021,Solihull 026F,E01010156,1531,771,760
2021,Solihull 027A,E01010212,1259,627,632
2021,Solihull 027B,E01010214,1158,607,551
2021,Solihull 027C,E01010215,1509,785,724
2021,Solihull 027D,E01010216,1488,775,713
2021,Solihull 028A,E01010150,1593,853,740
2021,Solihull 028B,E01010184,1643,865,778
2021,Solihull 028C,E01010185,1553,789,764
2021,Solihull 028D,E01010186,1859,983,876
2021,Solihull 028E,E01010187,1484,735,749
2021,Solihull 028F,E01010188,1714,850,864
2021,Solihull 029A,E01010180,1503,782,721
2021,Solihull 029B,E01010181,2785,1428,1357
2021,Solihull 029D,E01010183,1893,952,941
2021,Solihull 029E,E01010189,1629,829,800
2021,Solihull 029F,E01032885,1561,749,812
2021,Solihull 029G,E01032886,2761,1384,1377
2021,Solihull 030A,E01010220,1666,853,813
2021,Solihull 030B,E01010223,1248,638,610
2021,Solihull 030C,E01010225,1519,772,747
2021,Solihull 030D,E01032590,2297,1170,1127
2021,Walsall 001A,E01010301,1448,729,719
2021,Walsall 001B,E01010303,1587,810,777
2021,Walsall 001C,E01010306,2258,1153,1105
2021,Walsall 001D,E01010307,1732,872,860
2021,Walsall 002A,E01010302,1536,801,735
2021,Walsall 002B,E01010304,1686,864,822
2021,Walsall 002C,E01010305,1385,723,662
2021,Walsall 002D,E01010308,1810,948,862
2021,Walsall 003A,E01010345,1123,576,547
2021,Walsall 003B,E01010346,1262,652,610
2021,Walsall 003C,E01010347,1474,727,747
2021,Walsall 003D,E01010350,1413,708,705
2021,Walsall 004A,E01010249,1759,917,842
2021,Walsall 004B,E01010250,1399,728,671
2021,Walsall 004C,E01010252,1776,919,857
2021,Walsall 004D,E01010254,1468,748,720
2021,Walsall 005A,E01010348,1505,796,709
2021,Walsall 005B,E01010349,1244,627,617
2021,Walsall 005C,E01010351,1728,869,859
2021,Walsall 005D,E01010352,1605,819,786
2021,Walsall 006A,E01010284,1681,871,810
2021,Walsall 006B,E01010285,1855,932,923
2021,Walsall 006C,E01010286,1635,847,788
2021,Walsall 006D,E01010290,1653,854,799
2021,Walsall 007A,E01010251,1543,767,776
2021,Walsall 007B,E01010253,1217,621,596
2021,Walsall 007C,E01010255,1343,703,640
2021,Walsall 007D,E01010256,1504,760,744
2021,Walsall 007E,E01010257,1148,585,563
2021,Walsall 008A,E01010292,1949,926,1023
2021,Walsall 008B,E01010294,1513,749,764
2021,Walsall 008C,E01010296,1455,746,709
2021,Walsall 008D,E01010297,1336,680,656
2021,Walsall 009A,E01010291,1478,783,695
2021,Walsall 009B,E01010293,1682,875,807
2021,Walsall 009C,E01010298,1221,613,608
2021,Walsall 009D,E01010299,1582,800,782
2021,Walsall 009E,E01010300,1459,757,702
2021,Walsall 010A,E01010319,1314,650,664
2021,Walsall 010B,E01010321,1601,811,790
2021,Walsall 010C,E01010353,1528,783,745
2021,Walsall 010D,E01010354,1540,781,759
2021,Walsall 011A,E01010395,1350,683,667
2021,Walsall 011B,E01010397,1701,890,811
2021,Walsall 011C,E01010398,1534,770,764
2021,Walsall 011D,E01010399,1527,760,767
2021,Walsall 012A,E01010282,1349,685,664
2021,Walsall 012B,E01010287,1710,887,823
2021,Walsall 012C,E01010288,1645,849,796
2021,Walsall 012D,E01010289,1956,1045,911
2021,Walsall 013B,E01010277,1766,882,884
2021,Walsall 013D,E01010283,1923,960,963
2021,Walsall 013F,E01033894,1809,931,878
2021,Walsall 013G,E01033895,1657,854,803
2021,Walsall 014A,E01010393,1468,746,722
2021,Walsall 014B,E01010394,1346,678,668
2021,Walsall 014C,E01010396,1680,851,829
2021,Walsall 014D,E01010400,2108,1171,937
2021,Walsall 015A,E01010241,2338,1255,1083
2021,Walsall 015B,E01010242,1638,857,781
2021,Walsall 015C,E01010243,1487,802,685
2021,Walsall 015D,E01010244,1457,776,681
2021,Walsall 016A,E01010320,1338,704,634
2021,Walsall 016B,E01010322,1681,883,798
2021,Walsall 016C,E01010323,1483,729,754
2021,Walsall 016D,E01010324,1947,956,991
2021,Walsall 017A,E01010271,2113,1120,993
2021,Walsall 017B,E01010272,1542,772,770
2021,Walsall 017C,E01010273,1505,780,725
2021,Walsall 017D,E01010295,1516,804,712
2021,Walsall 018B,E01010279,2018,1050,968
2021,Walsall 018D,E01010374,2707,1407,1300
2021,Walsall 018E,E01010375,2307,1187,1120
2021,Walsall 018F,E01032888,2760,1412,1348
2021,Walsall 019A,E01010378,1177,603,574
2021,Walsall 019B,E01010379,1273,647,626
2021,Walsall 019C,E01010382,1500,760,740
2021,Walsall 019D,E01010383,1679,887,792
2021,Walsall 020A,E01010376,1225,594,631
2021,Walsall 020B,E01010377,1811,915,896
2021,Walsall 020C,E01010380,1426,729,697
2021,Walsall 020D,E01010381,1569,782,787
2021,Walsall 021A,E01010267,1595,811,784
2021,Walsall 021B,E01010268,1797,923,874
2021,Walsall 021C,E01010274,1580,811,769
2021,Walsall 021D,E01010275,1891,1001,890
2021,Walsall 022A,E01010245,1592,836,756
2021,Walsall 022B,E01010246,1572,796,776
2021,Walsall 022C,E01010247,1579,792,787
2021,Walsall 022D,E01010248,1605,834,771
2021,Walsall 022E,E01010388,1431,710,721
2021,Walsall 023A,E01010258,1660,895,765
2021,Walsall 023B,E01010259,1592,831,761
2021,Walsall 023C,E01010260,1872,978,894
2021,Walsall 023D,E01010266,1317,684,633
2021,Walsall 024A,E01010317,1608,839,769
2021,Walsall 024B,E01010318,1626,863,763
2021,Walsall 024C,E01010325,1923,959,964
2021,Walsall 024D,E01010369,1744,856,888
2021,Walsall 025A,E01010401,1619,838,781
2021,Walsall 025B,E01010403,1953,972,981
2021,Walsall 025C,E01010404,2029,999,1030
2021,Walsall 025D,E01010407,1877,975,902
2021,Walsall 025E,E01010408,1760,917,843
2021,Walsall 026A,E01010269,1635,832,803
2021,Walsall 026B,E01010270,1757,910,847
2021,Walsall 026C,E01010362,1876,962,914
2021,Walsall 026D,E01010363,2713,1314,1399
2021,Walsall 027A,E01010402,1750,897,853
2021,Walsall 027B,E01010405,1837,903,934
2021,Walsall 027C,E01010406,2868,1425,1443
2021,Walsall 027D,E01010409,1549,808,741
2021,Walsall 028A,E01010385,1519,759,760
2021,Walsall 028B,E01010386,1601,836,765
2021,Walsall 028C,E01010387,1471,757,714
2021,Walsall 028D,E01010392,1524,771,753
2021,Walsall 029A,E01010326,1659,839,820
2021,Walsall 029B,E01010327,1695,881,814
2021,Walsall 029C,E01010328,1525,771,754
2021,Walsall 029D,E01010330,1479,733,746
2021,Walsall 030A,E01010368,2198,1078,1120
2021,Walsall 030B,E01010370,2090,1030,1060
2021,Walsall 030D,E01010372,1634,806,828
2021,Walsall 030E,E01010373,1890,1032,858
2021,Walsall 030F,E01033896,1619,785,834
2021,Walsall 030G,E01033897,1432,730,702
2021,Walsall 031A,E01010361,1500,775,725
2021,Walsall 031B,E01010364,1607,809,798
2021,Walsall 031C,E01010365,1715,872,843
2021,Walsall 031D,E01010366,1821,949,872
2021,Walsall 031E,E01010367,1912,959,953
2021,Walsall 032A,E01010384,1425,747,678
2021,Walsall 032B,E01010389,1476,734,742
2021,Walsall 032C,E01010390,1695,876,819
2021,Walsall 032D,E01010391,1863,979,884
2021,Walsall 033A,E01010261,1873,1014,859
2021,Walsall 033B,E01010263,1616,826,790
2021,Walsall 033C,E01010264,2028,1061,967
2021,Walsall 033D,E01010265,2033,965,1068
2021,Walsall 034A,E01010336,1527,766,761
2021,Walsall 034B,E01010340,1753,901,852
2021,Walsall 034C,E01010341,1687,875,812
2021,Walsall 034D,E01010342,1846,948,898
2021,Walsall 034E,E01010343,1601,812,789
2021,Walsall 034F,E01010344,1851,939,912
2021,Walsall 035A,E01010331,1655,856,799
2021,Walsall 035B,E01010332,2003,1006,997
2021,Walsall 035C,E01010333,1611,813,798
2021,Walsall 035D,E01010334,1577,816,761
2021,Walsall 036A,E01010262,1796,919,877
2021,Walsall 036B,E01010309,2218,1147,1071
2021,Walsall 036C,E01010311,2771,1444,1327
2021,Walsall 036D,E01010316,1705,869,836
2021,Walsall 037A,E01010335,1635,864,771
2021,Walsall 037B,E01010337,1378,719,659
2021,Walsall 037C,E01010338,1886,947,939
2021,Walsall 037D,E01010339,1526,780,746
2021,Walsall 038A,E01010310,2168,1101,1067
2021,Walsall 038B,E01010312,1794,939,855
2021,Walsall 038C,E01010313,1527,759,768
2021,Walsall 038D,E01010314,1667,787,880
2021,Walsall 038E,E01010315,1953,1013,940
2021,Walsall 039A,E01010329,1672,874,798
2021,Walsall 039B,E01010355,1434,740,694
2021,Walsall 039C,E01010356,1480,753,727
2021,Walsall 039D,E01010357,2323,1227,1096
2021,Walsall 039E,E01010358,1537,822,715
2021,Walsall 039F,E01010359,1523,800,723
2021,Walsall 039G,E01010360,1462,758,704
2021,Wolverhampton 001A,E01010434,1763,902,861
2021,Wolverhampton 001B,E01010436,1432,727,705
2021,Wolverhampton 001C,E01010437,1157,595,562
2021,Wolverhampton 001D,E01010438,1409,716,693
2021,Wolverhampton 001E,E01010439,1379,719,660
2021,Wolverhampton 001F,E01010440,1592,851,741
2021,Wolverhampton 001G,E01010441,1356,702,654
2021,Wolverhampton 002A,E01010495,1749,898,851
2021,Wolverhampton 002B,E01010497,1114,536,578
2021,Wolverhampton 002C,E01010499,1471,767,704
2021,Wolverhampton 002D,E01010500,1458,794,664
2021,Wolverhampton 003A,E01010496,1409,763,646
2021,Wolverhampton 003B,E01010498,1336,684,652
2021,Wolverhampton 003C,E01010541,1394,701,693
2021,Wolverhampton 003D,E01010543,1417,750,667
2021,Wolverhampton 004A,E01010456,1486,799,687
2021,Wolverhampton 004B,E01010457,1592,795,797
2021,Wolverhampton 004C,E01010462,1692,890,802
2021,Wolverhampton 004D,E01010481,1508,803,705
2021,Wolverhampton 005A,E01010555,1501,784,717
2021,Wolverhampton 005B,E01010556,1427,718,709
2021,Wolverhampton 005C,E01010557,1423,726,697
2021,Wolverhampton 005D,E01010559,1422,750,672
2021,Wolverhampton 005E,E01010560,1710,875,835
2021,Wolverhampton 006B,E01010501,1444,733,711
2021,Wolverhampton 006C,E01010502,1383,709,674
2021,Wolverhampton 006D,E01010503,1254,638,616
2021,Wolverhampton 006E,E01034310,1042,557,485
2021,Wolverhampton 006F,E01034311,2289,1133,1156
2021,Wolverhampton 007A,E01010482,1486,806,680
2021,Wolverhampton 007B,E01010483,1484,805,679
2021,Wolverhampton 007C,E01010484,1349,727,622
2021,Wolverhampton 007D,E01010485,2196,1166,1030
2021,Wolverhampton 008A,E01010458,1752,905,847
2021,Wolverhampton 008B,E01010459,1551,778,773
2021,Wolverhampton 008C,E01010460,1586,798,788
2021,Wolverhampton 008D,E01010461,1572,799,773
2021,Wolverhampton 008E,E01010566,1843,982,861
2021,Wolverhampton 009A,E01010539,1571,832,739
2021,Wolverhampton 009B,E01010540,1460,755,705
2021,Wolverhampton 009C,E01010542,1600,838,762
2021,Wolverhampton 009D,E01010544,1513,772,741
2021,Wolverhampton 009E,E01010545,1681,851,830
2021,Wolverhampton 010A,E01010554,1407,716,691
2021,Wolverhampton 010B,E01010558,1634,827,807
2021,Wolverhampton 010C,E01010562,1544,788,756
2021,Wolverhampton 010D,E01010563,1406,722,684
2021,Wolverhampton 010E,E01010567,1531,773,758
2021,Wolverhampton 011A,E01010478,1456,691,765
2021,Wolverhampton 011B,E01010479,1629,834,795
2021,Wolverhampton 011C,E01010480,1398,663,735
2021,Wolverhampton 011D,E01010486,1695,891,804
2021,Wolverhampton 012A,E01010474,1659,865,794
2021,Wolverhampton 012B,E01010561,1575,809,766
2021,Wolverhampton 012C,E01010564,2539,1253,1286
2021,Wolverhampton 012D,E01010565,1806,923,883
2021,Wolverhampton 013A,E01010522,1754,842,912
2021,Wolverhampton 013B,E01010523,1726,819,907
2021,Wolverhampton 013C,E01010524,1795,865,930
2021,Wolverhampton 013D,E01010525,1849,900,949
2021,Wolverhampton 014A,E01010546,1752,906,846
2021,Wolverhampton 014B,E01010547,1473,778,695
2021,Wolverhampton 014C,E01010548,1436,799,637
2021,Wolverhampton 014D,E01010549,1518,794,724
2021,Wolverhampton 014E,E01010553,1594,813,781
2021,Wolverhampton 015A,E01010471,1801,917,884
2021,Wolverhampton 015B,E01010472,2651,1388,1263
2021,Wolverhampton 015C,E01010473,2135,999,1136
2021,Wolverhampton 015D,E01010475,1660,814,846
2021,Wolverhampton 015E,E01010476,1956,1011,945
2021,Wolverhampton 015F,E01010477,1672,869,803
2021,Wolverhampton 016A,E01010526,1488,716,772
2021,Wolverhampton 016B,E01010527,1898,899,999
2021,Wolverhampton 016C,E01010528,1608,814,794
2021,Wolverhampton 016D,E01010529,1746,777,969
2021,Wolverhampton 017A,E01010506,1554,721,833
2021,Wolverhampton 017B,E01010508,1599,652,947
2021,Wolverhampton 017C,E01010510,1545,791,754
2021,Wolverhampton 017D,E01010511,1791,901,890
2021,Wolverhampton 017E,E01010512,1402,703,699
2021,Wolverhampton 018A,E01010442,1386,700,686
2021,Wolverhampton 018B,E01010443,1691,908,783
2021,Wolverhampton 018C,E01010444,1274,657,617
2021,Wolverhampton 018D,E01010445,1475,751,724
2021,Wolverhampton 018E,E01010447,1886,943,943
2021,Wolverhampton 018F,E01010448,1696,901,795
2021,Wolverhampton 019A,E01010509,1530,803,727
2021,Wolverhampton 019B,E01010550,1655,844,811
2021,Wolverhampton 019C,E01010551,1589,780,809
2021,Wolverhampton 019D,E01010552,1866,983,883
2021,Wolverhampton 020A,E01010463,1838,936,902
2021,Wolverhampton 020B,E01010464,1627,785,842
2021,Wolverhampton 020C,E01010465,1688,804,884
2021,Wolverhampton 020D,E01010466,1610,819,791
2021,Wolverhampton 020E,E01010470,1592,771,821
2021,Wolverhampton 020G,E01034312,1895,978,917
2021,Wolverhampton 020H,E01034313,1281,575,706
2021,Wolverhampton 021A,E01010487,1526,793,733
2021,Wolverhampton 021B,E01010488,1459,754,705
2021,Wolverhampton 021C,E01010493,1543,778,765
2021,Wolverhampton 021D,E01010504,1582,820,762
2021,Wolverhampton 021E,E01010505,1239,635,604
2021,Wolverhampton 021F,E01010507,1459,779,680
2021,Wolverhampton 022A,E01010418,1490,748,742
2021,Wolverhampton 022B,E01010421,1660,869,791
2021,Wolverhampton 022C,E01010423,1607,837,770
2021,Wolverhampton 022D,E01010424,1556,785,771
2021,Wolverhampton 023A,E01010417,1634,836,798
2021,Wolverhampton 023B,E01010419,1757,891,866
2021,Wolverhampton 023C,E01010420,1357,696,661
2021,Wolverhampton 023D,E01010425,1322,685,637
2021,Wolverhampton 023E,E01010446,1656,836,820
2021,Wolverhampton 026A,E01010467,1615,792,823
2021,Wolverhampton 026B,E01010468,1526,800,726
2021,Wolverhampton 026C,E01010469,1446,738,708
2021,Wolverhampton 026D,E01010516,1427,715,712
2021,Wolverhampton 026E,E01010518,1628,809,819
2021,Wolverhampton 027A,E01010414,2213,1104,1109
2021,Wolverhampton 027B,E01010415,1818,982,836
2021,Wolverhampton 027C,E01010416,1894,954,940
2021,Wolverhampton 027D,E01010422,1869,941,928
2021,Wolverhampton 028A,E01010489,1499,818,681
2021,Wolverhampton 028B,E01010490,1916,911,1005
2021,Wolverhampton 028C,E01010491,1567,789,778
2021,Wolverhampton 028D,E01010492,1279,648,631
2021,Wolverhampton 028E,E01010494,1579,803,776
2021,Wolverhampton 029A,E01010449,2492,1276,1216
2021,Wolverhampton 029B,E01010450,2676,1376,1300
2021,Wolverhampton 029C,E01010451,2033,1014,1019
2021,Wolverhampton 029D,E01010452,1659,876,783
2021,Wolverhampton 029E,E01010455,2645,1291,1354
2021,Wolverhampton 030A,E01010427,1827,919,908
2021,Wolverhampton 030B,E01010431,1555,788,767
2021,Wolverhampton 030C,E01010432,1529,764,765
2021,Wolverhampton 030D,E01010519,1551,803,748
2021,Wolverhampton 030E,E01010520,1679,827,852
2021,Wolverhampton 031A,E01010513,1548,809,739
2021,Wolverhampton 031B,E01010514,1650,832,818
2021,Wolverhampton 031C,E01010515,1662,835,827
2021,Wolverhampton 031D,E01010517,1706,885,821
2021,Wolverhampton 032A,E01010533,1790,925,865
2021,Wolverhampton 032B,E01010535,1579,829,750
2021,Wolverhampton 032C,E01010536,1657,848,809
2021,Wolverhampton 032D,E01010537,1460,734,726
2021,Wolverhampton 033A,E01010410,2432,1271,1161
2021,Wolverhampton 033B,E01010411,2160,1099,1061
2021,Wolverhampton 033C,E01010412,2142,1072,1070
2021,Wolverhampton 033D,E01010413,1702,885,817
2021,Wolverhampton 034A,E01010531,1785,956,829
2021,Wolverhampton 034B,E01010532,1739,870,869
2021,Wolverhampton 034C,E01010534,1500,745,755
2021,Wolverhampton 034D,E01010538,1561,797,764
2021,Wolverhampton 035A,E01010426,1517,786,731
2021,Wolverhampton 035B,E01010428,1609,788,821
2021,Wolverhampton 035C,E01010429,1359,673,686
2021,Wolverhampton 035D,E01010430,1842,884,958
2021,Wolverhampton 035E,E01010433,1376,677,699
2021,Wolverhampton 035G,E01010454,1708,857,851
2021,Wolverhampton 035H,E01010530,1939,1008,931
2021,Wolverhampton 035I,E01034314,1724,953,771
2021,Wolverhampton 035J,E01034315,1289,659,630
