date,geography,geography code,Sex: All persons; measures: Value,Sex: Female; measures: Value,Sex: Male; measures: Value
2021,Bolton 001,E02000984,7678,3886,3792
2021,Bolton 002,E02000985,7417,3861,3556
2021,Bolton 003,E02000986,8397,4324,4073
2021,Bolton 004,E02000987,7297,3775,3522
2021,Bolton 005,E02000988,9043,4560,4483
2021,Bolton 006,E02000989,8350,4341,4009
2021,Bolton 007,E02000990,8352,4219,4133
2021,Bolton 008,E02000991,7811,4001,3810
2021,Bolton 009,E02000992,6303,3243,3060
2021,Bolton 010,E02000993,8434,4373,4061
2021,Bolton 011,E02000994,9047,4477,4570
2021,Bolton 012,E02000995,8348,4274,4074
2021,Bolton 013,E02000996,8575,4439,4136
2021,Bolton 014,E02000997,6478,3326,3152
2021,Bolton 015,E02000998,10434,5100,5334
2021,Bolton 016,E02000999,8530,4110,4420
2021,Bolton 017,E02001000,9178,4520,4658
2021,Bolton 018,E02001001,8858,4463,4395
2021,Bolton 019,E02001002,9728,4969,4759
2021,Bolton 020,E02001003,7354,3736,3618
2021,Bolton 021,E02001004,9343,4564,4779
2021,Bolton 022,E02001005,9845,4951,4894
2021,Bolton 023,E02001006,8471,4306,4165
2021,Bolton 024,E02001007,10065,5157,4908
2021,Bolton 025,E02001008,9155,4685,4470
2021,Bolton 026,E02001009,7481,3776,3705
2021,Bolton 027,E02001010,6524,3282,3242
2021,Bolton 028,E02001011,9747,4910,4837
2021,Bolton 029,E02001012,9802,4974,4828
2021,Bolton 030,E02001013,6106,3145,2961
2021,Bolton 031,E02001014,8465,4275,4190
2021,Bolton 032,E02001015,8204,4190,4014
2021,Bolton 033,E02001016,8706,4441,4265
2021,Bolton 034,E02001017,10773,5546,5227
2021,Bolton 035,E02001018,7662,3855,3807
2021,Bury 001,E02001019,9040,4570,4470
2021,Bury 002,E02001020,5917,3097,2820
2021,Bury 003,E02001021,7504,3816,3688
2021,Bury 004,E02001022,8071,4141,3930
2021,Bury 005,E02001023,5695,2908,2787
2021,Bury 006,E02001024,8058,4155,3903
2021,Bury 007,E02001025,8152,4213,3939
2021,Bury 008,E02001026,11350,5626,5724
2021,Bury 009,E02001027,7282,3694,3588
2021,Bury 010,E02001028,7333,3753,3580
2021,Bury 011,E02001029,7777,3914,3863
2021,Bury 012,E02001030,6180,3178,3002
2021,Bury 013,E02001031,6877,3508,3369
2021,Bury 014,E02001032,7675,3938,3737
2021,Bury 015,E02001033,6183,3156,3027
2021,Bury 016,E02001034,8617,4327,4290
2021,Bury 017,E02001035,7218,3684,3534
2021,Bury 018,E02001036,7484,3876,3608
2021,Bury 019,E02001037,7215,3622,3593
2021,Bury 020,E02001038,5679,2891,2788
2021,Bury 021,E02001039,8602,4539,4063
2021,Bury 022,E02001040,6404,3159,3245
2021,Bury 023,E02001041,7730,3980,3750
2021,Bury 024,E02001042,6560,3262,3298
2021,Bury 025,E02001043,5686,2932,2754
2021,Bury 026,E02001044,9565,4805,4760
2021,Manchester 001,E02001045,8433,4518,3915
2021,Manchester 002,E02001046,11213,5730,5483
2021,Manchester 003,E02001047,10474,5355,5119
2021,Manchester 004,E02001048,9446,4717,4729
2021,Manchester 005,E02001049,10494,5489,5005
2021,Manchester 006,E02001050,8429,4255,4174
2021,Manchester 007,E02001051,9272,4824,4448
2021,Manchester 008,E02001052,15014,7415,7599
2021,Manchester 009,E02001053,11908,6109,5799
2021,Manchester 011,E02001055,9688,5009,4679
2021,Manchester 012,E02001056,8935,4603,4332
2021,Manchester 015,E02001059,11850,5933,5917
2021,Manchester 017,E02001061,10962,5582,5380
2021,Manchester 018,E02001062,10138,4973,5165
2021,Manchester 019,E02001063,11072,5678,5394
2021,Manchester 020,E02001064,10779,5435,5344
2021,Manchester 021,E02001065,9528,4853,4675
2021,Manchester 022,E02001066,11566,5711,5855
2021,Manchester 023,E02001067,11550,5898,5652
2021,Manchester 024,E02001068,11887,6110,5777
2021,Manchester 025,E02001069,12493,6246,6247
2021,Manchester 026,E02001070,11994,5913,6081
2021,Manchester 028,E02001072,8939,4294,4645
2021,Manchester 029,E02001073,9364,4685,4679
2021,Manchester 030,E02001074,11798,6071,5727
2021,Manchester 031,E02001075,9135,4406,4729
2021,Manchester 032,E02001076,11275,5814,5461
2021,Manchester 033,E02001077,7427,3819,3608
2021,Manchester 034,E02001078,10689,5396,5293
2021,Manchester 035,E02001079,9461,4947,4514
2021,Manchester 036,E02001080,9730,4890,4840
2021,Manchester 037,E02001081,6306,3260,3046
2021,Manchester 038,E02001082,6673,3437,3236
2021,Manchester 039,E02001083,8242,4162,4080
2021,Manchester 040,E02001084,8604,4377,4227
2021,Manchester 041,E02001085,8970,4698,4272
2021,Manchester 042,E02001086,6882,3545,3337
2021,Manchester 043,E02001087,9281,4690,4591
2021,Manchester 044,E02001088,9124,4817,4307
2021,Manchester 045,E02001089,8042,4087,3955
2021,Manchester 046,E02001090,6981,3442,3539
2021,Manchester 047,E02001091,8384,4362,4022
2021,Manchester 048,E02001092,9230,4690,4540
2021,Manchester 049,E02001093,9894,5198,4696
2021,Manchester 050,E02001094,9989,5224,4765
2021,Manchester 051,E02001095,9033,4771,4262
2021,Manchester 052,E02001096,8022,4124,3898
2021,Manchester 053,E02001097,8566,4511,4055
2021,Manchester 054,E02006902,7882,3521,4361
2021,Manchester 055,E02006912,10129,4462,5667
2021,Manchester 056,E02006913,7802,3740,4062
2021,Manchester 057,E02006914,7859,3987,3872
2021,Manchester 058,E02006915,9364,4373,4991
2021,Manchester 059,E02006916,6983,3188,3795
2021,Manchester 060,E02006917,6428,2720,3708
2021,Manchester 061,E02006983,7040,3459,3581
2021,Manchester 062,E02006984,5653,2549,3104
2021,Manchester 063,E02006985,9280,4545,4735
2021,Manchester 064,E02006986,6355,3259,3096
2021,Oldham 001,E02001098,5940,3026,2914
2021,Oldham 002,E02001099,5678,2917,2761
2021,Oldham 003,E02001100,6038,3178,2860
2021,Oldham 004,E02001101,5674,2878,2796
2021,Oldham 005,E02001102,6030,3069,2961
2021,Oldham 006,E02001103,5502,2830,2672
2021,Oldham 007,E02001104,7312,3764,3548
2021,Oldham 008,E02001105,5953,3089,2864
2021,Oldham 009,E02001106,6028,3090,2938
2021,Oldham 010,E02001107,6924,3540,3384
2021,Oldham 011,E02001108,5952,3159,2793
2021,Oldham 012,E02001109,7750,3934,3816
2021,Oldham 013,E02001110,6477,3310,3167
2021,Oldham 014,E02001111,9135,4379,4756
2021,Oldham 015,E02001112,5994,3003,2991
2021,Oldham 016,E02001113,9434,4690,4744
2021,Oldham 017,E02001114,8848,4571,4277
2021,Oldham 018,E02001115,5990,3118,2872
2021,Oldham 019,E02001116,7912,4085,3827
2021,Oldham 020,E02001117,6000,3112,2888
2021,Oldham 021,E02001118,6064,3114,2950
2021,Oldham 022,E02001119,12317,6124,6193
2021,Oldham 024,E02001121,8679,4394,4285
2021,Oldham 026,E02001123,7060,3782,3278
2021,Oldham 027,E02001124,6876,3431,3445
2021,Oldham 028,E02001125,7917,4037,3880
2021,Oldham 029,E02001126,9164,4628,4536
2021,Oldham 030,E02001127,7755,4085,3670
2021,Oldham 031,E02001128,7458,3859,3599
2021,Oldham 032,E02001129,6787,3537,3250
2021,Oldham 033,E02001130,5803,3044,2759
2021,Oldham 034,E02001131,5458,2844,2614
2021,Oldham 036,E02007000,7693,3859,3834
2021,Oldham 037,E02007001,8486,4286,4200
2021,Rochdale 001,E02001132,6625,3400,3225
2021,Rochdale 002,E02001133,6605,3330,3275
2021,Rochdale 003,E02001134,6325,3214,3111
2021,Rochdale 004,E02001135,8403,4262,4141
2021,Rochdale 005,E02001136,9545,4721,4824
2021,Rochdale 006,E02001137,6201,3178,3023
2021,Rochdale 007,E02001138,8650,4477,4173
2021,Rochdale 008,E02001139,10362,5186,5176
2021,Rochdale 009,E02001140,8149,4170,3979
2021,Rochdale 010,E02001141,12014,5916,6098
2021,Rochdale 011,E02001142,6016,3102,2914
2021,Rochdale 012,E02001143,11640,5977,5663
2021,Rochdale 013,E02001144,6338,3245,3093
2021,Rochdale 014,E02001145,7040,3585,3455
2021,Rochdale 015,E02001146,10295,5083,5212
2021,Rochdale 016,E02001147,10402,5423,4979
2021,Rochdale 017,E02001148,10458,5333,5125
2021,Rochdale 018,E02001149,10321,5283,5038
2021,Rochdale 019,E02001150,8981,4712,4269
2021,Rochdale 020,E02001151,10103,5134,4969
2021,Rochdale 021,E02001152,9776,4975,4801
2021,Rochdale 022,E02001153,12281,6427,5854
2021,Rochdale 023,E02001154,10132,5193,4939
2021,Rochdale 024,E02001155,7210,3643,3567
2021,Rochdale 025,E02001156,9903,5088,4815
2021,Salford 001,E02001157,8704,4611,4093
2021,Salford 002,E02001158,6061,3118,2943
2021,Salford 003,E02001159,7494,3872,3622
2021,Salford 004,E02001160,7272,3752,3520
2021,Salford 005,E02001161,5843,2985,2858
2021,Salford 006,E02001162,5821,2971,2850
2021,Salford 007,E02001163,9918,5031,4887
2021,Salford 008,E02001164,7676,3539,4137
2021,Salford 009,E02001165,6171,3180,2991
2021,Salford 010,E02001166,8246,3890,4356
2021,Salford 011,E02001167,6969,3564,3405
2021,Salford 012,E02001168,9894,5110,4784
2021,Salford 013,E02001169,10906,5588,5318
2021,Salford 014,E02001170,9851,4946,4905
2021,Salford 015,E02001171,6163,3113,3050
2021,Salford 017,E02001173,9504,4780,4724
2021,Salford 018,E02001174,5722,2864,2858
2021,Salford 019,E02001175,7505,3828,3677
2021,Salford 020,E02001176,11752,5737,6015
2021,Salford 021,E02001177,13344,6677,6667
2021,Salford 023,E02001179,7017,3468,3549
2021,Salford 024,E02001180,5686,2751,2935
2021,Salford 025,E02001181,5976,2964,3012
2021,Salford 026,E02001182,7353,3663,3690
2021,Salford 027,E02001183,7329,3692,3637
2021,Salford 029,E02001185,9700,5019,4681
2021,Salford 030,E02001186,10556,5401,5155
2021,Salford 031,E02006957,8279,4013,4266
2021,Salford 032,E02006958,8073,3883,4190
2021,Salford 033,E02006959,8024,3668,4356
2021,Salford 034,E02006960,9327,4488,4839
2021,Salford 035,E02006961,6666,3259,3407
2021,Salford 036,E02006962,5123,2355,2768
2021,Salford 037,E02006963,6006,2614,3392
2021,Stockport 001,E02001187,7004,3656,3348
2021,Stockport 002,E02001188,8651,4404,4247
2021,Stockport 003,E02001189,8298,4294,4004
2021,Stockport 004,E02001190,7960,4045,3915
2021,Stockport 005,E02001191,5740,2952,2788
2021,Stockport 006,E02001192,6557,3288,3269
2021,Stockport 007,E02001193,6410,3240,3170
2021,Stockport 008,E02001194,6376,3222,3154
2021,Stockport 009,E02001195,7553,3882,3671
2021,Stockport 010,E02001196,7831,4040,3791
2021,Stockport 011,E02001197,6278,3243,3035
2021,Stockport 012,E02001198,7519,3960,3559
2021,Stockport 013,E02001199,7905,4030,3875
2021,Stockport 014,E02001200,7887,3889,3998
2021,Stockport 015,E02001201,5787,2956,2831
2021,Stockport 016,E02001202,6454,3275,3179
2021,Stockport 017,E02001203,5861,3017,2844
2021,Stockport 018,E02001204,8923,4596,4327
2021,Stockport 019,E02001205,8430,4328,4102
2021,Stockport 020,E02001206,7269,3780,3489
2021,Stockport 021,E02001207,6849,3476,3373
2021,Stockport 022,E02001208,7570,3949,3621
2021,Stockport 023,E02001209,7769,4015,3754
2021,Stockport 024,E02001210,7438,3890,3548
2021,Stockport 025,E02001211,6667,3441,3226
2021,Stockport 026,E02001212,6989,3608,3381
2021,Stockport 027,E02001213,9918,5044,4874
2021,Stockport 028,E02001214,8020,4171,3849
2021,Stockport 029,E02001215,5973,3090,2883
2021,Stockport 030,E02001216,7841,3997,3844
2021,Stockport 031,E02001217,6758,3483,3275
2021,Stockport 032,E02001218,6022,3110,2912
2021,Stockport 033,E02001219,5284,2700,2584
2021,Stockport 034,E02001220,5675,2904,2771
2021,Stockport 035,E02001221,5866,2954,2912
2021,Stockport 036,E02001222,6478,3350,3128
2021,Stockport 037,E02001223,6667,3460,3207
2021,Stockport 038,E02001224,5784,2963,2821
2021,Stockport 039,E02001225,7377,3842,3535
2021,Stockport 040,E02001226,7180,3647,3533
2021,Stockport 041,E02001227,5690,2959,2731
2021,Stockport 042,E02001228,6260,3220,3040
2021,Tameside 001,E02001229,10311,5242,5069
2021,Tameside 002,E02001230,5871,2939,2932
2021,Tameside 003,E02001231,7101,3645,3456
2021,Tameside 004,E02001232,8694,4538,4156
2021,Tameside 005,E02001233,7992,4085,3907
2021,Tameside 006,E02001234,7944,4074,3870
2021,Tameside 007,E02001235,7215,3551,3664
2021,Tameside 008,E02001236,6114,3096,3018
2021,Tameside 009,E02001237,7218,3707,3511
2021,Tameside 010,E02001238,7993,4065,3928
2021,Tameside 011,E02001239,9538,4909,4629
2021,Tameside 012,E02001240,6383,3209,3174
2021,Tameside 013,E02001241,11205,5475,5730
2021,Tameside 014,E02001242,7055,3639,3416
2021,Tameside 015,E02001243,8237,4092,4145
2021,Tameside 016,E02001244,5409,2728,2681
2021,Tameside 017,E02001245,8041,4036,4005
2021,Tameside 018,E02001246,7438,3900,3538
2021,Tameside 019,E02001247,7418,3781,3637
2021,Tameside 020,E02001248,11983,6129,5854
2021,Tameside 021,E02001249,6371,3294,3077
2021,Tameside 022,E02001250,6475,3308,3167
2021,Tameside 023,E02001251,6095,3074,3021
2021,Tameside 024,E02001252,7540,3873,3667
2021,Tameside 025,E02001253,5012,2553,2459
2021,Tameside 026,E02001254,5634,2911,2723
2021,Tameside 027,E02001255,7683,3972,3711
2021,Tameside 028,E02001256,10544,5371,5173
2021,Tameside 029,E02001257,9119,4759,4360
2021,Tameside 030,E02001258,7437,3839,3598
2021,Trafford 001,E02001259,11722,5864,5858
2021,Trafford 002,E02001260,7581,3906,3675
2021,Trafford 003,E02001261,8878,4472,4406
2021,Trafford 004,E02001262,8674,4430,4244
2021,Trafford 005,E02001263,8395,4300,4095
2021,Trafford 006,E02001264,8655,4431,4224
2021,Trafford 007,E02001265,8193,4251,3942
2021,Trafford 008,E02001266,6924,3593,3331
2021,Trafford 009,E02001267,7247,3758,3489
2021,Trafford 010,E02001268,7040,3668,3372
2021,Trafford 011,E02001269,8356,4273,4083
2021,Trafford 012,E02001270,8549,4361,4188
2021,Trafford 013,E02001271,6644,3454,3190
2021,Trafford 014,E02001272,8027,4079,3948
2021,Trafford 015,E02001273,9535,4775,4760
2021,Trafford 016,E02001274,8058,4131,3927
2021,Trafford 017,E02001275,8189,4330,3859
2021,Trafford 018,E02001276,8116,4260,3856
2021,Trafford 019,E02001277,9350,4878,4472
2021,Trafford 020,E02001278,8694,4347,4347
2021,Trafford 021,E02001279,8286,4153,4133
2021,Trafford 022,E02001280,8401,4395,4006
2021,Trafford 023,E02001281,7737,4030,3707
2021,Trafford 024,E02001282,10105,5197,4908
2021,Trafford 025,E02001283,9514,4811,4703
2021,Trafford 026,E02001284,8153,4147,4006
2021,Trafford 027,E02001285,7756,4047,3709
2021,Trafford 028,E02001286,8278,4306,3972
2021,Wigan 001,E02001287,6630,3384,3246
2021,Wigan 002,E02001288,8334,4222,4112
2021,Wigan 003,E02001289,10174,5150,5024
2021,Wigan 004,E02001290,6129,3159,2970
2021,Wigan 005,E02001291,7815,3978,3837
2021,Wigan 006,E02001292,8030,3986,4044
2021,Wigan 007,E02001293,6258,3204,3054
2021,Wigan 008,E02001294,7998,3963,4035
2021,Wigan 009,E02001295,7232,3495,3737
2021,Wigan 010,E02001296,9049,4670,4379
2021,Wigan 011,E02001297,6605,3319,3286
2021,Wigan 012,E02001298,8123,4113,4010
2021,Wigan 013,E02001299,8690,4393,4297
2021,Wigan 014,E02001300,7888,3997,3891
2021,Wigan 015,E02001301,9029,4544,4485
2021,Wigan 016,E02001302,7985,4044,3941
2021,Wigan 017,E02001303,9028,4561,4467
2021,Wigan 018,E02001304,12764,6513,6251
2021,Wigan 019,E02001305,8520,4339,4181
2021,Wigan 020,E02001306,7149,3635,3514
2021,Wigan 021,E02001307,11653,5944,5709
2021,Wigan 022,E02001308,5970,3030,2940
2021,Wigan 023,E02001309,8354,4250,4104
2021,Wigan 024,E02001310,9227,4660,4567
2021,Wigan 025,E02001311,8192,4155,4037
2021,Wigan 026,E02001312,8687,4090,4597
2021,Wigan 027,E02001313,8167,4094,4073
2021,Wigan 028,E02001314,8008,4041,3967
2021,Wigan 029,E02001315,9439,4804,4635
2021,Wigan 030,E02001316,7358,3597,3761
2021,Wigan 031,E02001317,9006,4550,4456
2021,Wigan 032,E02001318,7830,3937,3893
2021,Wigan 033,E02001319,8321,4125,4196
2021,Wigan 034,E02001320,7389,3829,3560
2021,Wigan 035,E02001321,8005,4045,3960
2021,Wigan 036,E02001322,7206,3711,3495
2021,Wigan 037,E02001323,7704,3928,3776
2021,Wigan 038,E02001324,8267,4150,4117
2021,Wigan 039,E02001325,8956,4582,4374
2021,Wigan 040,E02001326,8163,4142,4021
2021,Birmingham 001,E02001827,6452,3368,3084
2021,Birmingham 002,E02001828,7142,3703,3439
2021,Birmingham 003,E02001829,9160,4724,4436
2021,Birmingham 004,E02001830,9686,4933,4753
2021,Birmingham 005,E02001831,10683,5650,5033
2021,Birmingham 006,E02001832,7931,4042,3889
2021,Birmingham 007,E02001833,5936,2983,2953
2021,Birmingham 008,E02001834,6110,3198,2912
2021,Birmingham 009,E02001835,8472,4351,4121
2021,Birmingham 010,E02001836,9105,4642,4463
2021,Birmingham 011,E02001837,10667,5491,5176
2021,Birmingham 012,E02001838,7570,3907,3663
2021,Birmingham 013,E02001839,6440,3374,3066
2021,Birmingham 014,E02001840,9606,5075,4531
2021,Birmingham 015,E02001841,5963,3067,2896
2021,Birmingham 016,E02001842,8068,4135,3933
2021,Birmingham 017,E02001843,6639,3387,3252
2021,Birmingham 018,E02001844,9715,4991,4724
2021,Birmingham 019,E02001845,6662,3478,3184
2021,Birmingham 020,E02001846,8157,4197,3960
2021,Birmingham 021,E02001847,5596,2847,2749
2021,Birmingham 022,E02001848,7320,3900,3420
2021,Birmingham 023,E02001849,8792,4476,4316
2021,Birmingham 024,E02001850,8605,4343,4262
2021,Birmingham 025,E02001851,9083,4686,4397
2021,Birmingham 026,E02001852,7030,3537,3493
2021,Birmingham 029,E02001855,9935,5379,4556
2021,Birmingham 030,E02001856,9638,4829,4809
2021,Birmingham 031,E02001857,13854,6794,7060
2021,Birmingham 032,E02001858,9147,4626,4521
2021,Birmingham 033,E02001859,10398,5194,5204
2021,Birmingham 034,E02001860,8471,4243,4228
2021,Birmingham 035,E02001861,11205,5519,5686
2021,Birmingham 036,E02001862,9877,5011,4866
2021,Birmingham 037,E02001863,8404,4120,4284
2021,Birmingham 039,E02001865,11402,5619,5783
2021,Birmingham 040,E02001866,9451,4554,4897
2021,Birmingham 041,E02001867,8667,4352,4315
2021,Birmingham 042,E02001868,9818,4946,4872
2021,Birmingham 043,E02001869,7010,3680,3330
2021,Birmingham 044,E02001870,12993,6620,6373
2021,Birmingham 045,E02001871,8339,4413,3926
2021,Birmingham 046,E02001872,7423,3988,3435
2021,Birmingham 047,E02001873,11386,5780,5606
2021,Birmingham 048,E02001874,9959,5051,4908
2021,Birmingham 049,E02001875,8961,4463,4498
2021,Birmingham 050,E02001876,16085,8554,7531
2021,Birmingham 051,E02001877,12396,6241,6155
2021,Birmingham 052,E02001878,9522,4804,4718
2021,Birmingham 053,E02001879,10025,4793,5232
2021,Birmingham 054,E02001880,10037,5260,4777
2021,Birmingham 055,E02001881,10496,5295,5201
2021,Birmingham 056,E02001882,8912,4549,4363
2021,Birmingham 057,E02001883,8517,4406,4111
2021,Birmingham 058,E02001884,10188,5156,5032
2021,Birmingham 060,E02001886,9892,4771,5121
2021,Birmingham 062,E02001888,7181,3736,3445
2021,Birmingham 063,E02001889,9053,4521,4532
2021,Birmingham 064,E02001890,9976,4923,5053
2021,Birmingham 066,E02001892,11587,5961,5626
2021,Birmingham 067,E02001893,8822,4451,4371
2021,Birmingham 069,E02001895,8955,4727,4228
2021,Birmingham 070,E02001896,10158,5144,5014
2021,Birmingham 071,E02001897,8626,4347,4279
2021,Birmingham 072,E02001898,6558,3320,3238
2021,Birmingham 073,E02001899,8533,4403,4130
2021,Birmingham 074,E02001900,6710,3250,3460
2021,Birmingham 075,E02001901,8142,4231,3911
2021,Birmingham 076,E02001902,6255,3169,3086
2021,Birmingham 077,E02001903,8074,4039,4035
2021,Birmingham 078,E02001904,7725,3933,3792
2021,Birmingham 079,E02001905,10274,5504,4770
2021,Birmingham 080,E02001906,9569,4976,4593
2021,Birmingham 081,E02001907,10414,5204,5210
2021,Birmingham 082,E02001908,8953,4420,4533
2021,Birmingham 083,E02001909,8290,4143,4147
2021,Birmingham 084,E02001910,7232,3527,3705
2021,Birmingham 085,E02001911,8738,4521,4217
2021,Birmingham 087,E02001913,7442,3796,3646
2021,Birmingham 088,E02001914,7060,3486,3574
2021,Birmingham 089,E02001915,11959,5951,6008
2021,Birmingham 090,E02001916,9897,4994,4903
2021,Birmingham 092,E02001918,8651,4229,4422
2021,Birmingham 093,E02001919,6941,3455,3486
2021,Birmingham 094,E02001920,7654,4036,3618
2021,Birmingham 095,E02001921,7739,4019,3720
2021,Birmingham 096,E02001922,15988,8751,7237
2021,Birmingham 097,E02001923,11118,5666,5452
2021,Birmingham 098,E02001924,7077,3617,3460
2021,Birmingham 099,E02001925,6736,3471,3265
2021,Birmingham 100,E02001926,7829,3934,3895
2021,Birmingham 101,E02001927,7669,4048,3621
2021,Birmingham 102,E02001928,6818,3608,3210
2021,Birmingham 103,E02001929,10508,5440,5068
2021,Birmingham 104,E02001930,7703,3955,3748
2021,Birmingham 105,E02001931,8591,4368,4223
2021,Birmingham 106,E02001932,7425,3957,3468
2021,Birmingham 107,E02001933,7719,4004,3715
2021,Birmingham 108,E02001934,7146,3633,3513
2021,Birmingham 109,E02001935,8080,4260,3820
2021,Birmingham 110,E02001936,6384,3283,3101
2021,Birmingham 111,E02001937,8384,4315,4069
2021,Birmingham 112,E02001938,7870,4018,3852
2021,Birmingham 113,E02001939,6294,3372,2922
2021,Birmingham 115,E02001941,6550,3397,3153
2021,Birmingham 116,E02001942,6780,3529,3251
2021,Birmingham 117,E02001943,6475,3298,3177
2021,Birmingham 118,E02001944,8068,4165,3903
2021,Birmingham 119,E02001945,7894,4084,3810
2021,Birmingham 120,E02001946,7583,3846,3737
2021,Birmingham 121,E02001947,6239,3273,2966
2021,Birmingham 122,E02001948,7346,3765,3581
2021,Birmingham 123,E02001949,6161,3258,2903
2021,Birmingham 124,E02001950,8569,4452,4117
2021,Birmingham 125,E02001951,9433,4993,4440
2021,Birmingham 126,E02001952,9130,4744,4386
2021,Birmingham 127,E02001953,7112,3685,3427
2021,Birmingham 128,E02001954,7581,4032,3549
2021,Birmingham 129,E02001955,8096,4189,3907
2021,Birmingham 130,E02001956,6848,3523,3325
2021,Birmingham 131,E02001957,7880,4110,3770
2021,Birmingham 132,E02006807,8210,4172,4038
2021,Birmingham 133,E02006809,10153,5139,5014
2021,Birmingham 134,E02006895,9361,4707,4654
2021,Birmingham 135,E02006896,6124,2831,3293
2021,Birmingham 136,E02006897,8455,4188,4267
2021,Birmingham 137,E02006898,7904,3766,4138
2021,Birmingham 138,E02006899,6145,2794,3351
2021,Birmingham 139,E02006900,15720,7948,7772
2021,Birmingham 141,E02007038,13692,7003,6689
2021,Birmingham 142,E02007039,8305,4174,4131
2021,Birmingham 143,E02007040,7599,3827,3772
2021,Coventry 001,E02001958,8072,4062,4010
2021,Coventry 002,E02001959,6929,3538,3391
2021,Coventry 004,E02001961,7966,4044,3922
2021,Coventry 005,E02001962,7211,3686,3525
2021,Coventry 006,E02001963,6141,3101,3040
2021,Coventry 007,E02001964,11009,5768,5241
2021,Coventry 008,E02001965,8082,4126,3956
2021,Coventry 009,E02001966,7355,3688,3667
2021,Coventry 010,E02001967,6960,3562,3398
2021,Coventry 011,E02001968,7959,4032,3927
2021,Coventry 012,E02001969,6775,3500,3275
2021,Coventry 013,E02001970,5758,2946,2812
2021,Coventry 014,E02001971,6289,3248,3041
2021,Coventry 015,E02001972,11719,5844,5875
2021,Coventry 016,E02001973,8535,4274,4261
2021,Coventry 017,E02001974,9461,4804,4657
2021,Coventry 018,E02001975,7637,3878,3759
2021,Coventry 019,E02001976,7499,3819,3680
2021,Coventry 020,E02001977,10016,4788,5228
2021,Coventry 021,E02001978,6811,3357,3454
2021,Coventry 022,E02001979,5604,2890,2714
2021,Coventry 023,E02001980,5791,2945,2846
2021,Coventry 024,E02001981,13440,6541,6899
2021,Coventry 025,E02001982,8410,4285,4125
2021,Coventry 026,E02001983,7610,3815,3795
2021,Coventry 027,E02001984,10468,5335,5133
2021,Coventry 028,E02001985,9241,3912,5329
2021,Coventry 029,E02001986,7981,4009,3972
2021,Coventry 030,E02001987,5910,2858,3052
2021,Coventry 031,E02001988,11152,5189,5963
2021,Coventry 032,E02001989,6295,3166,3129
2021,Coventry 033,E02001990,9184,4696,4488
2021,Coventry 034,E02001991,8475,4212,4263
2021,Coventry 035,E02001992,10785,5605,5180
2021,Coventry 036,E02001993,8985,4405,4580
2021,Coventry 037,E02001994,7961,4028,3933
2021,Coventry 038,E02001995,9426,4777,4649
2021,Coventry 039,E02001996,7688,3921,3767
2021,Coventry 040,E02001997,8511,4336,4175
2021,Coventry 041,E02001998,6036,3032,3004
2021,Coventry 042,E02001999,9105,4531,4574
2021,Coventry 043,E02006805,9084,4584,4500
2021,Dudley 001,E02002000,8549,4443,4106
2021,Dudley 002,E02002001,6064,3046,3018
2021,Dudley 003,E02002002,6901,3533,3368
2021,Dudley 004,E02002003,9019,4530,4489
2021,Dudley 005,E02002004,7575,3955,3620
2021,Dudley 006,E02002005,9888,5126,4762
2021,Dudley 007,E02002006,6481,3281,3200
2021,Dudley 008,E02002007,9028,4589,4439
2021,Dudley 009,E02002008,8164,4165,3999
2021,Dudley 010,E02002009,7117,3638,3479
2021,Dudley 011,E02002010,8372,4061,4311
2021,Dudley 012,E02002011,5905,3000,2905
2021,Dudley 013,E02002012,8413,4334,4079
2021,Dudley 014,E02002013,6572,3390,3182
2021,Dudley 015,E02002014,8312,4184,4128
2021,Dudley 016,E02002015,7059,3565,3494
2021,Dudley 017,E02002016,8047,4184,3863
2021,Dudley 018,E02002017,8071,4103,3968
2021,Dudley 019,E02002018,8931,4608,4323
2021,Dudley 020,E02002019,7798,3964,3834
2021,Dudley 021,E02002020,9485,4853,4632
2021,Dudley 022,E02002021,7709,3795,3914
2021,Dudley 023,E02002022,8881,4525,4356
2021,Dudley 024,E02002023,5358,2726,2632
2021,Dudley 025,E02002024,8738,4437,4301
2021,Dudley 026,E02002025,8896,4498,4398
2021,Dudley 027,E02002026,6782,3413,3369
2021,Dudley 028,E02002027,5379,2700,2679
2021,Dudley 029,E02002028,5732,2933,2799
2021,Dudley 030,E02002029,6224,3252,2972
2021,Dudley 031,E02002030,6816,3394,3422
2021,Dudley 032,E02002031,6262,3107,3155
2021,Dudley 033,E02002032,10213,5248,4965
2021,Dudley 034,E02002033,7815,3987,3828
2021,Dudley 035,E02002034,8168,4089,4079
2021,Dudley 036,E02002035,6115,3145,2970
2021,Dudley 037,E02002036,6668,3204,3464
2021,Dudley 038,E02002037,5923,3057,2866
2021,Dudley 039,E02002038,9615,4863,4752
2021,Dudley 040,E02002039,6208,3082,3126
2021,Dudley 041,E02002040,5933,3017,2916
2021,Dudley 042,E02002041,6272,3332,2940
2021,Dudley 043,E02002042,8028,4116,3912
2021,Sandwell 001,E02002043,8757,4409,4348
2021,Sandwell 002,E02002044,8052,4200,3852
2021,Sandwell 003,E02002045,7811,4060,3751
2021,Sandwell 004,E02002046,5714,2948,2766
2021,Sandwell 005,E02002047,7553,3753,3800
2021,Sandwell 006,E02002048,6829,3556,3273
2021,Sandwell 007,E02002049,6309,3202,3107
2021,Sandwell 009,E02002051,6169,3224,2945
2021,Sandwell 010,E02002052,11365,5873,5492
2021,Sandwell 011,E02002053,6327,3289,3038
2021,Sandwell 012,E02002054,5818,3057,2761
2021,Sandwell 013,E02002055,11126,5720,5406
2021,Sandwell 014,E02002056,9881,5028,4853
2021,Sandwell 015,E02002057,10722,5388,5334
2021,Sandwell 016,E02002058,13570,6805,6765
2021,Sandwell 017,E02002059,11792,5899,5893
2021,Sandwell 018,E02002060,7356,3681,3675
2021,Sandwell 019,E02002061,7059,3580,3479
2021,Sandwell 020,E02002062,8958,4492,4466
2021,Sandwell 021,E02002063,10327,5115,5212
2021,Sandwell 022,E02002064,12496,6265,6231
2021,Sandwell 023,E02002065,14169,7075,7094
2021,Sandwell 024,E02002066,8258,4112,4146
2021,Sandwell 025,E02002067,6321,3262,3059
2021,Sandwell 027,E02002069,7244,3658,3586
2021,Sandwell 028,E02002070,10338,5144,5194
2021,Sandwell 029,E02002071,6717,3468,3249
2021,Sandwell 030,E02002072,8923,4503,4420
2021,Sandwell 031,E02002073,8409,4321,4088
2021,Sandwell 032,E02002074,8206,4204,4002
2021,Sandwell 033,E02002075,8733,4472,4261
2021,Sandwell 034,E02002076,10670,5478,5192
2021,Sandwell 035,E02002077,10884,5472,5412
2021,Sandwell 036,E02002078,6570,3401,3169
2021,Sandwell 037,E02002079,8659,4434,4225
2021,Sandwell 038,E02002080,7378,3786,3592
2021,Sandwell 039,E02006810,10687,5376,5311
2021,Sandwell 040,E02006943,7596,3832,3764
2021,Sandwell 041,E02006944,8075,4031,4044
2021,Solihull 001,E02002081,5434,2790,2644
2021,Solihull 002,E02002082,5840,3070,2770
2021,Solihull 003,E02002083,6029,3080,2949
2021,Solihull 004,E02002084,6746,3559,3187
2021,Solihull 005,E02002085,6659,3522,3137
2021,Solihull 006,E02002086,5923,3089,2834
2021,Solihull 007,E02002087,6297,3328,2969
2021,Solihull 008,E02002088,9583,5054,4529
2021,Solihull 009,E02002089,8066,4103,3963
2021,Solihull 010,E02002090,5962,2961,3001
2021,Solihull 011,E02002091,7654,3921,3733
2021,Solihull 012,E02002092,7266,3706,3560
2021,Solihull 013,E02002093,6691,3339,3352
2021,Solihull 014,E02002094,5980,3039,2941
2021,Solihull 015,E02002095,8625,4472,4153
2021,Solihull 016,E02002096,10373,5339,5034
2021,Solihull 017,E02002097,7345,3739,3606
2021,Solihull 018,E02002098,9737,4989,4748
2021,Solihull 019,E02002099,6900,3503,3397
2021,Solihull 021,E02002101,6305,3277,3028
2021,Solihull 022,E02002102,8776,4483,4293
2021,Solihull 023,E02002103,6082,3171,2911
2021,Solihull 024,E02002104,5848,3033,2815
2021,Solihull 025,E02002105,8265,4244,4021
2021,Solihull 026,E02002106,9730,5041,4689
2021,Solihull 027,E02002107,5413,2794,2619
2021,Solihull 028,E02002108,9848,5075,4773
2021,Solihull 029,E02002109,12132,6124,6008
2021,Solihull 030,E02006808,6732,3435,3297
2021,Walsall 001,E02002110,7024,3563,3461
2021,Walsall 002,E02002111,6417,3336,3081
2021,Walsall 003,E02002112,5270,2661,2609
2021,Walsall 004,E02002113,6402,3312,3090
2021,Walsall 005,E02002114,6082,3111,2971
2021,Walsall 006,E02002115,6823,3503,3320
2021,Walsall 007,E02002116,6755,3436,3319
2021,Walsall 008,E02002117,6253,3101,3152
2021,Walsall 009,E02002118,7420,3827,3593
2021,Walsall 010,E02002119,5983,3025,2958
2021,Walsall 011,E02002120,6110,3103,3007
2021,Walsall 012,E02002121,6663,3469,3194
2021,Walsall 013,E02002122,7155,3627,3528
2021,Walsall 014,E02002123,6602,3446,3156
2021,Walsall 015,E02002124,6920,3690,3230
2021,Walsall 016,E02002125,6449,3272,3177
2021,Walsall 017,E02002126,6678,3477,3201
2021,Walsall 018,E02002127,9792,5056,4736
2021,Walsall 019,E02002128,5628,2897,2731
2021,Walsall 020,E02002129,6031,3020,3011
2021,Walsall 021,E02002130,6863,3546,3317
2021,Walsall 022,E02002131,7778,3968,3810
2021,Walsall 023,E02002132,6441,3388,3053
2021,Walsall 024,E02002133,6901,3517,3384
2021,Walsall 025,E02002134,9235,4699,4536
2021,Walsall 026,E02002135,7981,4018,3963
2021,Walsall 027,E02002136,8004,4033,3971
2021,Walsall 028,E02002137,6115,3123,2992
2021,Walsall 029,E02002138,6358,3224,3134
2021,Walsall 030,E02002139,10861,5459,5402
2021,Walsall 031,E02002140,8555,4364,4191
2021,Walsall 032,E02002141,6459,3336,3123
2021,Walsall 033,E02002142,7550,3866,3684
2021,Walsall 034,E02002143,10264,5241,5023
2021,Walsall 035,E02002144,6845,3490,3355
2021,Walsall 036,E02002145,8492,4380,4112
2021,Walsall 037,E02002146,6425,3310,3115
2021,Walsall 038,E02002147,9109,4599,4510
2021,Walsall 039,E02002148,11431,5974,5457
2021,Wolverhampton 001,E02002149,10087,5214,4873
2021,Wolverhampton 002,E02002150,5791,2995,2796
2021,Wolverhampton 003,E02002151,5556,2898,2658
2021,Wolverhampton 004,E02002152,6275,3287,2988
2021,Wolverhampton 005,E02002153,7483,3853,3630
2021,Wolverhampton 006,E02002154,7412,3770,3642
2021,Wolverhampton 007,E02002155,6515,3504,3011
2021,Wolverhampton 008,E02002156,8302,4262,4040
2021,Wolverhampton 009,E02002157,7825,4048,3777
2021,Wolverhampton 010,E02002158,7523,3824,3699
2021,Wolverhampton 011,E02002159,6178,3079,3099
2021,Wolverhampton 012,E02002160,7579,3850,3729
2021,Wolverhampton 013,E02002161,7124,3426,3698
2021,Wolverhampton 014,E02002162,7773,4090,3683
2021,Wolverhampton 015,E02002163,11875,5998,5877
2021,Wolverhampton 016,E02002164,6743,3209,3534
2021,Wolverhampton 017,E02002165,7893,3770,4123
2021,Wolverhampton 018,E02002166,9408,4860,4548
2021,Wolverhampton 019,E02002167,6642,3410,3232
2021,Wolverhampton 020,E02002168,11532,5669,5863
2021,Wolverhampton 021,E02002169,8808,4561,4247
2021,Wolverhampton 022,E02002170,6315,3239,3076
2021,Wolverhampton 023,E02002171,7725,3944,3781
2021,Wolverhampton 026,E02002174,7643,3855,3788
2021,Wolverhampton 027,E02002175,7793,3980,3813
2021,Wolverhampton 028,E02002176,7841,3969,3872
2021,Wolverhampton 029,E02002177,11505,5833,5672
2021,Wolverhampton 030,E02002178,8141,4101,4040
2021,Wolverhampton 031,E02002179,6568,3361,3207
2021,Wolverhampton 032,E02002180,6487,3336,3151
2021,Wolverhampton 033,E02002181,8435,4326,4109
2021,Wolverhampton 034,E02002182,6586,3369,3217
2021,Wolverhampton 035,E02006894,14363,7285,7078
