date,geography,geography code,Residence type: Total; measures: Value,Residence type: Lives in a household; measures: Value,Residence type: Lives in a communal establishment; measures: Value
2021,Bolton 001,E02000984,7678,7677,1
2021,Bolton 002,E02000985,7417,7417,0
2021,Bolton 003,E02000986,8397,8358,39
2021,Bolton 004,E02000987,7300,7193,107
2021,Bolton 005,E02000988,9045,8940,105
2021,Bolton 006,E02000989,8350,8350,0
2021,Bolton 007,E02000990,8352,8345,7
2021,Bolton 008,E02000991,7811,7794,17
2021,Bolton 009,E02000992,6303,6264,39
2021,Bolton 010,E02000993,8434,8434,0
2021,Bolton 011,E02000994,9047,9047,0
2021,Bolton 012,E02000995,8347,8281,66
2021,Bolton 013,E02000996,8575,8427,148
2021,Bolton 014,E02000997,6478,6367,111
2021,Bolton 015,E02000998,10433,10367,66
2021,Bolton 016,E02000999,8530,8031,499
2021,Bolton 017,E02001000,9178,8989,189
2021,Bolton 018,E02001001,8860,8662,198
2021,Bolton 019,E02001002,9728,9728,0
2021,Bolton 020,E02001003,7352,7319,33
2021,Bolton 021,E02001004,9343,9342,1
2021,Bolton 022,E02001005,9845,9665,180
2021,Bolton 023,E02001006,8470,8435,35
2021,Bolton 024,E02001007,10065,10050,15
2021,Bolton 025,E02001008,9156,9079,77
2021,Bolton 026,E02001009,7481,7477,4
2021,Bolton 027,E02001010,6524,6468,56
2021,Bolton 028,E02001011,9747,9747,0
2021,Bolton 029,E02001012,9802,9798,4
2021,Bolton 030,E02001013,6106,6067,39
2021,Bolton 031,E02001014,8465,8425,40
2021,Bolton 032,E02001015,8204,8027,177
2021,Bolton 033,E02001016,8706,8705,1
2021,Bolton 034,E02001017,10773,10767,6
2021,Bolton 035,E02001018,7662,7662,0
2021,Bury 001,E02001019,9040,8857,183
2021,Bury 002,E02001020,5917,5892,25
2021,Bury 003,E02001021,7506,7352,154
2021,Bury 004,E02001022,8071,7905,166
2021,Bury 005,E02001023,5695,5682,13
2021,Bury 006,E02001024,8058,8005,53
2021,Bury 007,E02001025,8152,8073,79
2021,Bury 008,E02001026,11350,11269,81
2021,Bury 009,E02001027,7282,7112,170
2021,Bury 010,E02001028,7333,7295,38
2021,Bury 011,E02001029,7779,7709,70
2021,Bury 012,E02001030,6180,6156,24
2021,Bury 013,E02001031,6877,6875,2
2021,Bury 014,E02001032,7675,7588,87
2021,Bury 015,E02001033,6180,6176,4
2021,Bury 016,E02001034,8617,8542,75
2021,Bury 017,E02001035,7218,7218,0
2021,Bury 018,E02001036,7484,7482,2
2021,Bury 019,E02001037,7215,7111,104
2021,Bury 020,E02001038,5679,5666,13
2021,Bury 021,E02001039,8602,8602,0
2021,Bury 022,E02001040,6405,6193,212
2021,Bury 023,E02001041,7731,7661,70
2021,Bury 024,E02001042,6560,6538,22
2021,Bury 025,E02001043,5686,5551,135
2021,Bury 026,E02001044,9566,9533,33
2021,Manchester 001,E02001045,8434,8419,15
2021,Manchester 002,E02001046,11213,11155,58
2021,Manchester 003,E02001047,10475,10389,86
2021,Manchester 004,E02001048,9446,9389,57
2021,Manchester 005,E02001049,10496,10397,99
2021,Manchester 006,E02001050,8429,8268,161
2021,Manchester 007,E02001051,9269,9218,51
2021,Manchester 008,E02001052,15014,14885,129
2021,Manchester 009,E02001053,11908,11852,56
2021,Manchester 011,E02001055,9688,9434,254
2021,Manchester 012,E02001056,8935,8868,67
2021,Manchester 015,E02001059,11851,11741,110
2021,Manchester 017,E02001061,10961,10933,28
2021,Manchester 018,E02001062,10138,9241,897
2021,Manchester 019,E02001063,11072,7690,3382
2021,Manchester 020,E02001064,10779,10635,144
2021,Manchester 021,E02001065,9528,9467,61
2021,Manchester 022,E02001066,11567,9943,1624
2021,Manchester 023,E02001067,11550,11548,2
2021,Manchester 024,E02001068,11888,11878,10
2021,Manchester 025,E02001069,12493,11944,549
2021,Manchester 026,E02001070,11994,9130,2864
2021,Manchester 028,E02001072,8939,8809,130
2021,Manchester 029,E02001073,9363,9229,134
2021,Manchester 030,E02001074,11798,11528,270
2021,Manchester 031,E02001075,9135,9110,25
2021,Manchester 032,E02001076,11275,8951,2324
2021,Manchester 033,E02001077,7427,7426,1
2021,Manchester 034,E02001078,10689,10662,27
2021,Manchester 035,E02001079,9461,9434,27
2021,Manchester 036,E02001080,9729,9715,14
2021,Manchester 037,E02001081,6306,6306,0
2021,Manchester 038,E02001082,6673,6601,72
2021,Manchester 039,E02001083,8242,8168,74
2021,Manchester 040,E02001084,8604,8571,33
2021,Manchester 041,E02001085,8970,8970,0
2021,Manchester 042,E02001086,6882,6677,205
2021,Manchester 043,E02001087,9281,9247,34
2021,Manchester 044,E02001088,9124,9037,87
2021,Manchester 045,E02001089,8042,8030,12
2021,Manchester 046,E02001090,6981,6960,21
2021,Manchester 047,E02001091,8384,8378,6
2021,Manchester 048,E02001092,9230,9227,3
2021,Manchester 049,E02001093,9896,9711,185
2021,Manchester 050,E02001094,9989,9987,2
2021,Manchester 051,E02001095,9033,9003,30
2021,Manchester 052,E02001096,8022,8021,1
2021,Manchester 053,E02001097,8566,8499,67
2021,Manchester 054,E02006902,7882,7472,410
2021,Manchester 055,E02006912,10129,8230,1899
2021,Manchester 056,E02006913,7803,7755,48
2021,Manchester 057,E02006914,7859,3902,3957
2021,Manchester 058,E02006915,9362,8701,661
2021,Manchester 059,E02006916,6983,6976,7
2021,Manchester 060,E02006917,6428,6184,244
2021,Manchester 061,E02006983,7041,7026,15
2021,Manchester 062,E02006984,5653,5591,62
2021,Manchester 063,E02006985,9280,9263,17
2021,Manchester 064,E02006986,6356,6356,0
2021,Oldham 001,E02001098,5940,5938,2
2021,Oldham 002,E02001099,5678,5676,2
2021,Oldham 003,E02001100,6038,5903,135
2021,Oldham 004,E02001101,5674,5674,0
2021,Oldham 005,E02001102,6030,6030,0
2021,Oldham 006,E02001103,5502,5497,5
2021,Oldham 007,E02001104,7312,7243,69
2021,Oldham 008,E02001105,5953,5933,20
2021,Oldham 009,E02001106,6028,5952,76
2021,Oldham 010,E02001107,6923,6919,4
2021,Oldham 011,E02001108,5952,5880,72
2021,Oldham 012,E02001109,7750,7667,83
2021,Oldham 013,E02001110,6476,6421,55
2021,Oldham 014,E02001111,9134,9074,60
2021,Oldham 015,E02001112,5994,5992,2
2021,Oldham 016,E02001113,9434,9412,22
2021,Oldham 017,E02001114,8847,8762,85
2021,Oldham 018,E02001115,5990,5928,62
2021,Oldham 019,E02001116,7912,7872,40
2021,Oldham 020,E02001117,6000,5995,5
2021,Oldham 021,E02001118,6064,6046,18
2021,Oldham 022,E02001119,12317,12102,215
2021,Oldham 024,E02001121,8679,8644,35
2021,Oldham 026,E02001123,7059,7039,20
2021,Oldham 027,E02001124,6876,6876,0
2021,Oldham 028,E02001125,7918,7880,38
2021,Oldham 029,E02001126,9165,9125,40
2021,Oldham 030,E02001127,7755,7753,2
2021,Oldham 031,E02001128,7458,7448,10
2021,Oldham 032,E02001129,6787,6693,94
2021,Oldham 033,E02001130,5803,5784,19
2021,Oldham 034,E02001131,5458,5458,0
2021,Oldham 036,E02007000,7692,7599,93
2021,Oldham 037,E02007001,8486,8438,48
2021,Rochdale 001,E02001132,6628,6565,63
2021,Rochdale 002,E02001133,6605,6593,12
2021,Rochdale 003,E02001134,6325,6211,114
2021,Rochdale 004,E02001135,8403,8335,68
2021,Rochdale 005,E02001136,9545,9083,462
2021,Rochdale 006,E02001137,6201,6195,6
2021,Rochdale 007,E02001138,8647,8554,93
2021,Rochdale 008,E02001139,10362,10348,14
2021,Rochdale 009,E02001140,8149,8063,86
2021,Rochdale 010,E02001141,12014,11945,69
2021,Rochdale 011,E02001142,6016,5946,70
2021,Rochdale 012,E02001143,11640,11583,57
2021,Rochdale 013,E02001144,6338,6294,44
2021,Rochdale 014,E02001145,7040,7022,18
2021,Rochdale 015,E02001146,10296,10178,118
2021,Rochdale 016,E02001147,10402,10349,53
2021,Rochdale 017,E02001148,10458,10307,151
2021,Rochdale 018,E02001149,10321,10321,0
2021,Rochdale 019,E02001150,8981,8897,84
2021,Rochdale 020,E02001151,10103,10004,99
2021,Rochdale 021,E02001152,9776,9737,39
2021,Rochdale 022,E02001153,12281,12244,37
2021,Rochdale 023,E02001154,10132,10085,47
2021,Rochdale 024,E02001155,7210,7126,84
2021,Rochdale 025,E02001156,9903,9903,0
2021,Salford 001,E02001157,8704,8659,45
2021,Salford 002,E02001158,6061,6035,26
2021,Salford 003,E02001159,7494,7494,0
2021,Salford 004,E02001160,7272,7264,8
2021,Salford 005,E02001161,5844,5843,1
2021,Salford 006,E02001162,5820,5800,20
2021,Salford 007,E02001163,9918,9883,35
2021,Salford 008,E02001164,7676,6777,899
2021,Salford 009,E02001165,6171,6168,3
2021,Salford 010,E02001166,8245,8171,74
2021,Salford 011,E02001167,6969,6902,67
2021,Salford 012,E02001168,9894,9802,92
2021,Salford 013,E02001169,10908,10865,43
2021,Salford 014,E02001170,9853,9806,47
2021,Salford 015,E02001171,6159,6140,19
2021,Salford 017,E02001173,9504,8711,793
2021,Salford 018,E02001174,5722,5625,97
2021,Salford 019,E02001175,7502,7498,4
2021,Salford 020,E02001176,11752,11613,139
2021,Salford 021,E02001177,13344,13173,171
2021,Salford 023,E02001179,7017,6975,42
2021,Salford 024,E02001180,5686,5191,495
2021,Salford 025,E02001181,5976,5958,18
2021,Salford 026,E02001182,7353,7257,96
2021,Salford 027,E02001183,7329,7267,62
2021,Salford 029,E02001185,9698,9650,48
2021,Salford 030,E02001186,10557,10557,0
2021,Salford 031,E02006957,8279,8221,58
2021,Salford 032,E02006958,8074,7938,136
2021,Salford 033,E02006959,8024,7901,123
2021,Salford 034,E02006960,9327,7481,1846
2021,Salford 035,E02006961,6666,6487,179
2021,Salford 036,E02006962,5123,5123,0
2021,Salford 037,E02006963,6006,6004,2
2021,Stockport 001,E02001187,7004,7000,4
2021,Stockport 002,E02001188,8650,8647,3
2021,Stockport 003,E02001189,8298,8275,23
2021,Stockport 004,E02001190,7960,7780,180
2021,Stockport 005,E02001191,5741,5710,31
2021,Stockport 006,E02001192,6557,6455,102
2021,Stockport 007,E02001193,6410,6377,33
2021,Stockport 008,E02001194,6376,6340,36
2021,Stockport 009,E02001195,7553,7473,80
2021,Stockport 010,E02001196,7831,7751,80
2021,Stockport 011,E02001197,6278,6273,5
2021,Stockport 012,E02001198,7522,7405,117
2021,Stockport 013,E02001199,7905,7901,4
2021,Stockport 014,E02001200,7889,7798,91
2021,Stockport 015,E02001201,5787,5773,14
2021,Stockport 016,E02001202,6456,6419,37
2021,Stockport 017,E02001203,5861,5848,13
2021,Stockport 018,E02001204,8923,8856,67
2021,Stockport 019,E02001205,8430,8416,14
2021,Stockport 020,E02001206,7269,7161,108
2021,Stockport 021,E02001207,6849,6827,22
2021,Stockport 022,E02001208,7570,7499,71
2021,Stockport 023,E02001209,7769,7708,61
2021,Stockport 024,E02001210,7438,7385,53
2021,Stockport 025,E02001211,6667,6593,74
2021,Stockport 026,E02001212,6989,6926,63
2021,Stockport 027,E02001213,9918,9783,135
2021,Stockport 028,E02001214,8020,7999,21
2021,Stockport 029,E02001215,5973,5903,70
2021,Stockport 030,E02001216,7841,7841,0
2021,Stockport 031,E02001217,6756,6704,52
2021,Stockport 032,E02001218,6022,5949,73
2021,Stockport 033,E02001219,5284,5278,6
2021,Stockport 034,E02001220,5675,5675,0
2021,Stockport 035,E02001221,5866,5813,53
2021,Stockport 036,E02001222,6478,6401,77
2021,Stockport 037,E02001223,6667,6596,71
2021,Stockport 038,E02001224,5785,5697,88
2021,Stockport 039,E02001225,7377,7373,4
2021,Stockport 040,E02001226,7180,7108,72
2021,Stockport 041,E02001227,5690,5674,16
2021,Stockport 042,E02001228,6260,6167,93
2021,Tameside 001,E02001229,10311,10241,70
2021,Tameside 002,E02001230,5871,5871,0
2021,Tameside 003,E02001231,7101,7101,0
2021,Tameside 004,E02001232,8694,8621,73
2021,Tameside 005,E02001233,7992,7887,105
2021,Tameside 006,E02001234,7944,7852,92
2021,Tameside 007,E02001235,7215,7159,56
2021,Tameside 008,E02001236,6113,6022,91
2021,Tameside 009,E02001237,7218,7146,72
2021,Tameside 010,E02001238,7993,7986,7
2021,Tameside 011,E02001239,9538,9504,34
2021,Tameside 012,E02001240,6383,6383,0
2021,Tameside 013,E02001241,11205,11174,31
2021,Tameside 014,E02001242,7055,7002,53
2021,Tameside 015,E02001243,8236,8224,12
2021,Tameside 016,E02001244,5409,5409,0
2021,Tameside 017,E02001245,8042,7951,91
2021,Tameside 018,E02001246,7438,7310,128
2021,Tameside 019,E02001247,7419,7369,50
2021,Tameside 020,E02001248,11983,11981,2
2021,Tameside 021,E02001249,6371,6371,0
2021,Tameside 022,E02001250,6478,6433,45
2021,Tameside 023,E02001251,6095,6066,29
2021,Tameside 024,E02001252,7540,7540,0
2021,Tameside 025,E02001253,5015,4982,33
2021,Tameside 026,E02001254,5634,5621,13
2021,Tameside 027,E02001255,7681,7679,2
2021,Tameside 028,E02001256,10543,10359,184
2021,Tameside 029,E02001257,9119,9068,51
2021,Tameside 030,E02001258,7437,7374,63
2021,Trafford 001,E02001259,11723,11656,67
2021,Trafford 002,E02001260,7581,7569,12
2021,Trafford 003,E02001261,8878,8874,4
2021,Trafford 004,E02001262,8672,8649,23
2021,Trafford 005,E02001263,8393,8282,111
2021,Trafford 006,E02001264,8655,8655,0
2021,Trafford 007,E02001265,8193,8146,47
2021,Trafford 008,E02001266,6924,6907,17
2021,Trafford 009,E02001267,7247,7122,125
2021,Trafford 010,E02001268,7040,6954,86
2021,Trafford 011,E02001269,8356,8346,10
2021,Trafford 012,E02001270,8550,8454,96
2021,Trafford 013,E02001271,6644,6644,0
2021,Trafford 014,E02001272,8024,7992,32
2021,Trafford 015,E02001273,9535,9453,82
2021,Trafford 016,E02001274,8058,7937,121
2021,Trafford 017,E02001275,8189,8116,73
2021,Trafford 018,E02001276,8116,8105,11
2021,Trafford 019,E02001277,9350,9341,9
2021,Trafford 020,E02001278,8694,8625,69
2021,Trafford 021,E02001279,8286,8253,33
2021,Trafford 022,E02001280,8401,8341,60
2021,Trafford 023,E02001281,7738,7737,1
2021,Trafford 024,E02001282,10105,10060,45
2021,Trafford 025,E02001283,9514,9441,73
2021,Trafford 026,E02001284,8153,8153,0
2021,Trafford 027,E02001285,7756,7644,112
2021,Trafford 028,E02001286,8278,8214,64
2021,Wigan 001,E02001287,6630,6630,0
2021,Wigan 002,E02001288,8334,8285,49
2021,Wigan 003,E02001289,10174,10174,0
2021,Wigan 004,E02001290,6129,6078,51
2021,Wigan 005,E02001291,7815,7809,6
2021,Wigan 006,E02001292,8030,7994,36
2021,Wigan 007,E02001293,6257,6214,43
2021,Wigan 008,E02001294,7998,7913,85
2021,Wigan 009,E02001295,7232,7128,104
2021,Wigan 010,E02001296,9049,8964,85
2021,Wigan 011,E02001297,6605,6552,53
2021,Wigan 012,E02001298,8122,8087,35
2021,Wigan 013,E02001299,8690,8611,79
2021,Wigan 014,E02001300,7888,7793,95
2021,Wigan 015,E02001301,9029,8885,144
2021,Wigan 016,E02001302,7986,7895,91
2021,Wigan 017,E02001303,9028,8974,54
2021,Wigan 018,E02001304,12764,12763,1
2021,Wigan 019,E02001305,8521,8492,29
2021,Wigan 020,E02001306,7149,7149,0
2021,Wigan 021,E02001307,11653,11653,0
2021,Wigan 022,E02001308,5970,5912,58
2021,Wigan 023,E02001309,8354,8261,93
2021,Wigan 024,E02001310,9227,9151,76
2021,Wigan 025,E02001311,8192,8192,0
2021,Wigan 026,E02001312,8687,8184,503
2021,Wigan 027,E02001313,8167,8090,77
2021,Wigan 028,E02001314,8008,8008,0
2021,Wigan 029,E02001315,9440,9440,0
2021,Wigan 030,E02001316,7358,7321,37
2021,Wigan 031,E02001317,9005,8806,199
2021,Wigan 032,E02001318,7830,7830,0
2021,Wigan 033,E02001319,8321,8200,121
2021,Wigan 034,E02001320,7386,7362,24
2021,Wigan 035,E02001321,8005,7955,50
2021,Wigan 036,E02001322,7206,7086,120
2021,Wigan 037,E02001323,7705,7705,0
2021,Wigan 038,E02001324,8267,8234,33
2021,Wigan 039,E02001325,8956,8907,49
2021,Wigan 040,E02001326,8163,8163,0
2021,Birmingham 001,E02001827,6451,6408,43
2021,Birmingham 002,E02001828,7142,7104,38
2021,Birmingham 003,E02001829,9160,9160,0
2021,Birmingham 004,E02001830,9686,9589,97
2021,Birmingham 005,E02001831,10683,10647,36
2021,Birmingham 006,E02001832,7931,7922,9
2021,Birmingham 007,E02001833,5936,5936,0
2021,Birmingham 008,E02001834,6110,6110,0
2021,Birmingham 009,E02001835,8473,8219,254
2021,Birmingham 010,E02001836,9102,9026,76
2021,Birmingham 011,E02001837,10667,10642,25
2021,Birmingham 012,E02001838,7570,7497,73
2021,Birmingham 013,E02001839,6439,6409,30
2021,Birmingham 014,E02001840,9603,9514,89
2021,Birmingham 015,E02001841,5963,5852,111
2021,Birmingham 016,E02001842,8069,8068,1
2021,Birmingham 017,E02001843,6638,6630,8
2021,Birmingham 018,E02001844,9715,9362,353
2021,Birmingham 019,E02001845,6662,6662,0
2021,Birmingham 020,E02001846,8159,8117,42
2021,Birmingham 021,E02001847,5596,5586,10
2021,Birmingham 022,E02001848,7320,7181,139
2021,Birmingham 023,E02001849,8792,8774,18
2021,Birmingham 024,E02001850,8605,8587,18
2021,Birmingham 025,E02001851,9083,9001,82
2021,Birmingham 026,E02001852,7030,7000,30
2021,Birmingham 029,E02001855,9935,9812,123
2021,Birmingham 030,E02001856,9638,9585,53
2021,Birmingham 031,E02001857,13854,13440,414
2021,Birmingham 032,E02001858,9148,8329,819
2021,Birmingham 033,E02001859,10398,10296,102
2021,Birmingham 034,E02001860,8471,8468,3
2021,Birmingham 035,E02001861,11204,11160,44
2021,Birmingham 036,E02001862,9877,9791,86
2021,Birmingham 037,E02001863,8404,8315,89
2021,Birmingham 039,E02001865,11402,11396,6
2021,Birmingham 040,E02001866,9451,9359,92
2021,Birmingham 041,E02001867,8671,8639,32
2021,Birmingham 042,E02001868,9818,9816,2
2021,Birmingham 043,E02001869,7010,7007,3
2021,Birmingham 044,E02001870,12993,12880,113
2021,Birmingham 045,E02001871,8341,8285,56
2021,Birmingham 046,E02001872,7423,7377,46
2021,Birmingham 047,E02001873,11386,11228,158
2021,Birmingham 048,E02001874,9962,9935,27
2021,Birmingham 049,E02001875,8961,8937,24
2021,Birmingham 050,E02001876,16085,8823,7262
2021,Birmingham 051,E02001877,12396,12296,100
2021,Birmingham 052,E02001878,9522,9459,63
2021,Birmingham 053,E02001879,10025,9396,629
2021,Birmingham 054,E02001880,10037,10030,7
2021,Birmingham 055,E02001881,10495,10455,40
2021,Birmingham 056,E02001882,8913,8835,78
2021,Birmingham 057,E02001883,8517,8517,0
2021,Birmingham 058,E02001884,10188,10151,37
2021,Birmingham 060,E02001886,9892,9614,278
2021,Birmingham 062,E02001888,7181,7110,71
2021,Birmingham 063,E02001889,9053,8838,215
2021,Birmingham 064,E02001890,9976,9350,626
2021,Birmingham 066,E02001892,11587,11564,23
2021,Birmingham 067,E02001893,8822,8750,72
2021,Birmingham 069,E02001895,8955,8839,116
2021,Birmingham 070,E02001896,10160,10160,0
2021,Birmingham 071,E02001897,8624,8428,196
2021,Birmingham 072,E02001898,6558,6557,1
2021,Birmingham 073,E02001899,8534,8483,51
2021,Birmingham 074,E02001900,6710,6437,273
2021,Birmingham 075,E02001901,8142,8054,88
2021,Birmingham 076,E02001902,6255,6248,7
2021,Birmingham 077,E02001903,8076,8069,7
2021,Birmingham 078,E02001904,7725,7618,107
2021,Birmingham 079,E02001905,10274,6185,4089
2021,Birmingham 080,E02001906,9569,9563,6
2021,Birmingham 081,E02001907,10413,10380,33
2021,Birmingham 082,E02001908,8953,8941,12
2021,Birmingham 083,E02001909,8290,8253,37
2021,Birmingham 084,E02001910,7232,7229,3
2021,Birmingham 085,E02001911,8738,8731,7
2021,Birmingham 087,E02001913,7442,7151,291
2021,Birmingham 088,E02001914,7060,6879,181
2021,Birmingham 089,E02001915,11959,11796,163
2021,Birmingham 090,E02001916,9897,9786,111
2021,Birmingham 092,E02001918,8651,8334,317
2021,Birmingham 093,E02001919,6940,6802,138
2021,Birmingham 094,E02001920,7654,7645,9
2021,Birmingham 095,E02001921,7739,7732,7
2021,Birmingham 096,E02001922,15987,13523,2464
2021,Birmingham 097,E02001923,11118,11025,93
2021,Birmingham 098,E02001924,7077,7068,9
2021,Birmingham 099,E02001925,6736,6615,121
2021,Birmingham 100,E02001926,7828,7477,351
2021,Birmingham 101,E02001927,7669,7549,120
2021,Birmingham 102,E02001928,6818,6752,66
2021,Birmingham 103,E02001929,10507,10446,61
2021,Birmingham 104,E02001930,7703,7703,0
2021,Birmingham 105,E02001931,8591,8591,0
2021,Birmingham 106,E02001932,7425,7315,110
2021,Birmingham 107,E02001933,7719,7651,68
2021,Birmingham 108,E02001934,7144,7115,29
2021,Birmingham 109,E02001935,8080,8045,35
2021,Birmingham 110,E02001936,6387,6342,45
2021,Birmingham 111,E02001937,8384,8337,47
2021,Birmingham 112,E02001938,7870,7768,102
2021,Birmingham 113,E02001939,6294,6210,84
2021,Birmingham 115,E02001941,6550,6451,99
2021,Birmingham 116,E02001942,6780,6693,87
2021,Birmingham 117,E02001943,6475,6438,37
2021,Birmingham 118,E02001944,8068,7996,72
2021,Birmingham 119,E02001945,7894,7883,11
2021,Birmingham 120,E02001946,7583,7500,83
2021,Birmingham 121,E02001947,6240,6188,52
2021,Birmingham 122,E02001948,7346,7270,76
2021,Birmingham 123,E02001949,6161,6089,72
2021,Birmingham 124,E02001950,8569,8541,28
2021,Birmingham 125,E02001951,9433,9394,39
2021,Birmingham 126,E02001952,9128,9117,11
2021,Birmingham 127,E02001953,7112,6973,139
2021,Birmingham 128,E02001954,7581,7563,18
2021,Birmingham 129,E02001955,8096,8007,89
2021,Birmingham 130,E02001956,6848,6779,69
2021,Birmingham 131,E02001957,7880,7815,65
2021,Birmingham 132,E02006807,8210,8190,20
2021,Birmingham 133,E02006809,10153,10029,124
2021,Birmingham 134,E02006895,9361,8391,970
2021,Birmingham 135,E02006896,6124,5605,519
2021,Birmingham 136,E02006897,8455,7710,745
2021,Birmingham 137,E02006898,7904,7902,2
2021,Birmingham 138,E02006899,6145,6128,17
2021,Birmingham 139,E02006900,15720,15639,81
2021,Birmingham 141,E02007038,13692,13628,64
2021,Birmingham 142,E02007039,8307,8300,7
2021,Birmingham 143,E02007040,7599,7557,42
2021,Coventry 001,E02001958,8072,8053,19
2021,Coventry 002,E02001959,6929,6902,27
2021,Coventry 004,E02001961,7966,7964,2
2021,Coventry 005,E02001962,7211,7170,41
2021,Coventry 006,E02001963,6141,6138,3
2021,Coventry 007,E02001964,11009,10981,28
2021,Coventry 008,E02001965,8080,8055,25
2021,Coventry 009,E02001966,7355,7331,24
2021,Coventry 010,E02001967,6962,6823,139
2021,Coventry 011,E02001968,7959,7959,0
2021,Coventry 012,E02001969,6775,6665,110
2021,Coventry 013,E02001970,5758,5732,26
2021,Coventry 014,E02001971,6289,6289,0
2021,Coventry 015,E02001972,11719,11643,76
2021,Coventry 016,E02001973,8535,8535,0
2021,Coventry 017,E02001974,9461,9432,29
2021,Coventry 018,E02001975,7637,7634,3
2021,Coventry 019,E02001976,7499,7407,92
2021,Coventry 020,E02001977,10015,9807,208
2021,Coventry 021,E02001978,6810,6790,20
2021,Coventry 022,E02001979,5604,5564,40
2021,Coventry 023,E02001980,5792,5768,24
2021,Coventry 024,E02001981,13439,11877,1562
2021,Coventry 025,E02001982,8407,8317,90
2021,Coventry 026,E02001983,7611,7529,82
2021,Coventry 027,E02001984,10467,10373,94
2021,Coventry 028,E02001985,9241,8232,1009
2021,Coventry 029,E02001986,7981,7883,98
2021,Coventry 030,E02001987,5911,5910,1
2021,Coventry 031,E02001988,11152,6417,4735
2021,Coventry 032,E02001989,6294,6216,78
2021,Coventry 033,E02001990,9185,9090,95
2021,Coventry 034,E02001991,8476,8316,160
2021,Coventry 035,E02001992,10784,10754,30
2021,Coventry 036,E02001993,8985,8595,390
2021,Coventry 037,E02001994,7960,7954,6
2021,Coventry 038,E02001995,9426,9327,99
2021,Coventry 039,E02001996,7688,7667,21
2021,Coventry 040,E02001997,8511,8511,0
2021,Coventry 041,E02001998,6036,6036,0
2021,Coventry 042,E02001999,9105,5904,3201
2021,Coventry 043,E02006805,9083,9055,28
2021,Dudley 001,E02002000,8550,8517,33
2021,Dudley 002,E02002001,6064,6064,0
2021,Dudley 003,E02002002,6901,6845,56
2021,Dudley 004,E02002003,9020,8949,71
2021,Dudley 005,E02002004,7578,7549,29
2021,Dudley 006,E02002005,9889,9833,56
2021,Dudley 007,E02002006,6481,6481,0
2021,Dudley 008,E02002007,9028,9021,7
2021,Dudley 009,E02002008,8164,8054,110
2021,Dudley 010,E02002009,7117,7117,0
2021,Dudley 011,E02002010,8373,8253,120
2021,Dudley 012,E02002011,5904,5859,45
2021,Dudley 013,E02002012,8413,8275,138
2021,Dudley 014,E02002013,6571,6464,107
2021,Dudley 015,E02002014,8312,8262,50
2021,Dudley 016,E02002015,7059,7034,25
2021,Dudley 017,E02002016,8047,7982,65
2021,Dudley 018,E02002017,8071,8001,70
2021,Dudley 019,E02002018,8931,8874,57
2021,Dudley 020,E02002019,7798,7798,0
2021,Dudley 021,E02002020,9485,9400,85
2021,Dudley 022,E02002021,7712,7632,80
2021,Dudley 023,E02002022,8881,8830,51
2021,Dudley 024,E02002023,5358,5358,0
2021,Dudley 025,E02002024,8738,8708,30
2021,Dudley 026,E02002025,8896,8872,24
2021,Dudley 027,E02002026,6783,6783,0
2021,Dudley 028,E02002027,5379,5377,2
2021,Dudley 029,E02002028,5732,5694,38
2021,Dudley 030,E02002029,6224,6181,43
2021,Dudley 031,E02002030,6814,6781,33
2021,Dudley 032,E02002031,6261,6242,19
2021,Dudley 033,E02002032,10213,10186,27
2021,Dudley 034,E02002033,7815,7805,10
2021,Dudley 035,E02002034,8168,8147,21
2021,Dudley 036,E02002035,6115,6064,51
2021,Dudley 037,E02002036,6670,6670,0
2021,Dudley 038,E02002037,5923,5923,0
2021,Dudley 039,E02002038,9617,9579,38
2021,Dudley 040,E02002039,6207,5909,298
2021,Dudley 041,E02002040,5933,5907,26
2021,Dudley 042,E02002041,6272,6231,41
2021,Dudley 043,E02002042,8028,7994,34
2021,Sandwell 001,E02002043,8757,8603,154
2021,Sandwell 002,E02002044,8052,8052,0
2021,Sandwell 003,E02002045,7812,7812,0
2021,Sandwell 004,E02002046,5714,5714,0
2021,Sandwell 005,E02002047,7553,7388,165
2021,Sandwell 006,E02002048,6829,6827,2
2021,Sandwell 007,E02002049,6309,6309,0
2021,Sandwell 009,E02002051,6169,6139,30
2021,Sandwell 010,E02002052,11365,11201,164
2021,Sandwell 011,E02002053,6327,6316,11
2021,Sandwell 012,E02002054,5818,5809,9
2021,Sandwell 013,E02002055,11126,11120,6
2021,Sandwell 014,E02002056,9881,9826,55
2021,Sandwell 015,E02002057,10722,10645,77
2021,Sandwell 016,E02002058,13570,13417,153
2021,Sandwell 017,E02002059,11792,11684,108
2021,Sandwell 018,E02002060,7356,7319,37
2021,Sandwell 019,E02002061,7059,6993,66
2021,Sandwell 020,E02002062,8958,8834,124
2021,Sandwell 021,E02002063,10330,10290,40
2021,Sandwell 022,E02002064,12496,12425,71
2021,Sandwell 023,E02002065,14169,14068,101
2021,Sandwell 024,E02002066,8258,8229,29
2021,Sandwell 025,E02002067,6321,6288,33
2021,Sandwell 027,E02002069,7244,7244,0
2021,Sandwell 028,E02002070,10338,10192,146
2021,Sandwell 029,E02002071,6717,6717,0
2021,Sandwell 030,E02002072,8921,8860,61
2021,Sandwell 031,E02002073,8411,8353,58
2021,Sandwell 032,E02002074,8206,8159,47
2021,Sandwell 033,E02002075,8736,8655,81
2021,Sandwell 034,E02002076,10670,10653,17
2021,Sandwell 035,E02002077,10884,10829,55
2021,Sandwell 036,E02002078,6570,6566,4
2021,Sandwell 037,E02002079,8659,8654,5
2021,Sandwell 038,E02002080,7378,7319,59
2021,Sandwell 039,E02006810,10690,10667,23
2021,Sandwell 040,E02006943,7596,7545,51
2021,Sandwell 041,E02006944,8075,8075,0
2021,Solihull 001,E02002081,5434,5413,21
2021,Solihull 002,E02002082,5840,5837,3
2021,Solihull 003,E02002083,6029,6026,3
2021,Solihull 004,E02002084,6746,6725,21
2021,Solihull 005,E02002085,6659,6659,0
2021,Solihull 006,E02002086,5923,5862,61
2021,Solihull 007,E02002087,6297,6296,1
2021,Solihull 008,E02002088,9583,9517,66
2021,Solihull 009,E02002089,8066,7901,165
2021,Solihull 010,E02002090,5962,5962,0
2021,Solihull 011,E02002091,7654,7654,0
2021,Solihull 012,E02002092,7268,7223,45
2021,Solihull 013,E02002093,6691,6584,107
2021,Solihull 014,E02002094,5980,5911,69
2021,Solihull 015,E02002095,8625,8589,36
2021,Solihull 016,E02002096,10375,10254,121
2021,Solihull 017,E02002097,7343,7308,35
2021,Solihull 018,E02002098,9737,9720,17
2021,Solihull 019,E02002099,6900,6841,59
2021,Solihull 021,E02002101,6307,6290,17
2021,Solihull 022,E02002102,8776,8663,113
2021,Solihull 023,E02002103,6082,6025,57
2021,Solihull 024,E02002104,5847,5805,42
2021,Solihull 025,E02002105,8265,8214,51
2021,Solihull 026,E02002106,9730,9603,127
2021,Solihull 027,E02002107,5413,5400,13
2021,Solihull 028,E02002108,9846,9831,15
2021,Solihull 029,E02002109,12134,12126,8
2021,Solihull 030,E02006808,6732,6732,0
2021,Walsall 001,E02002110,7024,6977,47
2021,Walsall 002,E02002111,6417,6377,40
2021,Walsall 003,E02002112,5270,5261,9
2021,Walsall 004,E02002113,6402,6349,53
2021,Walsall 005,E02002114,6082,6046,36
2021,Walsall 006,E02002115,6823,6799,24
2021,Walsall 007,E02002116,6755,6719,36
2021,Walsall 008,E02002117,6254,6227,27
2021,Walsall 009,E02002118,7420,7420,0
2021,Walsall 010,E02002119,5983,5983,0
2021,Walsall 011,E02002120,6110,6110,0
2021,Walsall 012,E02002121,6663,6513,150
2021,Walsall 013,E02002122,7155,7142,13
2021,Walsall 014,E02002123,6602,6568,34
2021,Walsall 015,E02002124,6920,6806,114
2021,Walsall 016,E02002125,6450,6396,54
2021,Walsall 017,E02002126,6679,6679,0
2021,Walsall 018,E02002127,9792,9688,104
2021,Walsall 019,E02002128,5625,5571,54
2021,Walsall 020,E02002129,6032,6027,5
2021,Walsall 021,E02002130,6863,6852,11
2021,Walsall 022,E02002131,7778,7778,0
2021,Walsall 023,E02002132,6441,6402,39
2021,Walsall 024,E02002133,6901,6855,46
2021,Walsall 025,E02002134,9235,9148,87
2021,Walsall 026,E02002135,7981,7956,25
2021,Walsall 027,E02002136,8004,7997,7
2021,Walsall 028,E02002137,6115,6088,27
2021,Walsall 029,E02002138,6358,6356,2
2021,Walsall 030,E02002139,10861,10443,418
2021,Walsall 031,E02002140,8555,8453,102
2021,Walsall 032,E02002141,6459,6459,0
2021,Walsall 033,E02002142,7550,7485,65
2021,Walsall 034,E02002143,10264,10245,19
2021,Walsall 035,E02002144,6845,6836,9
2021,Walsall 036,E02002145,8492,8490,2
2021,Walsall 037,E02002146,6425,6388,37
2021,Walsall 038,E02002147,9109,9074,35
2021,Walsall 039,E02002148,11431,11431,0
2021,Wolverhampton 001,E02002149,10087,10052,35
2021,Wolverhampton 002,E02002150,5791,5733,58
2021,Wolverhampton 003,E02002151,5556,5556,0
2021,Wolverhampton 004,E02002152,6273,6161,112
2021,Wolverhampton 005,E02002153,7483,7480,3
2021,Wolverhampton 006,E02002154,7412,7387,25
2021,Wolverhampton 007,E02002155,6515,6485,30
2021,Wolverhampton 008,E02002156,8302,8292,10
2021,Wolverhampton 009,E02002157,7825,7799,26
2021,Wolverhampton 010,E02002158,7523,7463,60
2021,Wolverhampton 011,E02002159,6178,6176,2
2021,Wolverhampton 012,E02002160,7579,7511,68
2021,Wolverhampton 013,E02002161,7124,7124,0
2021,Wolverhampton 014,E02002162,7773,7589,184
2021,Wolverhampton 015,E02002163,11875,11818,57
2021,Wolverhampton 016,E02002164,6743,6123,620
2021,Wolverhampton 017,E02002165,7893,7734,159
2021,Wolverhampton 018,E02002166,9408,9365,43
2021,Wolverhampton 019,E02002167,6642,6642,0
2021,Wolverhampton 020,E02002168,11532,10639,893
2021,Wolverhampton 021,E02002169,8808,8676,132
2021,Wolverhampton 022,E02002170,6313,6313,0
2021,Wolverhampton 023,E02002171,7725,7724,1
2021,Wolverhampton 026,E02002174,7643,7539,104
2021,Wolverhampton 027,E02002175,7793,7724,69
2021,Wolverhampton 028,E02002176,7841,7841,0
2021,Wolverhampton 029,E02002177,11505,11427,78
2021,Wolverhampton 030,E02002178,8141,7929,212
2021,Wolverhampton 031,E02002179,6568,6512,56
2021,Wolverhampton 032,E02002180,6488,6460,28
2021,Wolverhampton 033,E02002181,8435,8435,0
2021,Wolverhampton 034,E02002182,6586,6458,128
2021,Wolverhampton 035,E02006894,14363,14152,211
