date,geography,geography code,Residence type: Total; measures: Value,Residence type: Lives in a household; measures: Value,Residence type: Lives in a communal establishment; measures: Value
2021,Bolton 001A,E01004768,1593,1593,0
2021,Bolton 001B,E01004803,1620,1620,0
2021,Bolton 001C,E01004804,1468,1467,1
2021,Bolton 001D,E01004807,1377,1377,0
2021,Bolton 001E,E01004808,1618,1618,0
2021,Bolton 002A,E01004788,1359,1359,0
2021,Bolton 002B,E01004790,1418,1418,0
2021,Bolton 002C,E01004805,1566,1566,0
2021,Bolton 002D,E01004806,1517,1517,0
2021,Bolton 002E,E01004810,1557,1557,0
2021,Bolton 003A,E01004769,1503,1503,0
2021,Bolton 003B,E01004770,1521,1521,0
2021,Bolton 003C,E01004771,1685,1685,0
2021,Bolton 003D,E01004773,1965,1928,37
2021,Bolton 003E,E01004809,1723,1721,2
2021,Bolton 004A,E01004777,1723,1675,48
2021,Bolton 004B,E01004881,1482,1424,58
2021,Bolton 004C,E01004888,1281,1281,0
2021,Bolton 004D,E01004889,1432,1431,1
2021,Bolton 004E,E01004890,1381,1381,0
2021,Bolton 005A,E01004766,1658,1658,0
2021,Bolton 005B,E01004767,1890,1861,29
2021,Bolton 005C,E01004772,1846,1846,0
2021,Bolton 005D,E01004774,1765,1738,27
2021,Bolton 005E,E01004824,1884,1835,49
2021,Bolton 006A,E01004784,1194,1194,0
2021,Bolton 006B,E01004785,1523,1523,0
2021,Bolton 006C,E01004786,1450,1450,0
2021,Bolton 006D,E01004789,1453,1453,0
2021,Bolton 006E,E01004791,1323,1323,0
2021,Bolton 006F,E01004792,1409,1409,0
2021,Bolton 007A,E01004779,1632,1626,6
2021,Bolton 007B,E01004781,2133,2132,1
2021,Bolton 007C,E01004882,1349,1349,0
2021,Bolton 007D,E01004883,1760,1760,0
2021,Bolton 007E,E01004884,1476,1476,0
2021,Bolton 008A,E01004864,1464,1464,0
2021,Bolton 008B,E01004867,1551,1551,0
2021,Bolton 008C,E01004921,1633,1632,1
2021,Bolton 008D,E01004924,1571,1571,0
2021,Bolton 008E,E01004925,1592,1576,16
2021,Bolton 009A,E01004778,1190,1169,21
2021,Bolton 009B,E01004780,2288,2270,18
2021,Bolton 009C,E01004782,1348,1348,0
2021,Bolton 009D,E01004783,1477,1477,0
2021,Bolton 010A,E01004802,1973,1973,0
2021,Bolton 010B,E01004926,1432,1432,0
2021,Bolton 010C,E01004927,2301,2301,0
2021,Bolton 010D,E01004929,2728,2728,0
2021,Bolton 011A,E01004820,1790,1790,0
2021,Bolton 011B,E01004825,1971,1971,0
2021,Bolton 011C,E01004826,1667,1667,0
2021,Bolton 011D,E01004865,1581,1581,0
2021,Bolton 011E,E01004866,2038,2038,0
2021,Bolton 012A,E01004840,1736,1703,33
2021,Bolton 012B,E01004841,1746,1746,0
2021,Bolton 012C,E01004842,1713,1713,0
2021,Bolton 012D,E01004919,1509,1501,8
2021,Bolton 012E,E01004920,1642,1617,25
2021,Bolton 013A,E01004787,1708,1708,0
2021,Bolton 013B,E01004793,1747,1673,74
2021,Bolton 013C,E01004794,2122,2110,12
2021,Bolton 013D,E01004795,1504,1444,60
2021,Bolton 013E,E01004797,1492,1492,0
2021,Bolton 014A,E01004775,2326,2246,80
2021,Bolton 014B,E01004885,1425,1425,0
2021,Bolton 014C,E01004886,1397,1369,28
2021,Bolton 014D,E01004887,1329,1327,2
2021,Bolton 015A,E01004868,2163,2163,0
2021,Bolton 015B,E01004869,2188,2188,0
2021,Bolton 015C,E01004870,2015,1949,66
2021,Bolton 015D,E01004871,1815,1815,0
2021,Bolton 015E,E01004922,2254,2254,0
2021,Bolton 016B,E01004822,1851,1827,24
2021,Bolton 016C,E01004823,2047,2022,25
2021,Bolton 016D,E01004848,2090,1695,395
2021,Bolton 016E,E01033217,1227,1174,53
2021,Bolton 016F,E01033220,1314,1312,2
2021,Bolton 017A,E01004818,1722,1596,126
2021,Bolton 017B,E01004819,1518,1458,60
2021,Bolton 017C,E01004928,1378,1375,3
2021,Bolton 017D,E01004930,1514,1514,0
2021,Bolton 017E,E01004931,1564,1564,0
2021,Bolton 017F,E01004932,1482,1482,0
2021,Bolton 018A,E01004834,1745,1645,100
2021,Bolton 018B,E01004838,2010,1946,64
2021,Bolton 018C,E01004843,1558,1537,21
2021,Bolton 018D,E01004845,1872,1867,5
2021,Bolton 018E,E01004923,1675,1667,8
2021,Bolton 019A,E01004796,1576,1576,0
2021,Bolton 019B,E01004798,1613,1613,0
2021,Bolton 019C,E01004799,1273,1273,0
2021,Bolton 019D,E01004800,1294,1294,0
2021,Bolton 019E,E01004801,1674,1674,0
2021,Bolton 019F,E01004917,2298,2298,0
2021,Bolton 020A,E01004835,1461,1461,0
2021,Bolton 020B,E01004836,1744,1711,33
2021,Bolton 020C,E01004837,1561,1561,0
2021,Bolton 020D,E01004844,1573,1573,0
2021,Bolton 020E,E01004897,1013,1013,0
2021,Bolton 021A,E01004827,1990,1989,1
2021,Bolton 021B,E01004849,1794,1794,0
2021,Bolton 021C,E01004850,2293,2293,0
2021,Bolton 021D,E01004851,1691,1691,0
2021,Bolton 021E,E01004853,1575,1575,0
2021,Bolton 022A,E01004811,1845,1843,2
2021,Bolton 022B,E01004812,2402,2387,15
2021,Bolton 022C,E01004813,1746,1676,70
2021,Bolton 022D,E01004815,1786,1786,0
2021,Bolton 022E,E01004817,2064,1971,93
2021,Bolton 023A,E01004828,2017,2017,0
2021,Bolton 023B,E01004829,1458,1450,8
2021,Bolton 023C,E01004832,1641,1641,0
2021,Bolton 023D,E01004854,1658,1630,28
2021,Bolton 023E,E01004878,1697,1697,0
2021,Bolton 024A,E01004911,1539,1539,0
2021,Bolton 024B,E01004912,1435,1435,0
2021,Bolton 024C,E01004913,1955,1955,0
2021,Bolton 024D,E01004914,1170,1170,0
2021,Bolton 024E,E01004915,1274,1259,15
2021,Bolton 024F,E01004916,1467,1467,0
2021,Bolton 024G,E01004918,1225,1225,0
2021,Bolton 025A,E01004846,1410,1404,6
2021,Bolton 025B,E01004847,2282,2212,70
2021,Bolton 025C,E01004852,1732,1732,0
2021,Bolton 025D,E01004877,2074,2074,0
2021,Bolton 025E,E01004879,1657,1657,0
2021,Bolton 026A,E01004830,1754,1754,0
2021,Bolton 026B,E01004831,1827,1827,0
2021,Bolton 026C,E01004833,1530,1530,0
2021,Bolton 026D,E01004839,2370,2366,4
2021,Bolton 027A,E01004814,1604,1604,0
2021,Bolton 027B,E01004855,1481,1481,0
2021,Bolton 027C,E01004856,1537,1537,0
2021,Bolton 027D,E01004857,1902,1846,56
2021,Bolton 028A,E01004891,1540,1540,0
2021,Bolton 028B,E01004893,1525,1525,0
2021,Bolton 028C,E01004894,1925,1925,0
2021,Bolton 028E,E01004901,1764,1764,0
2021,Bolton 028F,E01033218,1574,1574,0
2021,Bolton 028G,E01033219,1421,1421,0
2021,Bolton 029A,E01004816,2939,2939,0
2021,Bolton 029B,E01004872,1694,1690,4
2021,Bolton 029C,E01004873,2021,2021,0
2021,Bolton 029D,E01004875,1669,1669,0
2021,Bolton 029E,E01004880,1479,1479,0
2021,Bolton 030A,E01004892,1580,1580,0
2021,Bolton 030B,E01004896,1315,1279,36
2021,Bolton 030C,E01004899,1596,1596,0
2021,Bolton 030D,E01004900,1615,1612,3
2021,Bolton 031A,E01004776,1822,1822,0
2021,Bolton 031B,E01004895,1326,1326,0
2021,Bolton 031C,E01004936,2170,2131,39
2021,Bolton 031D,E01004938,1548,1547,1
2021,Bolton 031E,E01004939,1599,1599,0
2021,Bolton 032A,E01004858,1586,1565,21
2021,Bolton 032B,E01004859,1506,1399,107
2021,Bolton 032C,E01004860,1470,1470,0
2021,Bolton 032D,E01004902,1847,1847,0
2021,Bolton 032E,E01004906,1795,1746,49
2021,Bolton 033A,E01004861,1962,1962,0
2021,Bolton 033B,E01004862,1436,1436,0
2021,Bolton 033C,E01004863,1586,1586,0
2021,Bolton 033D,E01004874,1755,1754,1
2021,Bolton 033E,E01004876,1967,1967,0
2021,Bolton 034A,E01004903,1445,1445,0
2021,Bolton 034B,E01004904,1678,1678,0
2021,Bolton 034C,E01004905,1597,1592,5
2021,Bolton 034D,E01004907,1310,1308,2
2021,Bolton 034E,E01004908,1296,1296,0
2021,Bolton 034F,E01004909,1397,1397,0
2021,Bolton 034G,E01004910,2051,2051,0
2021,Bolton 035A,E01004933,1314,1314,0
2021,Bolton 035B,E01004934,1442,1442,0
2021,Bolton 035C,E01004935,1838,1838,0
2021,Bolton 035D,E01004937,1637,1637,0
2021,Bolton 035E,E01004940,1431,1431,0
2021,Bury 001A,E01005014,1465,1465,0
2021,Bury 001B,E01005015,1494,1492,2
2021,Bury 001C,E01005016,1494,1494,0
2021,Bury 001D,E01005017,1835,1835,0
2021,Bury 001E,E01005018,1534,1534,0
2021,Bury 001F,E01005021,1218,1037,181
2021,Bury 002A,E01005019,1504,1504,0
2021,Bury 002B,E01005023,1278,1253,25
2021,Bury 002C,E01005046,1480,1480,0
2021,Bury 002D,E01005048,1657,1657,0
2021,Bury 003A,E01005020,1362,1362,0
2021,Bury 003B,E01005022,1497,1497,0
2021,Bury 003C,E01005047,1477,1390,87
2021,Bury 003D,E01005049,1645,1637,8
2021,Bury 003E,E01005051,1524,1466,58
2021,Bury 004A,E01004976,1546,1539,7
2021,Bury 004B,E01004977,1708,1621,87
2021,Bury 004C,E01004978,1857,1830,27
2021,Bury 004D,E01004981,1472,1427,45
2021,Bury 004E,E01004982,1488,1488,0
2021,Bury 005A,E01004961,1450,1450,0
2021,Bury 005B,E01004965,1238,1235,3
2021,Bury 005C,E01004966,1816,1806,10
2021,Bury 005D,E01004967,1191,1191,0
2021,Bury 006A,E01004963,1478,1478,0
2021,Bury 006B,E01004968,1481,1470,11
2021,Bury 006C,E01005050,2124,2124,0
2021,Bury 006D,E01005052,1441,1441,0
2021,Bury 006E,E01005053,1530,1487,43
2021,Bury 007A,E01004954,1450,1443,7
2021,Bury 007B,E01004955,1357,1332,25
2021,Bury 007C,E01004956,1776,1737,39
2021,Bury 007D,E01004957,1899,1899,0
2021,Bury 007E,E01004960,1670,1662,8
2021,Bury 008A,E01004958,1508,1508,0
2021,Bury 008B,E01004959,1734,1733,1
2021,Bury 008C,E01004979,1812,1785,27
2021,Bury 008D,E01004980,1454,1451,3
2021,Bury 008E,E01005024,2649,2599,50
2021,Bury 008F,E01005026,2193,2193,0
2021,Bury 009A,E01004947,1546,1510,36
2021,Bury 009B,E01004948,1871,1799,72
2021,Bury 009C,E01004962,2013,2001,12
2021,Bury 009D,E01004964,1852,1802,50
2021,Bury 010A,E01004949,1413,1413,0
2021,Bury 010B,E01004950,1488,1488,0
2021,Bury 010C,E01004951,1565,1527,38
2021,Bury 010D,E01004952,1336,1336,0
2021,Bury 010E,E01004953,1533,1533,0
2021,Bury 011A,E01005025,1697,1697,0
2021,Bury 011B,E01005027,1862,1810,52
2021,Bury 011C,E01005028,2235,2233,2
2021,Bury 011D,E01005029,1985,1970,15
2021,Bury 012A,E01005000,1471,1448,23
2021,Bury 012B,E01005001,1278,1278,0
2021,Bury 012C,E01005005,1409,1409,0
2021,Bury 012D,E01005006,2022,2021,1
2021,Bury 013A,E01005030,1786,1784,2
2021,Bury 013B,E01005054,1571,1571,0
2021,Bury 013C,E01005059,1786,1786,0
2021,Bury 013D,E01005060,1734,1734,0
2021,Bury 014A,E01004997,1550,1488,62
2021,Bury 014B,E01004998,1656,1631,25
2021,Bury 014C,E01004999,1477,1477,0
2021,Bury 014D,E01005002,1507,1507,0
2021,Bury 014E,E01005003,1485,1485,0
2021,Bury 015A,E01004991,1382,1378,4
2021,Bury 015B,E01004992,1425,1425,0
2021,Bury 015C,E01004993,1988,1988,0
2021,Bury 015D,E01004994,1383,1383,0
2021,Bury 016A,E01004990,1586,1586,0
2021,Bury 016B,E01004996,1511,1474,37
2021,Bury 016C,E01005004,1584,1584,0
2021,Bury 016D,E01005008,2172,2143,29
2021,Bury 016E,E01005009,1766,1757,9
2021,Bury 017A,E01004945,1534,1534,0
2021,Bury 017B,E01005055,1448,1448,0
2021,Bury 017C,E01005056,1272,1272,0
2021,Bury 017D,E01005057,1618,1618,0
2021,Bury 017E,E01005058,1346,1346,0
2021,Bury 018A,E01004995,1501,1501,0
2021,Bury 018B,E01005010,1606,1606,0
2021,Bury 018C,E01005012,1756,1756,0
2021,Bury 018D,E01005013,2622,2620,2
2021,Bury 019A,E01004984,1392,1392,0
2021,Bury 019B,E01004985,1462,1462,0
2021,Bury 019C,E01004989,1421,1371,50
2021,Bury 019D,E01005007,1509,1455,54
2021,Bury 019E,E01005011,1431,1431,0
2021,Bury 020A,E01004983,1355,1355,0
2021,Bury 020B,E01004986,1627,1627,0
2021,Bury 020C,E01004987,1310,1297,13
2021,Bury 020D,E01004988,1387,1387,0
2021,Bury 021A,E01004941,1869,1869,0
2021,Bury 021B,E01004942,1700,1700,0
2021,Bury 021C,E01004943,1837,1837,0
2021,Bury 021D,E01004944,1517,1517,0
2021,Bury 021E,E01004946,1679,1679,0
2021,Bury 022A,E01004969,1509,1447,62
2021,Bury 022B,E01004970,1626,1626,0
2021,Bury 022C,E01004971,1480,1480,0
2021,Bury 022D,E01005034,1790,1639,151
2021,Bury 023A,E01004972,1494,1494,0
2021,Bury 023B,E01004973,1544,1544,0
2021,Bury 023C,E01004975,1498,1498,0
2021,Bury 023D,E01005039,1576,1506,70
2021,Bury 023E,E01005045,1619,1619,0
2021,Bury 024A,E01004974,1411,1411,0
2021,Bury 024B,E01005033,1675,1675,0
2021,Bury 024C,E01005036,1982,1980,2
2021,Bury 024D,E01005037,1494,1473,21
2021,Bury 025A,E01005031,1533,1531,2
2021,Bury 025B,E01005032,1341,1208,133
2021,Bury 025C,E01005035,1455,1455,0
2021,Bury 025D,E01005038,1357,1357,0
2021,Bury 026A,E01005040,1845,1839,6
2021,Bury 026B,E01005041,1857,1857,0
2021,Bury 026C,E01005042,1952,1952,0
2021,Bury 026D,E01005043,1947,1943,4
2021,Bury 026E,E01005044,1964,1942,22
2021,Manchester 001A,E01005098,1631,1630,1
2021,Manchester 001B,E01005099,1942,1933,9
2021,Manchester 001C,E01005100,1658,1658,0
2021,Manchester 001D,E01005102,1370,1370,0
2021,Manchester 001E,E01005103,1832,1828,4
2021,Manchester 002A,E01005101,1871,1870,1
2021,Manchester 002B,E01005135,1866,1866,0
2021,Manchester 002C,E01005136,1510,1480,30
2021,Manchester 002D,E01005138,2480,2480,0
2021,Manchester 002F,E01034107,1412,1412,0
2021,Manchester 002G,E01034108,2072,2047,25
2021,Manchester 003B,E01005139,1966,1966,0
2021,Manchester 003C,E01005141,1974,1974,0
2021,Manchester 003D,E01005251,1678,1678,0
2021,Manchester 003E,E01005252,1929,1901,28
2021,Manchester 003F,E01033685,1586,1586,0
2021,Manchester 003G,E01033687,1341,1284,57
2021,Manchester 004A,E01005104,1975,1975,0
2021,Manchester 004B,E01005160,1974,1974,0
2021,Manchester 004C,E01005161,1814,1814,0
2021,Manchester 004D,E01005162,1897,1840,57
2021,Manchester 004E,E01005163,1786,1786,0
2021,Manchester 005A,E01005247,1421,1421,0
2021,Manchester 005B,E01005248,1329,1329,0
2021,Manchester 005C,E01005249,2197,2157,40
2021,Manchester 005D,E01005250,2234,2177,57
2021,Manchester 005E,E01005253,1705,1705,0
2021,Manchester 005F,E01005254,1606,1606,0
2021,Manchester 006A,E01005164,2343,2245,98
2021,Manchester 006B,E01005205,2193,2190,3
2021,Manchester 006C,E01005206,1875,1815,60
2021,Manchester 006D,E01005207,2018,2018,0
2021,Manchester 007A,E01005223,1617,1617,0
2021,Manchester 007B,E01005224,2118,2118,0
2021,Manchester 007C,E01005225,2093,2044,49
2021,Manchester 007D,E01005226,1939,1938,1
2021,Manchester 007E,E01005229,1502,1502,0
2021,Manchester 008A,E01005145,3003,2963,40
2021,Manchester 008C,E01005149,2184,2184,0
2021,Manchester 008D,E01005165,2348,2316,32
2021,Manchester 008E,E01005166,2142,2122,20
2021,Manchester 008F,E01005167,2315,2278,37
2021,Manchester 008G,E01034109,1525,1525,0
2021,Manchester 008H,E01034110,1497,1497,0
2021,Manchester 009A,E01005202,2383,2357,26
2021,Manchester 009B,E01005203,2024,2021,3
2021,Manchester 009D,E01005227,2077,2051,26
2021,Manchester 009E,E01005228,2250,2250,0
2021,Manchester 009F,E01033678,1776,1776,0
2021,Manchester 009G,E01033679,1397,1397,0
2021,Manchester 011A,E01005256,2640,2563,77
2021,Manchester 011B,E01005257,2009,2009,0
2021,Manchester 011C,E01005258,1798,1700,98
2021,Manchester 011D,E01005259,1773,1773,0
2021,Manchester 011E,E01005260,1468,1389,79
2021,Manchester 012A,E01005093,1843,1776,67
2021,Manchester 012B,E01005094,1693,1692,1
2021,Manchester 012C,E01005097,1950,1950,0
2021,Manchester 012D,E01005255,1664,1664,0
2021,Manchester 012E,E01005261,1786,1786,0
2021,Manchester 015A,E01005092,1946,1917,29
2021,Manchester 015C,E01005105,2955,2946,9
2021,Manchester 015D,E01005106,2334,2334,0
2021,Manchester 015E,E01005107,2033,1966,67
2021,Manchester 015F,E01033668,1154,1152,2
2021,Manchester 015G,E01033669,1426,1426,0
2021,Manchester 017D,E01005189,1688,1688,0
2021,Manchester 017E,E01005190,2449,2448,1
2021,Manchester 017G,E01034111,1571,1571,0
2021,Manchester 017H,E01034112,1851,1851,0
2021,Manchester 017I,E01034113,1486,1485,1
2021,Manchester 017J,E01034114,1917,1890,27
2021,Manchester 018A,E01005061,1792,1790,2
2021,Manchester 018C,E01005063,2118,2110,8
2021,Manchester 018D,E01005065,2173,2031,142
2021,Manchester 018E,E01005066,1052,1052,0
2021,Manchester 018F,E01034115,1894,1149,745
2021,Manchester 018G,E01034116,1109,1109,0
2021,Manchester 019A,E01005208,2808,2377,431
2021,Manchester 019C,E01005210,2645,966,1679
2021,Manchester 019D,E01005214,2389,2386,3
2021,Manchester 019E,E01034117,2202,979,1223
2021,Manchester 019F,E01034118,1026,982,44
2021,Manchester 020A,E01005067,2075,2075,0
2021,Manchester 020B,E01005186,2896,2770,126
2021,Manchester 020C,E01005232,1926,1926,0
2021,Manchester 020D,E01005235,2079,2061,18
2021,Manchester 020E,E01005239,1803,1803,0
2021,Manchester 021A,E01005187,2246,2246,0
2021,Manchester 021B,E01005188,1919,1919,0
2021,Manchester 021C,E01005191,1860,1854,6
2021,Manchester 021D,E01005192,1733,1680,53
2021,Manchester 021E,E01005193,1770,1768,2
2021,Manchester 022B,E01005230,2094,2027,67
2021,Manchester 022C,E01005231,2503,1648,855
2021,Manchester 022D,E01005236,2265,2265,0
2021,Manchester 022E,E01005237,2037,2016,21
2021,Manchester 022H,E01034119,2667,1987,680
2021,Manchester 023A,E01005195,2447,2447,0
2021,Manchester 023C,E01005197,1727,1727,0
2021,Manchester 023D,E01005198,2050,2048,2
2021,Manchester 023E,E01005201,2127,2127,0
2021,Manchester 023F,E01034120,1777,1777,0
2021,Manchester 023G,E01034121,1422,1422,0
2021,Manchester 024B,E01005243,2911,2911,0
2021,Manchester 024C,E01005245,2806,2800,6
2021,Manchester 024D,E01005246,2541,2541,0
2021,Manchester 024E,E01034122,1868,1868,0
2021,Manchester 024F,E01034123,1761,1758,3
2021,Manchester 025C,E01005244,2993,2449,544
2021,Manchester 025D,E01005285,1536,1534,2
2021,Manchester 025E,E01005288,1823,1823,0
2021,Manchester 025F,E01034124,1568,1566,2
2021,Manchester 025G,E01034125,1556,1556,0
2021,Manchester 025H,E01034126,1655,1654,1
2021,Manchester 025I,E01034127,1362,1362,0
2021,Manchester 026A,E01005280,2177,2177,0
2021,Manchester 026B,E01005281,2572,983,1589
2021,Manchester 026C,E01005284,2598,1481,1117
2021,Manchester 026D,E01005286,2300,2153,147
2021,Manchester 026E,E01005287,2347,2336,11
2021,Manchester 028A,E01005297,2436,2364,72
2021,Manchester 028B,E01005298,1814,1814,0
2021,Manchester 028C,E01005302,2109,2061,48
2021,Manchester 028E,E01033680,1261,1251,10
2021,Manchester 028F,E01033686,1317,1317,0
2021,Manchester 029A,E01005150,1696,1646,50
2021,Manchester 029B,E01005151,1476,1404,72
2021,Manchester 029C,E01005152,1436,1436,0
2021,Manchester 029D,E01005159,1610,1600,10
2021,Manchester 029E,E01005296,1567,1565,2
2021,Manchester 029F,E01005299,1579,1579,0
2021,Manchester 030A,E01005178,2010,2010,0
2021,Manchester 030B,E01005179,2230,2151,79
2021,Manchester 030C,E01005180,1920,1920,0
2021,Manchester 030D,E01005181,2226,2087,139
2021,Manchester 030E,E01005182,1619,1567,52
2021,Manchester 030F,E01005183,1792,1792,0
2021,Manchester 031A,E01005219,2277,2265,12
2021,Manchester 031B,E01005220,2137,2132,5
2021,Manchester 031C,E01005221,2556,2555,1
2021,Manchester 031D,E01005222,2164,2158,6
2021,Manchester 032A,E01005184,2295,2259,36
2021,Manchester 032B,E01005185,3260,1767,1493
2021,Manchester 032C,E01005271,1985,1826,159
2021,Manchester 032F,E01034128,3735,3099,636
2021,Manchester 033A,E01005154,1427,1427,0
2021,Manchester 033B,E01005156,1479,1479,0
2021,Manchester 033C,E01005158,1492,1492,0
2021,Manchester 033D,E01005300,1547,1547,0
2021,Manchester 033E,E01005301,1482,1481,1
2021,Manchester 034A,E01005118,1472,1472,0
2021,Manchester 034B,E01005120,1901,1901,0
2021,Manchester 034C,E01005215,2045,2045,0
2021,Manchester 034D,E01005216,1529,1529,0
2021,Manchester 034E,E01005217,2053,2041,12
2021,Manchester 034F,E01005218,1689,1674,15
2021,Manchester 035A,E01005270,1768,1768,0
2021,Manchester 035B,E01005272,1973,1948,25
2021,Manchester 035C,E01005273,1667,1665,2
2021,Manchester 035D,E01005278,1854,1854,0
2021,Manchester 035E,E01005279,2199,2199,0
2021,Manchester 036A,E01005305,1708,1708,0
2021,Manchester 036B,E01005309,2228,2214,14
2021,Manchester 036C,E01005310,1986,1986,0
2021,Manchester 036D,E01005311,1825,1825,0
2021,Manchester 036E,E01005312,1982,1982,0
2021,Manchester 037A,E01005082,1799,1799,0
2021,Manchester 037B,E01005153,1542,1542,0
2021,Manchester 037C,E01005155,1434,1434,0
2021,Manchester 037D,E01005157,1529,1529,0
2021,Manchester 038A,E01005274,1751,1751,0
2021,Manchester 038B,E01005275,1780,1780,0
2021,Manchester 038C,E01005276,1464,1407,57
2021,Manchester 038D,E01005277,1676,1662,14
2021,Manchester 039A,E01005076,1348,1348,0
2021,Manchester 039C,E01005081,1822,1822,0
2021,Manchester 039D,E01005083,1838,1836,2
2021,Manchester 039E,E01033670,1446,1446,0
2021,Manchester 039F,E01033671,1788,1716,72
2021,Manchester 040A,E01005125,1574,1574,0
2021,Manchester 040B,E01005304,1959,1928,31
2021,Manchester 040C,E01005306,1580,1580,0
2021,Manchester 040D,E01005307,1803,1803,0
2021,Manchester 040E,E01005308,1688,1686,2
2021,Manchester 041A,E01005119,1738,1738,0
2021,Manchester 041B,E01005121,1686,1686,0
2021,Manchester 041C,E01005122,1910,1910,0
2021,Manchester 041D,E01005123,1774,1774,0
2021,Manchester 041E,E01005124,1861,1861,0
2021,Manchester 042A,E01005077,1677,1677,0
2021,Manchester 042B,E01005078,1553,1408,145
2021,Manchester 042C,E01005079,1643,1583,60
2021,Manchester 042D,E01005084,2009,2009,0
2021,Manchester 043A,E01005172,1529,1509,20
2021,Manchester 043B,E01005173,1618,1604,14
2021,Manchester 043C,E01005174,1556,1556,0
2021,Manchester 043D,E01005175,1590,1590,0
2021,Manchester 043E,E01005176,1682,1682,0
2021,Manchester 043F,E01005177,1303,1303,0
2021,Manchester 044A,E01005115,1898,1898,0
2021,Manchester 044B,E01005262,1785,1783,2
2021,Manchester 044C,E01005264,1649,1582,67
2021,Manchester 044D,E01005265,1738,1738,0
2021,Manchester 044E,E01005266,2054,2036,18
2021,Manchester 045A,E01005126,2003,2003,0
2021,Manchester 045B,E01005168,1404,1404,0
2021,Manchester 045C,E01005169,1369,1369,0
2021,Manchester 045D,E01005170,1520,1520,0
2021,Manchester 045E,E01005171,1746,1734,12
2021,Manchester 046A,E01005263,1736,1728,8
2021,Manchester 046B,E01005267,1524,1513,11
2021,Manchester 046C,E01005268,2187,2187,0
2021,Manchester 046D,E01005269,1534,1532,2
2021,Manchester 047A,E01005069,1418,1418,0
2021,Manchester 047B,E01005111,1460,1460,0
2021,Manchester 047C,E01005113,1672,1672,0
2021,Manchester 047D,E01005114,1745,1739,6
2021,Manchester 047E,E01005116,2089,2089,0
2021,Manchester 048A,E01005071,1735,1735,0
2021,Manchester 048B,E01005072,1781,1779,2
2021,Manchester 048C,E01005073,1536,1536,0
2021,Manchester 048D,E01005112,1723,1722,1
2021,Manchester 048E,E01005117,2455,2455,0
2021,Manchester 049A,E01005085,1673,1669,4
2021,Manchester 049B,E01005086,1909,1909,0
2021,Manchester 049C,E01005089,1970,1916,54
2021,Manchester 049D,E01005289,1701,1701,0
2021,Manchester 049E,E01005295,2641,2516,125
2021,Manchester 050A,E01005087,2304,2304,0
2021,Manchester 050B,E01005088,1933,1933,0
2021,Manchester 050C,E01005090,1890,1890,0
2021,Manchester 050D,E01005091,2381,2381,0
2021,Manchester 050E,E01005291,1481,1479,2
2021,Manchester 051A,E01005068,1690,1690,0
2021,Manchester 051B,E01005070,1847,1825,22
2021,Manchester 051C,E01005074,1623,1623,0
2021,Manchester 051D,E01005075,1550,1542,8
2021,Manchester 051E,E01005319,2323,2323,0
2021,Manchester 052A,E01005290,1688,1688,0
2021,Manchester 052B,E01005292,1523,1523,0
2021,Manchester 052C,E01005293,1174,1173,1
2021,Manchester 052D,E01005294,1617,1617,0
2021,Manchester 052E,E01005317,2020,2020,0
2021,Manchester 053A,E01005313,1515,1515,0
2021,Manchester 053B,E01005314,1695,1693,2
2021,Manchester 053C,E01005315,1724,1724,0
2021,Manchester 053D,E01005316,1642,1642,0
2021,Manchester 053E,E01005318,1990,1925,65
2021,Manchester 054A,E01005130,1447,1425,22
2021,Manchester 054B,E01033651,1691,1691,0
2021,Manchester 054C,E01033658,1394,1123,271
2021,Manchester 054D,E01033664,1859,1796,63
2021,Manchester 054E,E01033667,1491,1437,54
2021,Manchester 055A,E01005128,2026,1067,959
2021,Manchester 055B,E01033653,1851,1797,54
2021,Manchester 055C,E01033654,1791,906,885
2021,Manchester 055E,E01033661,1988,1987,1
2021,Manchester 055F,E01034129,1082,1082,0
2021,Manchester 055G,E01034130,1391,1391,0
2021,Manchester 056A,E01005143,3007,3004,3
2021,Manchester 056B,E01033655,1267,1261,6
2021,Manchester 056C,E01033665,1522,1522,0
2021,Manchester 056D,E01033676,2006,1967,39
2021,Manchester 057A,E01005212,3127,1532,1595
2021,Manchester 057B,E01033656,2718,848,1870
2021,Manchester 057C,E01033662,2014,1522,492
2021,Manchester 058A,E01005142,2293,2290,3
2021,Manchester 058B,E01005147,2783,2781,2
2021,Manchester 058C,E01033674,2080,1424,656
2021,Manchester 058D,E01033675,2208,2206,2
2021,Manchester 059A,E01005213,2397,2390,7
2021,Manchester 059B,E01033660,1438,1438,0
2021,Manchester 059C,E01033672,1704,1704,0
2021,Manchester 059D,E01033673,1444,1444,0
2021,Manchester 060A,E01033677,1019,1019,0
2021,Manchester 060B,E01033681,1330,1330,0
2021,Manchester 060C,E01033682,1222,1222,0
2021,Manchester 060E,E01034131,1025,1025,0
2021,Manchester 060F,E01034132,1832,1588,244
2021,Manchester 061A,E01005129,1842,1842,0
2021,Manchester 061B,E01005132,2137,2137,0
2021,Manchester 061C,E01034133,1869,1854,15
2021,Manchester 061D,E01034134,1193,1193,0
2021,Manchester 062D,E01033684,1820,1820,0
2021,Manchester 062B,E01033688,1709,1647,62
2021,Manchester 062A,E01034135,1115,1115,0
2021,Manchester 062C,E01034136,1009,1009,0
2021,Manchester 063B,E01005233,2937,2929,8
2021,Manchester 063A,E01005234,2313,2313,0
2021,Manchester 063D,E01005238,2298,2294,4
2021,Manchester 063C,E01034137,1732,1727,5
2021,Manchester 064C,E01005199,2512,2512,0
2021,Manchester 064A,E01005200,2459,2459,0
2021,Manchester 064B,E01034138,1385,1385,0
2021,Oldham 001A,E01005357,1428,1428,0
2021,Oldham 001B,E01005358,1568,1568,0
2021,Oldham 001C,E01005359,1564,1564,0
2021,Oldham 001D,E01005360,1380,1378,2
2021,Oldham 002A,E01005441,1527,1527,0
2021,Oldham 002B,E01005442,1329,1327,2
2021,Oldham 002C,E01005444,1397,1397,0
2021,Oldham 002D,E01005445,1425,1425,0
2021,Oldham 003A,E01005361,1671,1671,0
2021,Oldham 003B,E01005443,1314,1314,0
2021,Oldham 003C,E01005446,1406,1406,0
2021,Oldham 003D,E01005447,1647,1512,135
2021,Oldham 004A,E01005390,1361,1361,0
2021,Oldham 004B,E01005394,1450,1450,0
2021,Oldham 004C,E01005395,1430,1430,0
2021,Oldham 004D,E01005396,1433,1433,0
2021,Oldham 005A,E01005355,1459,1459,0
2021,Oldham 005B,E01005356,1252,1252,0
2021,Oldham 005C,E01005399,1585,1585,0
2021,Oldham 005D,E01005403,1734,1734,0
2021,Oldham 006A,E01005410,1495,1495,0
2021,Oldham 006B,E01005411,1563,1563,0
2021,Oldham 006C,E01005414,1335,1330,5
2021,Oldham 006D,E01005415,1109,1109,0
2021,Oldham 007C,E01005452,1278,1278,0
2021,Oldham 007D,E01005453,1555,1555,0
2021,Oldham 007E,E01032558,1728,1728,0
2021,Oldham 007F,E01032559,2751,2682,69
2021,Oldham 008A,E01005391,1559,1559,0
2021,Oldham 008B,E01005392,1588,1588,0
2021,Oldham 008C,E01005393,1221,1201,20
2021,Oldham 008D,E01005401,1585,1585,0
2021,Oldham 009A,E01005397,1328,1328,0
2021,Oldham 009B,E01005398,1529,1483,46
2021,Oldham 009C,E01005400,1526,1524,2
2021,Oldham 009D,E01005402,1644,1617,27
2021,Oldham 010A,E01005335,1290,1290,0
2021,Oldham 010B,E01005337,2548,2546,2
2021,Oldham 010C,E01005339,1485,1485,0
2021,Oldham 010D,E01005340,1599,1598,1
2021,Oldham 011A,E01005421,1816,1744,72
2021,Oldham 011B,E01005422,1551,1551,0
2021,Oldham 011E,E01032920,2585,2585,0
2021,Oldham 012A,E01005448,1643,1630,13
2021,Oldham 012B,E01005449,1584,1560,24
2021,Oldham 012C,E01005454,1379,1357,22
2021,Oldham 012D,E01005455,1464,1441,23
2021,Oldham 012E,E01005456,1679,1679,0
2021,Oldham 013A,E01005407,1719,1717,2
2021,Oldham 013B,E01005412,1684,1684,0
2021,Oldham 013C,E01005416,1521,1498,23
2021,Oldham 013D,E01005417,1554,1522,32
2021,Oldham 014A,E01005348,2423,2423,0
2021,Oldham 014B,E01005350,2408,2376,32
2021,Oldham 014C,E01005432,1827,1798,29
2021,Oldham 014D,E01005433,2477,2477,0
2021,Oldham 015A,E01005329,1499,1499,0
2021,Oldham 015B,E01005330,1735,1735,0
2021,Oldham 015C,E01005333,1239,1237,2
2021,Oldham 015D,E01005336,1521,1521,0
2021,Oldham 016A,E01005349,2506,2506,0
2021,Oldham 016B,E01005351,2085,2085,0
2021,Oldham 016C,E01005352,1528,1512,16
2021,Oldham 016D,E01005353,1510,1508,2
2021,Oldham 016E,E01005354,1804,1801,3
2021,Oldham 017A,E01005327,1966,1883,83
2021,Oldham 017B,E01005328,1790,1788,2
2021,Oldham 017C,E01005331,1724,1724,0
2021,Oldham 017D,E01005334,1425,1425,0
2021,Oldham 017E,E01005338,1941,1941,0
2021,Oldham 018A,E01005387,1473,1473,0
2021,Oldham 018B,E01005388,1339,1317,22
2021,Oldham 018C,E01005389,1767,1727,40
2021,Oldham 018D,E01005418,1411,1411,0
2021,Oldham 019A,E01005428,2365,2365,0
2021,Oldham 019B,E01005431,1862,1822,40
2021,Oldham 019C,E01005450,2138,2138,0
2021,Oldham 019D,E01005451,1547,1547,0
2021,Oldham 020C,E01005408,2018,2013,5
2021,Oldham 020D,E01005409,1568,1568,0
2021,Oldham 020E,E01032922,2414,2414,0
2021,Oldham 021A,E01005406,1407,1407,0
2021,Oldham 021B,E01005413,1591,1591,0
2021,Oldham 021C,E01005419,1451,1451,0
2021,Oldham 021D,E01005420,1615,1597,18
2021,Oldham 022A,E01005321,2335,2301,34
2021,Oldham 022B,E01005326,2997,2816,181
2021,Oldham 022C,E01005427,2214,2214,0
2021,Oldham 022D,E01005429,1920,1920,0
2021,Oldham 022E,E01005430,2852,2852,0
2021,Oldham 024A,E01005320,2700,2684,16
2021,Oldham 024B,E01005434,2161,2142,19
2021,Oldham 024C,E01005437,2048,2048,0
2021,Oldham 024D,E01005459,1770,1770,0
2021,Oldham 026A,E01005383,2191,2191,0
2021,Oldham 026D,E01005386,1548,1546,2
2021,Oldham 026E,E01032556,1502,1502,0
2021,Oldham 026F,E01032557,1819,1800,19
2021,Oldham 027A,E01005342,1592,1592,0
2021,Oldham 027B,E01005343,1415,1415,0
2021,Oldham 027C,E01005344,1913,1913,0
2021,Oldham 027D,E01005381,1956,1956,0
2021,Oldham 028A,E01005332,2294,2292,2
2021,Oldham 028B,E01005341,1413,1413,0
2021,Oldham 028C,E01005345,1503,1503,0
2021,Oldham 028D,E01005346,1392,1361,31
2021,Oldham 028E,E01005347,1309,1306,3
2021,Oldham 029A,E01005322,1509,1509,0
2021,Oldham 029B,E01005323,1571,1531,40
2021,Oldham 029C,E01005324,1620,1620,0
2021,Oldham 029D,E01005325,1497,1497,0
2021,Oldham 029E,E01005438,2968,2968,0
2021,Oldham 030A,E01005377,1749,1749,0
2021,Oldham 030B,E01005379,1296,1296,0
2021,Oldham 030C,E01005380,1513,1513,0
2021,Oldham 030D,E01005382,1609,1607,2
2021,Oldham 030E,E01005439,1587,1587,0
2021,Oldham 031A,E01005362,1357,1357,0
2021,Oldham 031B,E01005364,1584,1584,0
2021,Oldham 031C,E01005368,1516,1512,4
2021,Oldham 031D,E01005376,1444,1444,0
2021,Oldham 031E,E01005378,1557,1551,6
2021,Oldham 032A,E01005363,1772,1772,0
2021,Oldham 032B,E01005369,1965,1895,70
2021,Oldham 032C,E01005370,1578,1578,0
2021,Oldham 032D,E01005371,1472,1448,24
2021,Oldham 033A,E01005365,1377,1377,0
2021,Oldham 033B,E01005366,1556,1537,19
2021,Oldham 033C,E01005367,1420,1420,0
2021,Oldham 033D,E01005440,1450,1450,0
2021,Oldham 034A,E01005372,1277,1277,0
2021,Oldham 034B,E01005373,1193,1193,0
2021,Oldham 034C,E01005374,1486,1486,0
2021,Oldham 034D,E01005375,1502,1502,0
2021,Oldham 036C,E01005460,2705,2705,0
2021,Oldham 036D,E01005463,1687,1687,0
2021,Oldham 036A,E01034232,1692,1600,92
2021,Oldham 036B,E01034233,1609,1607,2
2021,Oldham 037B,E01005435,2032,2032,0
2021,Oldham 037D,E01005436,1827,1801,26
2021,Oldham 037A,E01005461,2424,2424,0
2021,Oldham 037C,E01005462,2204,2182,22
2021,Rochdale 001A,E01005518,1592,1581,11
2021,Rochdale 001B,E01005520,1715,1715,0
2021,Rochdale 001C,E01005522,1484,1456,28
2021,Rochdale 001D,E01005523,1831,1810,21
2021,Rochdale 002A,E01005519,1564,1564,0
2021,Rochdale 002B,E01005594,1514,1502,12
2021,Rochdale 002C,E01005597,1979,1979,0
2021,Rochdale 002D,E01005598,1548,1548,0
2021,Rochdale 003A,E01005516,1281,1263,18
2021,Rochdale 003B,E01005517,1435,1397,38
2021,Rochdale 003C,E01005521,1452,1424,28
2021,Rochdale 003D,E01005596,2156,2127,29
2021,Rochdale 004A,E01005578,1543,1505,38
2021,Rochdale 004B,E01005579,1861,1861,0
2021,Rochdale 004C,E01005586,1615,1606,9
2021,Rochdale 004D,E01005593,2056,2037,19
2021,Rochdale 004E,E01005595,1328,1326,2
2021,Rochdale 005A,E01005489,1249,1249,0
2021,Rochdale 005B,E01005490,1571,1143,428
2021,Rochdale 005C,E01005491,1436,1436,0
2021,Rochdale 005D,E01005493,1762,1762,0
2021,Rochdale 005E,E01005494,1758,1758,0
2021,Rochdale 005F,E01005495,1769,1735,34
2021,Rochdale 006A,E01005488,1507,1503,4
2021,Rochdale 006B,E01005492,1535,1532,3
2021,Rochdale 006C,E01005499,1512,1512,0
2021,Rochdale 006D,E01005571,1648,1648,0
2021,Rochdale 007A,E01005570,1307,1262,45
2021,Rochdale 007B,E01005572,1500,1500,0
2021,Rochdale 007C,E01005573,1433,1433,0
2021,Rochdale 007D,E01005574,1728,1728,0
2021,Rochdale 007E,E01005587,1368,1368,0
2021,Rochdale 007F,E01005588,1316,1268,48
2021,Rochdale 008A,E01005580,1647,1647,0
2021,Rochdale 008B,E01005581,1973,1971,2
2021,Rochdale 008D,E01005583,1746,1746,0
2021,Rochdale 008F,E01005585,1567,1562,5
2021,Rochdale 008H,E01034234,1763,1757,6
2021,Rochdale 008I,E01034235,1667,1665,2
2021,Rochdale 009A,E01005496,1321,1321,0
2021,Rochdale 009B,E01005589,1700,1700,0
2021,Rochdale 009C,E01005590,1904,1871,33
2021,Rochdale 009D,E01005591,1586,1555,31
2021,Rochdale 009E,E01005592,1638,1616,22
2021,Rochdale 010A,E01005472,1647,1643,4
2021,Rochdale 010B,E01005473,1699,1699,0
2021,Rochdale 010C,E01005482,1661,1618,43
2021,Rochdale 010D,E01005483,1485,1474,11
2021,Rochdale 010E,E01005484,2032,2021,11
2021,Rochdale 010F,E01005486,1701,1701,0
2021,Rochdale 010G,E01005487,1789,1789,0
2021,Rochdale 011A,E01005474,1318,1248,70
2021,Rochdale 011B,E01005575,1714,1714,0
2021,Rochdale 011C,E01005576,1522,1522,0
2021,Rochdale 011D,E01005577,1459,1459,0
2021,Rochdale 012A,E01005469,1822,1822,0
2021,Rochdale 012B,E01005563,2170,2170,0
2021,Rochdale 012C,E01005565,1571,1571,0
2021,Rochdale 012D,E01005566,2344,2339,5
2021,Rochdale 012E,E01005568,1940,1888,52
2021,Rochdale 012F,E01005569,1792,1792,0
2021,Rochdale 013A,E01005556,1528,1528,0
2021,Rochdale 013B,E01005559,1469,1469,0
2021,Rochdale 013C,E01005560,1462,1437,25
2021,Rochdale 013D,E01005567,1879,1860,19
2021,Rochdale 014A,E01005555,1383,1383,0
2021,Rochdale 014B,E01005557,1139,1139,0
2021,Rochdale 014C,E01005558,1594,1594,0
2021,Rochdale 014D,E01005561,1412,1394,18
2021,Rochdale 014E,E01005562,1509,1509,0
2021,Rochdale 015A,E01005470,2036,1983,53
2021,Rochdale 015B,E01005471,1696,1696,0
2021,Rochdale 015C,E01005475,1778,1778,0
2021,Rochdale 015D,E01005485,2373,2312,61
2021,Rochdale 015E,E01005564,2410,2408,2
2021,Rochdale 016A,E01005464,1969,1969,0
2021,Rochdale 016B,E01005465,1810,1780,30
2021,Rochdale 016C,E01005466,2484,2461,23
2021,Rochdale 016D,E01005467,1972,1972,0
2021,Rochdale 016E,E01005468,2166,2166,0
2021,Rochdale 017A,E01005476,1796,1796,0
2021,Rochdale 017B,E01005477,1771,1771,0
2021,Rochdale 017C,E01005478,1588,1588,0
2021,Rochdale 017D,E01005479,1976,1942,34
2021,Rochdale 017E,E01005480,1647,1645,2
2021,Rochdale 017F,E01005481,1680,1565,115
2021,Rochdale 018A,E01005497,1891,1891,0
2021,Rochdale 018B,E01005501,1783,1783,0
2021,Rochdale 018C,E01005502,1378,1378,0
2021,Rochdale 018D,E01005504,1642,1642,0
2021,Rochdale 018E,E01005505,2182,2182,0
2021,Rochdale 018F,E01005509,1445,1445,0
2021,Rochdale 019A,E01005510,1094,1094,0
2021,Rochdale 019B,E01005511,1251,1170,81
2021,Rochdale 019C,E01005512,1440,1437,3
2021,Rochdale 019D,E01005513,1554,1554,0
2021,Rochdale 019E,E01005514,1844,1844,0
2021,Rochdale 019F,E01005515,1798,1798,0
2021,Rochdale 020A,E01005498,1372,1363,9
2021,Rochdale 020B,E01005500,1592,1555,37
2021,Rochdale 020C,E01005503,1318,1318,0
2021,Rochdale 020D,E01005506,1546,1492,54
2021,Rochdale 020E,E01005507,2261,2261,0
2021,Rochdale 020F,E01005508,2015,2015,0
2021,Rochdale 021A,E01005524,1470,1470,0
2021,Rochdale 021B,E01005525,1886,1886,0
2021,Rochdale 021C,E01005526,1907,1907,0
2021,Rochdale 021D,E01005528,1548,1548,0
2021,Rochdale 021E,E01005536,1713,1713,0
2021,Rochdale 021F,E01005543,1251,1212,39
2021,Rochdale 022A,E01005527,2059,2028,31
2021,Rochdale 022B,E01005529,1660,1658,2
2021,Rochdale 022C,E01005551,2026,2026,0
2021,Rochdale 022D,E01005552,2342,2340,2
2021,Rochdale 022E,E01005553,2037,2035,2
2021,Rochdale 022F,E01005554,2157,2157,0
2021,Rochdale 023A,E01005534,1417,1417,0
2021,Rochdale 023B,E01005535,1469,1441,28
2021,Rochdale 023C,E01005537,1270,1270,0
2021,Rochdale 023D,E01005538,1482,1482,0
2021,Rochdale 023E,E01005540,1345,1345,0
2021,Rochdale 023F,E01005541,1534,1534,0
2021,Rochdale 023G,E01005542,1619,1600,19
2021,Rochdale 024A,E01005533,1623,1620,3
2021,Rochdale 024B,E01005539,1311,1289,22
2021,Rochdale 024C,E01005546,1242,1242,0
2021,Rochdale 024D,E01005547,1755,1737,18
2021,Rochdale 024E,E01005548,1275,1235,40
2021,Rochdale 025A,E01005530,1458,1458,0
2021,Rochdale 025B,E01005531,1158,1158,0
2021,Rochdale 025C,E01005532,1548,1548,0
2021,Rochdale 025D,E01005544,1475,1475,0
2021,Rochdale 025E,E01005545,1250,1250,0
2021,Rochdale 025F,E01005549,1548,1548,0
2021,Rochdale 025G,E01005550,1465,1465,0
2021,Salford 001A,E01005659,1544,1502,42
2021,Salford 001B,E01005660,1823,1822,1
2021,Salford 001C,E01005663,1525,1525,0
2021,Salford 001D,E01005664,1707,1706,1
2021,Salford 001E,E01005665,2104,2104,0
2021,Salford 002A,E01005703,1746,1746,0
2021,Salford 002B,E01005704,1344,1344,0
2021,Salford 002C,E01005706,1537,1512,25
2021,Salford 002D,E01005708,1434,1433,1
2021,Salford 003A,E01005702,2639,2639,0
2021,Salford 003C,E01005707,1751,1751,0
2021,Salford 003D,E01033976,1965,1965,0
2021,Salford 003E,E01033977,1141,1141,0
2021,Salford 004A,E01005661,1900,1892,8
2021,Salford 004B,E01005662,1620,1620,0
2021,Salford 004C,E01005709,1606,1606,0
2021,Salford 004D,E01005710,2143,2143,0
2021,Salford 005A,E01005670,1759,1759,0
2021,Salford 005B,E01005672,1278,1277,1
2021,Salford 005C,E01005676,1225,1225,0
2021,Salford 005D,E01005677,1581,1581,0
2021,Salford 006A,E01005686,1463,1463,0
2021,Salford 006B,E01005688,1568,1568,0
2021,Salford 006C,E01005691,1414,1414,0
2021,Salford 006D,E01005692,1375,1355,20
2021,Salford 007A,E01005711,1394,1394,0
2021,Salford 007B,E01005712,1838,1803,35
2021,Salford 007C,E01005713,1627,1627,0
2021,Salford 007D,E01005714,1712,1712,0
2021,Salford 007E,E01005715,1746,1746,0
2021,Salford 007F,E01005718,1601,1601,0
2021,Salford 008A,E01005673,1486,1486,0
2021,Salford 008C,E01005678,1569,1569,0
2021,Salford 008D,E01005679,1550,1550,0
2021,Salford 008E,E01033978,1027,1027,0
2021,Salford 008F,E01033979,2044,1145,899
2021,Salford 009A,E01005687,1804,1801,3
2021,Salford 009B,E01005689,1366,1366,0
2021,Salford 009C,E01005690,1568,1568,0
2021,Salford 009D,E01005693,1433,1433,0
2021,Salford 010A,E01005646,2254,2254,0
2021,Salford 010B,E01005649,1723,1705,18
2021,Salford 010C,E01005650,1993,1961,32
2021,Salford 010D,E01005651,2278,2253,25
2021,Salford 011A,E01005647,1501,1436,65
2021,Salford 011B,E01005648,2351,2351,0
2021,Salford 011C,E01005652,1555,1555,0
2021,Salford 011D,E01005653,1562,1560,2
2021,Salford 012A,E01005671,1567,1552,15
2021,Salford 012B,E01005674,1573,1500,73
2021,Salford 012C,E01005694,1709,1709,0
2021,Salford 012D,E01005696,1784,1780,4
2021,Salford 012E,E01005698,1745,1745,0
2021,Salford 012F,E01005700,1516,1516,0
2021,Salford 013A,E01005716,1633,1633,0
2021,Salford 013B,E01005717,1555,1555,0
2021,Salford 013C,E01005734,1419,1376,43
2021,Salford 013D,E01005735,1423,1423,0
2021,Salford 013E,E01005736,1368,1368,0
2021,Salford 013F,E01005737,1511,1511,0
2021,Salford 013G,E01005739,1999,1999,0
2021,Salford 014A,E01005695,1556,1556,0
2021,Salford 014B,E01005697,1531,1531,0
2021,Salford 014C,E01005738,1933,1886,47
2021,Salford 014D,E01005740,1599,1599,0
2021,Salford 014E,E01005741,1679,1679,0
2021,Salford 014F,E01005742,1555,1555,0
2021,Salford 015A,E01005625,1372,1372,0
2021,Salford 015B,E01005627,1172,1172,0
2021,Salford 015C,E01005699,1790,1790,0
2021,Salford 015D,E01005701,1824,1805,19
2021,Salford 017A,E01005624,1841,1841,0
2021,Salford 017B,E01005680,1732,1680,52
2021,Salford 017C,E01005683,2149,2073,76
2021,Salford 017G,E01033980,1043,1043,0
2021,Salford 017H,E01033981,2739,2074,665
2021,Salford 018A,E01005622,1595,1580,15
2021,Salford 018B,E01005623,1266,1258,8
2021,Salford 018C,E01005626,1286,1258,28
2021,Salford 018D,E01005628,1575,1529,46
2021,Salford 019A,E01005725,1460,1459,1
2021,Salford 019B,E01005726,1433,1431,2
2021,Salford 019C,E01005727,1349,1348,1
2021,Salford 019D,E01005728,1791,1791,0
2021,Salford 019E,E01005733,1469,1469,0
2021,Salford 020A,E01005631,1577,1567,10
2021,Salford 020B,E01005632,2452,2450,2
2021,Salford 020C,E01005633,1532,1532,0
2021,Salford 020D,E01005634,1589,1589,0
2021,Salford 020E,E01005635,1552,1457,95
2021,Salford 020F,E01005636,1598,1565,33
2021,Salford 020G,E01005637,1453,1453,0
2021,Salford 021A,E01005629,1485,1480,5
2021,Salford 021B,E01005630,1529,1509,20
2021,Salford 021C,E01005719,2038,1990,48
2021,Salford 021E,E01005722,2032,2007,25
2021,Salford 021F,E01005723,1661,1654,7
2021,Salford 021G,E01005724,1413,1378,35
2021,Salford 021H,E01033982,1911,1880,31
2021,Salford 021I,E01033983,1275,1275,0
2021,Salford 023A,E01005654,1966,1966,0
2021,Salford 023B,E01005656,1697,1697,0
2021,Salford 023C,E01005657,1802,1761,41
2021,Salford 023D,E01005721,1552,1551,1
2021,Salford 024C,E01005681,1502,1033,469
2021,Salford 024D,E01005682,1741,1741,0
2021,Salford 024E,E01033984,2442,2417,25
2021,Salford 025A,E01005729,1535,1517,18
2021,Salford 025B,E01005730,1668,1668,0
2021,Salford 025C,E01005731,1567,1567,0
2021,Salford 025D,E01005732,1207,1207,0
2021,Salford 026A,E01005599,1903,1901,2
2021,Salford 026B,E01005600,2036,2036,0
2021,Salford 026C,E01005601,1740,1646,94
2021,Salford 026D,E01005602,1674,1674,0
2021,Salford 027A,E01005603,1809,1808,1
2021,Salford 027B,E01005604,1651,1651,0
2021,Salford 027C,E01005605,1658,1645,13
2021,Salford 027D,E01005638,2211,2163,48
2021,Salford 029A,E01005639,1516,1516,0
2021,Salford 029B,E01005640,1360,1360,0
2021,Salford 029C,E01005641,1365,1336,29
2021,Salford 029D,E01005642,1208,1208,0
2021,Salford 029E,E01005643,1369,1350,19
2021,Salford 029F,E01005644,1517,1517,0
2021,Salford 029G,E01005645,1363,1363,0
2021,Salford 030A,E01005616,1446,1446,0
2021,Salford 030B,E01005617,1480,1480,0
2021,Salford 030C,E01005618,2080,2080,0
2021,Salford 030D,E01005619,1231,1231,0
2021,Salford 030E,E01005620,2550,2550,0
2021,Salford 030F,E01005621,1770,1770,0
2021,Salford 031B,E01005612,2481,2481,0
2021,Salford 031A,E01005613,2698,2640,58
2021,Salford 031C,E01005614,3100,3100,0
2021,Salford 032C,E01005611,2513,2509,4
2021,Salford 032D,E01005615,2372,2275,97
2021,Salford 032A,E01033985,1664,1629,35
2021,Salford 032B,E01033986,1524,1524,0
2021,Salford 033F,E01032909,1716,1716,0
2021,Salford 033E,E01033330,1541,1418,123
2021,Salford 033A,E01033987,1137,1137,0
2021,Salford 033B,E01033988,1311,1311,0
2021,Salford 033C,E01033989,1132,1132,0
2021,Salford 033D,E01033990,1187,1187,0
2021,Salford 034C,E01005610,2941,1289,1652
2021,Salford 034D,E01032684,1386,1285,101
2021,Salford 034E,E01032906,2043,1948,95
2021,Salford 034A,E01033991,1561,1561,0
2021,Salford 034B,E01033992,1398,1398,0
2021,Salford 035C,E01005667,2274,2272,2
2021,Salford 035B,E01032912,2271,2094,177
2021,Salford 035A,E01032914,2121,2121,0
2021,Salford 036C,E01032915,2138,2138,0
2021,Salford 036A,E01033993,1813,1813,0
2021,Salford 036B,E01033994,1172,1172,0
2021,Salford 037A,E01033995,1205,1205,0
2021,Salford 037B,E01033996,1218,1218,0
2021,Salford 037C,E01033997,1030,1030,0
2021,Salford 037D,E01033998,1329,1329,0
2021,Salford 037E,E01033999,1223,1221,2
2021,Stockport 001A,E01005886,1466,1466,0
2021,Stockport 001B,E01005888,1530,1530,0
2021,Stockport 001C,E01005889,1423,1419,4
2021,Stockport 001D,E01005891,1221,1221,0
2021,Stockport 001E,E01005894,1362,1362,0
2021,Stockport 002A,E01005887,1732,1732,0
2021,Stockport 002B,E01005890,1527,1527,0
2021,Stockport 002C,E01005893,2187,2187,0
2021,Stockport 002D,E01005896,1663,1663,0
2021,Stockport 002E,E01005919,1541,1538,3
2021,Stockport 003A,E01005862,1476,1476,0
2021,Stockport 003B,E01005892,1267,1267,0
2021,Stockport 003C,E01005895,1168,1145,23
2021,Stockport 003D,E01005920,1601,1601,0
2021,Stockport 003E,E01005921,1471,1470,1
2021,Stockport 003F,E01005922,1314,1314,0
2021,Stockport 004A,E01005753,1838,1731,107
2021,Stockport 004B,E01005754,2005,2005,0
2021,Stockport 004C,E01005755,1737,1699,38
2021,Stockport 004D,E01005756,2378,2345,33
2021,Stockport 005A,E01005745,1375,1375,0
2021,Stockport 005B,E01005746,1451,1420,31
2021,Stockport 005C,E01005747,1403,1403,0
2021,Stockport 005D,E01005748,1512,1512,0
2021,Stockport 006A,E01005863,1719,1704,15
2021,Stockport 006B,E01005864,1576,1489,87
2021,Stockport 006C,E01005866,1669,1669,0
2021,Stockport 006D,E01005869,1593,1593,0
2021,Stockport 007A,E01005914,1418,1418,0
2021,Stockport 007B,E01005915,1549,1548,1
2021,Stockport 007C,E01005916,1614,1594,20
2021,Stockport 007D,E01005917,1830,1818,12
2021,Stockport 008A,E01005859,1411,1396,15
2021,Stockport 008B,E01005865,1963,1963,0
2021,Stockport 008C,E01005867,1482,1461,21
2021,Stockport 008D,E01005868,1522,1522,0
2021,Stockport 009A,E01005743,1274,1274,0
2021,Stockport 009B,E01005744,1554,1474,80
2021,Stockport 009C,E01005749,1656,1656,0
2021,Stockport 009D,E01005750,1669,1669,0
2021,Stockport 009E,E01005751,1400,1400,0
2021,Stockport 010A,E01005897,1528,1457,71
2021,Stockport 010B,E01005898,1708,1708,0
2021,Stockport 010C,E01005900,1608,1607,1
2021,Stockport 010D,E01005903,1457,1449,8
2021,Stockport 010E,E01005904,1530,1530,0
2021,Stockport 011A,E01005853,1615,1615,0
2021,Stockport 011B,E01005856,1602,1597,5
2021,Stockport 011C,E01005860,1517,1517,0
2021,Stockport 011D,E01005861,1543,1543,0
2021,Stockport 012A,E01005752,1405,1405,0
2021,Stockport 012B,E01005899,1619,1543,76
2021,Stockport 012C,E01005901,1367,1367,0
2021,Stockport 012D,E01005902,1620,1620,0
2021,Stockport 012E,E01005905,1511,1470,41
2021,Stockport 013A,E01005852,1486,1486,0
2021,Stockport 013B,E01005854,1731,1727,4
2021,Stockport 013C,E01005855,1483,1483,0
2021,Stockport 013D,E01005857,1626,1626,0
2021,Stockport 013E,E01005858,1580,1580,0
2021,Stockport 014A,E01005757,1603,1603,0
2021,Stockport 014C,E01005766,1776,1769,7
2021,Stockport 014D,E01005918,1616,1532,84
2021,Stockport 014E,E01033947,1540,1540,0
2021,Stockport 014F,E01033948,1349,1349,0
2021,Stockport 015A,E01005870,1374,1374,0
2021,Stockport 015B,E01005871,1382,1382,0
2021,Stockport 015C,E01005873,1469,1455,14
2021,Stockport 015D,E01005875,1562,1562,0
2021,Stockport 016A,E01005764,1604,1570,34
2021,Stockport 016B,E01005816,1561,1561,0
2021,Stockport 016C,E01005817,1391,1391,0
2021,Stockport 016D,E01005822,1897,1894,3
2021,Stockport 017A,E01005880,1488,1488,0
2021,Stockport 017B,E01005881,1210,1210,0
2021,Stockport 017C,E01005883,1519,1519,0
2021,Stockport 017D,E01005908,1644,1631,13
2021,Stockport 018A,E01005765,1379,1364,15
2021,Stockport 018B,E01005818,1400,1400,0
2021,Stockport 018C,E01005819,1595,1595,0
2021,Stockport 018D,E01005820,1491,1440,51
2021,Stockport 018E,E01005821,1412,1411,1
2021,Stockport 018F,E01005823,1646,1646,0
2021,Stockport 019A,E01005825,1676,1669,7
2021,Stockport 019B,E01005872,1646,1639,7
2021,Stockport 019C,E01005874,1875,1875,0
2021,Stockport 019D,E01005876,1495,1495,0
2021,Stockport 019E,E01005877,1738,1738,0
2021,Stockport 020A,E01005878,1749,1747,2
2021,Stockport 020B,E01005879,1318,1318,0
2021,Stockport 020C,E01005882,1276,1235,41
2021,Stockport 020D,E01005884,1435,1435,0
2021,Stockport 020E,E01005885,1491,1426,65
2021,Stockport 021A,E01005832,1421,1421,0
2021,Stockport 021B,E01005833,1040,1024,16
2021,Stockport 021C,E01005835,1393,1387,6
2021,Stockport 021D,E01005837,1546,1546,0
2021,Stockport 021E,E01005843,1450,1450,0
2021,Stockport 022A,E01005769,1552,1502,50
2021,Stockport 022B,E01005778,1408,1387,21
2021,Stockport 022C,E01005779,1472,1472,0
2021,Stockport 022D,E01005780,1485,1485,0
2021,Stockport 022E,E01005781,1656,1656,0
2021,Stockport 023A,E01005759,1677,1677,0
2021,Stockport 023B,E01005760,1932,1932,0
2021,Stockport 023C,E01005797,1414,1414,0
2021,Stockport 023D,E01005800,1615,1615,0
2021,Stockport 023E,E01005804,1131,1070,61
2021,Stockport 024A,E01005824,1508,1508,0
2021,Stockport 024B,E01005826,1611,1570,41
2021,Stockport 024C,E01005827,1752,1752,0
2021,Stockport 024D,E01005828,1373,1373,0
2021,Stockport 024E,E01005829,1192,1180,12
2021,Stockport 025A,E01005768,2066,2047,19
2021,Stockport 025B,E01005770,1497,1497,0
2021,Stockport 025C,E01005771,1439,1416,23
2021,Stockport 025D,E01005775,1665,1633,32
2021,Stockport 026A,E01005761,1408,1406,2
2021,Stockport 026B,E01005762,1973,1972,1
2021,Stockport 026C,E01005763,1733,1674,59
2021,Stockport 026D,E01005799,1874,1874,0
2021,Stockport 027A,E01005798,1642,1565,77
2021,Stockport 027B,E01005801,2219,2176,43
2021,Stockport 027C,E01005802,1482,1470,12
2021,Stockport 027D,E01005803,1394,1394,0
2021,Stockport 027E,E01005830,1539,1539,0
2021,Stockport 027F,E01005831,1645,1639,6
2021,Stockport 028A,E01005767,1633,1633,0
2021,Stockport 028B,E01005772,1550,1550,0
2021,Stockport 028C,E01005773,1572,1572,0
2021,Stockport 028D,E01005774,1549,1528,21
2021,Stockport 028E,E01005776,1716,1716,0
2021,Stockport 029A,E01005909,1532,1532,0
2021,Stockport 029B,E01005910,1614,1613,1
2021,Stockport 029C,E01005911,1330,1261,69
2021,Stockport 029D,E01005912,1495,1495,0
2021,Stockport 030A,E01005782,1277,1277,0
2021,Stockport 030B,E01005783,1550,1550,0
2021,Stockport 030C,E01005784,1494,1494,0
2021,Stockport 030D,E01005785,1673,1673,0
2021,Stockport 030E,E01005786,1848,1848,0
2021,Stockport 031A,E01005834,1542,1542,0
2021,Stockport 031B,E01005836,1833,1786,47
2021,Stockport 031C,E01005838,1780,1780,0
2021,Stockport 031D,E01005840,1603,1596,7
2021,Stockport 032A,E01005927,1305,1305,0
2021,Stockport 032B,E01005928,1619,1619,0
2021,Stockport 032C,E01005929,1418,1418,0
2021,Stockport 032D,E01005930,1678,1605,73
2021,Stockport 033A,E01005806,1187,1187,0
2021,Stockport 033B,E01005813,1365,1364,1
2021,Stockport 033C,E01005814,1296,1291,5
2021,Stockport 033D,E01005815,1436,1436,0
2021,Stockport 034A,E01005777,1558,1558,0
2021,Stockport 034B,E01005787,1331,1331,0
2021,Stockport 034C,E01005788,1565,1565,0
2021,Stockport 034D,E01005790,1221,1221,0
2021,Stockport 035A,E01005805,1540,1514,26
2021,Stockport 035B,E01005807,1550,1535,15
2021,Stockport 035C,E01005839,1296,1296,0
2021,Stockport 035D,E01005841,1480,1468,12
2021,Stockport 036A,E01005844,1548,1471,77
2021,Stockport 036B,E01005845,1657,1657,0
2021,Stockport 036C,E01005849,1651,1651,0
2021,Stockport 036D,E01005851,1622,1622,0
2021,Stockport 037A,E01005808,1375,1375,0
2021,Stockport 037B,E01005809,1226,1226,0
2021,Stockport 037C,E01005810,1560,1489,71
2021,Stockport 037D,E01005811,1300,1300,0
2021,Stockport 037E,E01005812,1206,1206,0
2021,Stockport 038A,E01005842,1581,1581,0
2021,Stockport 038B,E01005906,1436,1364,72
2021,Stockport 038C,E01005907,1348,1333,15
2021,Stockport 038D,E01005913,1419,1419,0
2021,Stockport 039A,E01005789,1671,1668,3
2021,Stockport 039B,E01005791,1569,1568,1
2021,Stockport 039C,E01005793,1525,1525,0
2021,Stockport 039D,E01005795,1365,1365,0
2021,Stockport 039E,E01005796,1247,1247,0
2021,Stockport 040A,E01005846,1714,1714,0
2021,Stockport 040B,E01005847,1577,1577,0
2021,Stockport 040C,E01005848,2083,2011,72
2021,Stockport 040D,E01005850,1806,1806,0
2021,Stockport 041A,E01005792,1531,1531,0
2021,Stockport 041B,E01005794,1269,1269,0
2021,Stockport 041C,E01005923,1498,1484,14
2021,Stockport 041D,E01005931,1394,1392,2
2021,Stockport 042A,E01005924,1305,1267,38
2021,Stockport 042B,E01005925,1435,1398,37
2021,Stockport 042C,E01005926,2242,2222,20
2021,Stockport 042D,E01005932,1280,1280,0
2021,Tameside 001A,E01006053,1947,1947,0
2021,Tameside 001B,E01006054,1807,1770,37
2021,Tameside 001C,E01006055,1505,1505,0
2021,Tameside 001D,E01006057,1529,1529,0
2021,Tameside 001E,E01006058,2078,2043,35
2021,Tameside 001F,E01006059,1447,1447,0
2021,Tameside 002A,E01005938,1567,1567,0
2021,Tameside 002B,E01005939,1271,1271,0
2021,Tameside 002C,E01005940,1400,1400,0
2021,Tameside 002D,E01005955,1633,1633,0
2021,Tameside 003A,E01006056,1250,1250,0
2021,Tameside 003B,E01006061,2479,2479,0
2021,Tameside 003C,E01006062,1989,1989,0
2021,Tameside 003D,E01006063,1383,1383,0
2021,Tameside 004A,E01005936,1516,1516,0
2021,Tameside 004B,E01005937,1707,1707,0
2021,Tameside 004C,E01005945,2043,1970,73
2021,Tameside 004D,E01005946,1587,1587,0
2021,Tameside 004E,E01005947,1839,1839,0
2021,Tameside 005A,E01005954,1496,1445,51
2021,Tameside 005B,E01005956,1376,1336,40
2021,Tameside 005C,E01005957,1561,1547,14
2021,Tameside 005D,E01005958,1607,1607,0
2021,Tameside 005E,E01005959,1952,1952,0
2021,Tameside 006A,E01005933,1574,1574,0
2021,Tameside 006B,E01005934,1507,1507,0
2021,Tameside 006C,E01005935,1465,1435,30
2021,Tameside 006D,E01005949,1652,1614,38
2021,Tameside 006E,E01005960,1746,1722,24
2021,Tameside 007A,E01005941,1884,1844,40
2021,Tameside 007B,E01005942,1661,1661,0
2021,Tameside 007C,E01005943,1817,1802,15
2021,Tameside 007D,E01005944,1853,1852,1
2021,Tameside 008A,E01006060,1510,1510,0
2021,Tameside 008B,E01006064,1728,1728,0
2021,Tameside 008C,E01006065,1460,1460,0
2021,Tameside 008D,E01006066,1415,1324,91
2021,Tameside 009A,E01006067,1875,1871,4
2021,Tameside 009B,E01006068,1559,1535,24
2021,Tameside 009C,E01006069,1740,1740,0
2021,Tameside 009D,E01006073,2045,2000,45
2021,Tameside 010A,E01005993,1350,1350,0
2021,Tameside 010B,E01005995,1372,1372,0
2021,Tameside 010C,E01005996,1948,1944,4
2021,Tameside 010D,E01005997,1536,1536,0
2021,Tameside 010E,E01006000,1787,1784,3
2021,Tameside 011A,E01005994,1507,1507,0
2021,Tameside 011B,E01005999,2190,2190,0
2021,Tameside 011C,E01006002,1370,1368,2
2021,Tameside 011D,E01006004,1524,1524,0
2021,Tameside 011E,E01006005,1395,1362,33
2021,Tameside 011F,E01006007,1551,1551,0
2021,Tameside 012A,E01005998,1882,1882,0
2021,Tameside 012B,E01006001,1546,1546,0
2021,Tameside 012C,E01006003,1530,1530,0
2021,Tameside 012D,E01006006,1426,1426,0
2021,Tameside 013A,E01005948,2314,2311,3
2021,Tameside 013B,E01005950,2175,2175,0
2021,Tameside 013C,E01005951,1857,1857,0
2021,Tameside 013E,E01005953,2297,2273,24
2021,Tameside 013F,E01033949,1190,1189,1
2021,Tameside 013G,E01033950,1371,1369,2
2021,Tameside 014A,E01005961,2962,2909,53
2021,Tameside 014B,E01005962,1419,1419,0
2021,Tameside 014C,E01005968,1376,1376,0
2021,Tameside 014D,E01005969,1299,1299,0
2021,Tameside 015A,E01006022,1936,1936,0
2021,Tameside 015B,E01006023,1577,1577,0
2021,Tameside 015C,E01006070,1398,1386,12
2021,Tameside 015D,E01006071,1710,1710,0
2021,Tameside 015E,E01006072,1615,1615,0
2021,Tameside 016A,E01006009,1329,1329,0
2021,Tameside 016B,E01006017,1398,1398,0
2021,Tameside 016C,E01006018,1316,1316,0
2021,Tameside 016D,E01006021,1366,1366,0
2021,Tameside 017A,E01006008,1386,1385,1
2021,Tameside 017B,E01006010,1403,1403,0
2021,Tameside 017C,E01006012,1961,1901,60
2021,Tameside 017D,E01006015,1347,1347,0
2021,Tameside 017E,E01006016,1947,1918,29
2021,Tameside 018A,E01006011,1708,1704,4
2021,Tameside 018B,E01006013,1307,1307,0
2021,Tameside 018C,E01006014,1282,1282,0
2021,Tameside 018D,E01006019,1503,1459,44
2021,Tameside 018E,E01006020,1637,1558,79
2021,Tameside 019A,E01005963,1161,1161,0
2021,Tameside 019B,E01005964,1522,1497,25
2021,Tameside 019C,E01005965,1733,1712,21
2021,Tameside 019D,E01005966,1578,1575,3
2021,Tameside 019E,E01005967,1424,1424,0
2021,Tameside 020A,E01006031,2255,2255,0
2021,Tameside 020B,E01006032,1528,1528,0
2021,Tameside 020C,E01006033,1768,1768,0
2021,Tameside 020D,E01006034,2133,2133,0
2021,Tameside 020E,E01006035,2147,2147,0
2021,Tameside 020F,E01006036,2152,2150,2
2021,Tameside 021A,E01005970,1413,1413,0
2021,Tameside 021B,E01005972,1720,1720,0
2021,Tameside 021C,E01005974,1692,1692,0
2021,Tameside 021D,E01005975,1546,1546,0
2021,Tameside 022A,E01006024,1765,1765,0
2021,Tameside 022B,E01006026,1527,1527,0
2021,Tameside 022C,E01006037,1601,1601,0
2021,Tameside 022D,E01006038,1586,1541,45
2021,Tameside 023A,E01006047,1326,1326,0
2021,Tameside 023B,E01006048,1595,1566,29
2021,Tameside 023C,E01006049,1545,1545,0
2021,Tameside 023D,E01006051,1628,1628,0
2021,Tameside 024A,E01005985,1554,1554,0
2021,Tameside 024B,E01005987,1518,1518,0
2021,Tameside 024C,E01005988,1599,1599,0
2021,Tameside 024D,E01005990,1373,1373,0
2021,Tameside 024E,E01005991,1496,1496,0
2021,Tameside 025A,E01005971,1354,1354,0
2021,Tameside 025B,E01005986,1245,1245,0
2021,Tameside 025C,E01005989,1206,1206,0
2021,Tameside 025D,E01005992,1210,1177,33
2021,Tameside 026A,E01005973,1367,1367,0
2021,Tameside 026B,E01005976,1482,1482,0
2021,Tameside 026C,E01005977,1450,1437,13
2021,Tameside 026D,E01005978,1335,1335,0
2021,Tameside 027A,E01006025,1917,1917,0
2021,Tameside 027B,E01006027,2343,2341,2
2021,Tameside 027C,E01006050,1841,1841,0
2021,Tameside 027D,E01006052,1580,1580,0
2021,Tameside 028A,E01006028,1776,1773,3
2021,Tameside 028B,E01006029,1934,1934,0
2021,Tameside 028C,E01006030,1869,1850,19
2021,Tameside 028D,E01006039,1352,1308,44
2021,Tameside 028E,E01006040,1891,1772,119
2021,Tameside 028F,E01006041,1721,1721,0
2021,Tameside 029A,E01005979,1584,1584,0
2021,Tameside 029B,E01005980,1449,1408,41
2021,Tameside 029C,E01005981,1647,1642,5
2021,Tameside 029D,E01005982,1326,1321,5
2021,Tameside 029E,E01005983,1507,1507,0
2021,Tameside 029F,E01005984,1604,1604,0
2021,Tameside 030A,E01006042,1697,1697,0
2021,Tameside 030B,E01006043,1437,1437,0
2021,Tameside 030C,E01006044,1523,1508,15
2021,Tameside 030D,E01006045,1253,1253,0
2021,Tameside 030E,E01006046,1528,1480,48
2021,Trafford 001A,E01006109,1147,1107,40
2021,Trafford 001B,E01006110,1876,1866,10
2021,Trafford 001C,E01006111,1775,1775,0
2021,Trafford 001D,E01006112,2049,2049,0
2021,Trafford 001F,E01006188,1990,1976,14
2021,Trafford 001G,E01034000,1235,1235,0
2021,Trafford 001H,E01034001,1647,1647,0
2021,Trafford 002A,E01006116,1328,1328,0
2021,Trafford 002B,E01006117,1704,1704,0
2021,Trafford 002C,E01006118,1462,1462,0
2021,Trafford 002D,E01006119,1639,1639,0
2021,Trafford 002E,E01006121,1448,1436,12
2021,Trafford 003A,E01006141,1791,1791,0
2021,Trafford 003B,E01006186,2160,2160,0
2021,Trafford 003C,E01006187,2599,2599,0
2021,Trafford 003D,E01006189,2328,2324,4
2021,Trafford 004A,E01006113,1619,1619,0
2021,Trafford 004B,E01006114,1693,1689,4
2021,Trafford 004C,E01006115,1518,1498,20
2021,Trafford 004D,E01006145,2051,2050,1
2021,Trafford 004E,E01006146,1791,1791,0
2021,Trafford 005A,E01006122,1785,1785,0
2021,Trafford 005B,E01006123,1671,1631,40
2021,Trafford 005C,E01006124,1479,1479,0
2021,Trafford 005D,E01006128,1929,1858,71
2021,Trafford 005E,E01006131,1529,1529,0
2021,Trafford 006A,E01006155,1749,1749,0
2021,Trafford 006B,E01006157,1701,1701,0
2021,Trafford 006C,E01006159,1875,1875,0
2021,Trafford 006D,E01006182,1606,1606,0
2021,Trafford 006E,E01006183,1724,1724,0
2021,Trafford 007A,E01006125,1511,1511,0
2021,Trafford 007B,E01006126,1837,1793,44
2021,Trafford 007C,E01006127,1545,1545,0
2021,Trafford 007D,E01006130,1760,1759,1
2021,Trafford 007E,E01006132,1539,1538,1
2021,Trafford 008A,E01006156,1674,1674,0
2021,Trafford 008B,E01006158,1749,1749,0
2021,Trafford 008C,E01006179,1802,1785,17
2021,Trafford 008D,E01006184,1699,1699,0
2021,Trafford 009A,E01006198,1462,1426,36
2021,Trafford 009B,E01006199,1537,1536,1
2021,Trafford 009C,E01006200,1481,1403,78
2021,Trafford 009D,E01006201,1467,1458,9
2021,Trafford 009E,E01006202,1299,1299,0
2021,Trafford 010A,E01006120,1430,1406,24
2021,Trafford 010B,E01006129,1384,1368,16
2021,Trafford 010C,E01006133,1416,1414,2
2021,Trafford 010D,E01006197,1478,1474,4
2021,Trafford 010E,E01006203,1332,1292,40
2021,Trafford 011A,E01006142,1716,1716,0
2021,Trafford 011B,E01006143,1668,1668,0
2021,Trafford 011C,E01006144,1386,1380,6
2021,Trafford 011D,E01006180,1840,1838,2
2021,Trafford 011E,E01006181,1746,1744,2
2021,Trafford 012A,E01006147,1442,1442,0
2021,Trafford 012B,E01006149,1578,1577,1
2021,Trafford 012C,E01006150,1919,1826,93
2021,Trafford 012D,E01006154,1602,1601,1
2021,Trafford 012E,E01006165,2007,2007,0
2021,Trafford 013A,E01006166,1640,1640,0
2021,Trafford 013B,E01006169,1647,1647,0
2021,Trafford 013C,E01006170,1602,1602,0
2021,Trafford 013D,E01006171,1755,1755,0
2021,Trafford 014A,E01006098,1337,1306,31
2021,Trafford 014B,E01006099,1324,1324,0
2021,Trafford 014C,E01006164,1762,1762,0
2021,Trafford 014D,E01006174,1788,1787,1
2021,Trafford 014E,E01006178,1813,1813,0
2021,Trafford 015A,E01006097,1786,1749,37
2021,Trafford 015B,E01006160,2140,2140,0
2021,Trafford 015C,E01006161,2158,2115,43
2021,Trafford 015D,E01006162,1622,1617,5
2021,Trafford 015E,E01006163,1832,1832,0
2021,Trafford 016A,E01006148,1698,1611,87
2021,Trafford 016B,E01006151,1582,1562,20
2021,Trafford 016C,E01006152,1639,1639,0
2021,Trafford 016D,E01006153,1600,1600,0
2021,Trafford 016E,E01006172,1540,1526,14
2021,Trafford 017A,E01006104,1687,1675,12
2021,Trafford 017B,E01006105,1766,1766,0
2021,Trafford 017C,E01006106,1474,1413,61
2021,Trafford 017D,E01006107,1594,1594,0
2021,Trafford 017E,E01006108,1668,1668,0
2021,Trafford 018A,E01006102,1404,1404,0
2021,Trafford 018B,E01006173,1550,1550,0
2021,Trafford 018C,E01006175,1776,1776,0
2021,Trafford 018D,E01006176,1733,1722,11
2021,Trafford 018E,E01006177,1653,1653,0
2021,Trafford 019A,E01006091,2970,2970,0
2021,Trafford 019B,E01006092,1331,1331,0
2021,Trafford 019C,E01006095,1659,1659,0
2021,Trafford 019D,E01006167,1579,1570,9
2021,Trafford 019E,E01006168,1812,1812,0
2021,Trafford 020A,E01006090,2300,2231,69
2021,Trafford 020B,E01006094,1603,1603,0
2021,Trafford 020C,E01006096,1610,1610,0
2021,Trafford 020D,E01006100,1488,1488,0
2021,Trafford 020E,E01006103,1693,1693,0
2021,Trafford 021A,E01006101,1495,1495,0
2021,Trafford 021B,E01006190,1687,1654,33
2021,Trafford 021C,E01006195,1795,1795,0
2021,Trafford 021D,E01006196,1700,1700,0
2021,Trafford 021E,E01006210,1609,1609,0
2021,Trafford 022A,E01006204,1620,1618,2
2021,Trafford 022B,E01006206,1869,1869,0
2021,Trafford 022C,E01006207,1750,1694,56
2021,Trafford 022D,E01006208,1551,1551,0
2021,Trafford 022E,E01006211,1612,1609,3
2021,Trafford 023A,E01006093,1527,1527,0
2021,Trafford 023B,E01006191,1708,1708,0
2021,Trafford 023C,E01006192,1517,1516,1
2021,Trafford 023D,E01006205,1342,1342,0
2021,Trafford 023E,E01006209,1643,1643,0
2021,Trafford 024A,E01006078,2122,2122,0
2021,Trafford 024B,E01006080,1968,1933,35
2021,Trafford 024C,E01006089,2014,2014,0
2021,Trafford 024D,E01006193,1570,1560,10
2021,Trafford 024E,E01006194,2431,2431,0
2021,Trafford 025A,E01006074,1643,1596,47
2021,Trafford 025B,E01006075,2146,2143,3
2021,Trafford 025C,E01006076,1675,1652,23
2021,Trafford 025D,E01006079,2598,2598,0
2021,Trafford 025E,E01006087,1452,1452,0
2021,Trafford 026A,E01006083,1279,1279,0
2021,Trafford 026B,E01006084,1742,1742,0
2021,Trafford 026C,E01006088,1630,1630,0
2021,Trafford 026D,E01006139,1805,1805,0
2021,Trafford 026E,E01006140,1697,1697,0
2021,Trafford 027A,E01006077,1643,1643,0
2021,Trafford 027B,E01006081,1385,1365,20
2021,Trafford 027C,E01006082,1498,1498,0
2021,Trafford 027D,E01006085,1542,1486,56
2021,Trafford 027E,E01006086,1688,1652,36
2021,Trafford 028A,E01006134,1493,1491,2
2021,Trafford 028B,E01006135,1767,1705,62
2021,Trafford 028C,E01006136,1703,1703,0
2021,Trafford 028D,E01006137,1421,1421,0
2021,Trafford 028E,E01006138,1893,1893,0
2021,Wigan 001A,E01006315,1503,1503,0
2021,Wigan 001B,E01006316,2002,2002,0
2021,Wigan 001C,E01006317,1551,1551,0
2021,Wigan 001D,E01006319,1573,1573,0
2021,Wigan 002A,E01006229,1379,1371,8
2021,Wigan 002B,E01006230,2122,2122,0
2021,Wigan 002C,E01006233,1404,1363,41
2021,Wigan 002D,E01006237,1922,1922,0
2021,Wigan 002E,E01006238,1509,1509,0
2021,Wigan 003A,E01006259,1316,1316,0
2021,Wigan 003B,E01006312,1370,1370,0
2021,Wigan 003C,E01006313,1458,1458,0
2021,Wigan 003D,E01006314,1724,1724,0
2021,Wigan 003E,E01006318,1426,1426,0
2021,Wigan 003F,E01006320,1279,1279,0
2021,Wigan 003G,E01006321,1601,1601,0
2021,Wigan 004A,E01006231,1467,1462,5
2021,Wigan 004B,E01006232,1989,1943,46
2021,Wigan 004C,E01006234,1145,1145,0
2021,Wigan 004D,E01006235,1528,1528,0
2021,Wigan 005A,E01006253,1523,1523,0
2021,Wigan 005B,E01006254,1574,1574,0
2021,Wigan 005C,E01006255,1492,1486,6
2021,Wigan 005D,E01006256,1709,1709,0
2021,Wigan 005E,E01006260,1517,1517,0
2021,Wigan 006A,E01006370,1886,1882,4
2021,Wigan 006B,E01006372,1609,1580,29
2021,Wigan 006C,E01006373,1459,1456,3
2021,Wigan 006D,E01006374,1463,1463,0
2021,Wigan 006E,E01006390,1613,1613,0
2021,Wigan 007A,E01006236,1573,1573,0
2021,Wigan 007B,E01006388,1836,1793,43
2021,Wigan 007C,E01006389,1318,1318,0
2021,Wigan 007D,E01006391,1530,1530,0
2021,Wigan 008A,E01006257,1207,1194,13
2021,Wigan 008B,E01006258,1601,1555,46
2021,Wigan 008C,E01006369,2032,2010,22
2021,Wigan 008D,E01006371,1476,1476,0
2021,Wigan 008E,E01006375,1683,1679,4
2021,Wigan 009A,E01006306,1479,1479,0
2021,Wigan 009B,E01006307,1374,1374,0
2021,Wigan 009C,E01006386,1587,1519,68
2021,Wigan 009D,E01006387,1316,1280,36
2021,Wigan 009E,E01006392,1476,1476,0
2021,Wigan 010A,E01006350,1858,1815,43
2021,Wigan 010B,E01006351,2020,2020,0
2021,Wigan 010C,E01006357,1830,1788,42
2021,Wigan 010D,E01006360,1680,1680,0
2021,Wigan 010E,E01006361,1661,1661,0
2021,Wigan 011A,E01006356,1434,1434,0
2021,Wigan 011B,E01006396,1480,1427,53
2021,Wigan 011C,E01006397,1080,1080,0
2021,Wigan 011D,E01006398,1007,1007,0
2021,Wigan 011E,E01006399,1603,1603,0
2021,Wigan 012A,E01006305,1710,1710,0
2021,Wigan 012B,E01006308,1620,1612,8
2021,Wigan 012C,E01006309,1669,1642,27
2021,Wigan 012D,E01006310,1589,1589,0
2021,Wigan 012E,E01006311,1534,1534,0
2021,Wigan 013A,E01006269,1737,1735,2
2021,Wigan 013B,E01006271,1682,1642,40
2021,Wigan 013C,E01006272,1635,1598,37
2021,Wigan 013D,E01006273,1482,1482,0
2021,Wigan 013E,E01006276,2154,2154,0
2021,Wigan 014A,E01006353,1458,1458,0
2021,Wigan 014B,E01006354,1442,1392,50
2021,Wigan 014C,E01006355,1473,1473,0
2021,Wigan 014D,E01006358,2133,2088,45
2021,Wigan 014E,E01006359,1384,1384,0
2021,Wigan 015A,E01006349,2037,2037,0
2021,Wigan 015B,E01006352,2034,1978,56
2021,Wigan 015C,E01006404,1778,1744,34
2021,Wigan 015D,E01006405,1747,1693,54
2021,Wigan 015E,E01006411,1433,1433,0
2021,Wigan 016A,E01006270,1442,1392,50
2021,Wigan 016B,E01006274,1531,1531,0
2021,Wigan 016C,E01006275,1572,1572,0
2021,Wigan 016D,E01006277,1877,1877,0
2021,Wigan 016E,E01006286,1559,1520,39
2021,Wigan 017A,E01006239,2082,2082,0
2021,Wigan 017B,E01006240,1573,1573,0
2021,Wigan 017C,E01006241,2539,2486,53
2021,Wigan 017D,E01006287,1143,1143,0
2021,Wigan 017E,E01006289,1689,1688,1
2021,Wigan 018A,E01006362,1634,1634,0
2021,Wigan 018B,E01006363,1516,1516,0
2021,Wigan 018C,E01006364,1831,1831,0
2021,Wigan 018D,E01006365,2266,2266,0
2021,Wigan 018E,E01006366,1850,1849,1
2021,Wigan 018F,E01006367,1783,1783,0
2021,Wigan 018G,E01006368,1884,1884,0
2021,Wigan 019A,E01006278,1634,1632,2
2021,Wigan 019B,E01006279,1577,1576,1
2021,Wigan 019C,E01006280,1455,1431,24
2021,Wigan 019D,E01006281,1937,1935,2
2021,Wigan 019E,E01006285,1916,1916,0
2021,Wigan 020A,E01006406,1377,1377,0
2021,Wigan 020B,E01006407,1453,1453,0
2021,Wigan 020C,E01006408,1749,1749,0
2021,Wigan 020D,E01006409,1298,1298,0
2021,Wigan 020E,E01006410,1272,1272,0
2021,Wigan 021A,E01006393,1382,1382,0
2021,Wigan 021B,E01006394,1540,1540,0
2021,Wigan 021C,E01006395,2628,2628,0
2021,Wigan 021D,E01006400,1995,1995,0
2021,Wigan 021E,E01006401,1354,1354,0
2021,Wigan 021F,E01006402,1128,1128,0
2021,Wigan 021G,E01006403,1626,1626,0
2021,Wigan 022A,E01006290,1389,1389,0
2021,Wigan 022B,E01006291,1463,1463,0
2021,Wigan 022C,E01006292,1500,1457,43
2021,Wigan 022D,E01006293,1618,1603,15
2021,Wigan 023A,E01006242,1931,1896,35
2021,Wigan 023B,E01006243,2120,2120,0
2021,Wigan 023C,E01006244,1676,1616,60
2021,Wigan 023D,E01006245,2629,2629,0
2021,Wigan 024A,E01006213,1521,1521,0
2021,Wigan 024B,E01006215,1712,1653,59
2021,Wigan 024C,E01006217,2378,2361,17
2021,Wigan 024D,E01006218,2432,2432,0
2021,Wigan 024E,E01006219,1184,1184,0
2021,Wigan 025A,E01006288,1824,1824,0
2021,Wigan 025B,E01006294,1940,1940,0
2021,Wigan 025C,E01006295,1568,1568,0
2021,Wigan 025D,E01006377,1557,1557,0
2021,Wigan 025E,E01006378,1303,1303,0
2021,Wigan 026A,E01006212,1392,1392,0
2021,Wigan 026B,E01006214,1379,1377,2
2021,Wigan 026C,E01006216,2190,2190,0
2021,Wigan 026D,E01006322,2086,2086,0
2021,Wigan 026E,E01006329,1637,1136,501
2021,Wigan 027A,E01006282,1854,1820,34
2021,Wigan 027B,E01006283,1584,1584,0
2021,Wigan 027C,E01006284,1577,1577,0
2021,Wigan 027D,E01006336,1656,1613,43
2021,Wigan 027E,E01006337,1496,1496,0
2021,Wigan 028A,E01006376,1771,1771,0
2021,Wigan 028B,E01006381,2050,2050,0
2021,Wigan 028C,E01006382,1257,1257,0
2021,Wigan 028D,E01006383,1609,1609,0
2021,Wigan 028E,E01006384,1321,1321,0
2021,Wigan 029A,E01006250,2138,2138,0
2021,Wigan 029B,E01006251,1544,1544,0
2021,Wigan 029C,E01006379,1581,1581,0
2021,Wigan 029D,E01006380,2731,2731,0
2021,Wigan 029E,E01006385,1445,1445,0
2021,Wigan 030A,E01006328,1527,1518,9
2021,Wigan 030B,E01006333,2086,2063,23
2021,Wigan 030C,E01006334,2076,2072,4
2021,Wigan 030D,E01006338,1668,1668,0
2021,Wigan 031A,E01006248,2280,2280,0
2021,Wigan 031B,E01006249,1655,1655,0
2021,Wigan 031C,E01006330,1538,1538,0
2021,Wigan 031D,E01006331,1517,1517,0
2021,Wigan 031E,E01006332,2014,1815,199
2021,Wigan 032A,E01006262,1710,1710,0
2021,Wigan 032B,E01006263,1490,1490,0
2021,Wigan 032C,E01006266,1373,1373,0
2021,Wigan 032D,E01006267,1620,1620,0
2021,Wigan 032E,E01006268,1637,1637,0
2021,Wigan 033A,E01006323,1552,1514,38
2021,Wigan 033B,E01006324,1291,1291,0
2021,Wigan 033C,E01006325,1505,1505,0
2021,Wigan 033D,E01006326,1411,1397,14
2021,Wigan 033E,E01006327,2562,2493,69
2021,Wigan 034A,E01006246,1535,1535,0
2021,Wigan 034B,E01006247,1282,1282,0
2021,Wigan 034C,E01006252,1399,1399,0
2021,Wigan 034D,E01006297,1595,1593,2
2021,Wigan 034E,E01006335,1578,1556,22
2021,Wigan 035A,E01006220,1742,1692,50
2021,Wigan 035B,E01006221,1560,1560,0
2021,Wigan 035C,E01006222,1556,1556,0
2021,Wigan 035D,E01006224,1433,1433,0
2021,Wigan 035E,E01006226,1714,1714,0
2021,Wigan 036A,E01006223,1586,1541,45
2021,Wigan 036B,E01006225,1507,1483,24
2021,Wigan 036C,E01006261,1487,1436,51
2021,Wigan 036D,E01006264,1230,1230,0
2021,Wigan 036E,E01006265,1396,1396,0
2021,Wigan 037A,E01006296,1503,1503,0
2021,Wigan 037B,E01006298,1424,1424,0
2021,Wigan 037C,E01006299,1935,1935,0
2021,Wigan 037D,E01006300,1359,1359,0
2021,Wigan 037E,E01006301,1484,1484,0
2021,Wigan 038A,E01006227,1581,1581,0
2021,Wigan 038B,E01006228,1628,1628,0
2021,Wigan 038C,E01006342,1556,1551,5
2021,Wigan 038D,E01006344,1440,1413,27
2021,Wigan 038E,E01006346,2062,2061,1
2021,Wigan 039A,E01006339,1255,1255,0
2021,Wigan 039B,E01006340,1888,1888,0
2021,Wigan 039C,E01006343,1612,1612,0
2021,Wigan 039D,E01006345,1559,1535,24
2021,Wigan 039E,E01006348,2642,2617,25
2021,Wigan 040A,E01006302,1835,1835,0
2021,Wigan 040B,E01006303,1625,1625,0
2021,Wigan 040C,E01006304,1521,1521,0
2021,Wigan 040D,E01006341,1664,1664,0
2021,Wigan 040E,E01006347,1518,1518,0
2021,Birmingham 001A,E01009417,1612,1608,4
2021,Birmingham 001B,E01009418,1586,1547,39
2021,Birmingham 001C,E01009419,1464,1464,0
2021,Birmingham 001D,E01009433,1789,1789,0
2021,Birmingham 002A,E01009415,1749,1731,18
2021,Birmingham 002B,E01009422,2001,1981,20
2021,Birmingham 002C,E01009423,1672,1672,0
2021,Birmingham 002D,E01009425,1721,1721,0
2021,Birmingham 003A,E01009416,2795,2795,0
2021,Birmingham 003B,E01009420,1702,1702,0
2021,Birmingham 003C,E01009426,1478,1478,0
2021,Birmingham 003D,E01009429,1499,1499,0
2021,Birmingham 003E,E01009431,1689,1689,0
2021,Birmingham 004A,E01009421,1715,1715,0
2021,Birmingham 004B,E01009424,1582,1531,51
2021,Birmingham 004C,E01009427,1489,1489,0
2021,Birmingham 004D,E01009428,1681,1681,0
2021,Birmingham 004E,E01009430,1724,1724,0
2021,Birmingham 004F,E01009468,1495,1449,46
2021,Birmingham 005A,E01009445,1892,1892,0
2021,Birmingham 005B,E01009446,2488,2454,34
2021,Birmingham 005C,E01009447,1651,1651,0
2021,Birmingham 005D,E01009448,1651,1651,0
2021,Birmingham 005E,E01009452,1705,1705,0
2021,Birmingham 005F,E01009455,1295,1293,2
2021,Birmingham 006A,E01009432,1499,1499,0
2021,Birmingham 006B,E01009435,1718,1717,1
2021,Birmingham 006C,E01009437,1793,1784,9
2021,Birmingham 006D,E01009444,1499,1499,0
2021,Birmingham 006E,E01009454,1424,1424,0
2021,Birmingham 007A,E01009221,1527,1527,0
2021,Birmingham 007B,E01009464,1411,1411,0
2021,Birmingham 007C,E01009465,1434,1434,0
2021,Birmingham 007D,E01009467,1564,1564,0
2021,Birmingham 008A,E01009220,1557,1557,0
2021,Birmingham 008B,E01009222,1522,1522,0
2021,Birmingham 008C,E01009224,1408,1408,0
2021,Birmingham 008D,E01009233,1623,1623,0
2021,Birmingham 009A,E01009449,2157,2138,19
2021,Birmingham 009B,E01009451,1434,1434,0
2021,Birmingham 009C,E01009453,1373,1373,0
2021,Birmingham 009D,E01009466,1691,1614,77
2021,Birmingham 009E,E01009471,1819,1660,159
2021,Birmingham 010A,E01009135,1406,1351,55
2021,Birmingham 010B,E01009469,1461,1461,0
2021,Birmingham 010C,E01009470,1440,1440,0
2021,Birmingham 010D,E01009472,1670,1670,0
2021,Birmingham 010E,E01009473,1563,1554,9
2021,Birmingham 010F,E01009474,1565,1550,15
2021,Birmingham 011A,E01009127,1544,1544,0
2021,Birmingham 011B,E01009128,1376,1376,0
2021,Birmingham 011C,E01009130,1504,1504,0
2021,Birmingham 011D,E01009131,1471,1471,0
2021,Birmingham 011E,E01009133,1485,1485,0
2021,Birmingham 011F,E01009134,1683,1658,25
2021,Birmingham 011G,E01009137,1606,1606,0
2021,Birmingham 012A,E01009434,1652,1652,0
2021,Birmingham 012B,E01009436,1382,1382,0
2021,Birmingham 012C,E01009438,1355,1355,0
2021,Birmingham 012D,E01009440,1576,1503,73
2021,Birmingham 012E,E01009450,1605,1605,0
2021,Birmingham 013A,E01009223,1591,1591,0
2021,Birmingham 013B,E01009225,1631,1601,30
2021,Birmingham 013C,E01009227,1659,1659,0
2021,Birmingham 013D,E01009228,1558,1558,0
2021,Birmingham 014B,E01009122,1636,1604,32
2021,Birmingham 014C,E01009129,1600,1600,0
2021,Birmingham 014D,E01009132,1547,1540,7
2021,Birmingham 014E,E01009136,1759,1722,37
2021,Birmingham 014F,E01034913,1160,1151,9
2021,Birmingham 014G,E01034914,1901,1897,4
2021,Birmingham 015A,E01009457,1506,1506,0
2021,Birmingham 015B,E01009459,1591,1577,14
2021,Birmingham 015C,E01009461,1305,1304,1
2021,Birmingham 015D,E01009463,1561,1465,96
2021,Birmingham 016A,E01009235,1662,1662,0
2021,Birmingham 016B,E01009243,1819,1819,0
2021,Birmingham 016C,E01009245,1472,1472,0
2021,Birmingham 016D,E01009246,1557,1556,1
2021,Birmingham 016E,E01009247,1557,1557,0
2021,Birmingham 017A,E01009226,1458,1450,8
2021,Birmingham 017B,E01009229,1590,1590,0
2021,Birmingham 017C,E01009230,1654,1654,0
2021,Birmingham 017D,E01009231,1936,1936,0
2021,Birmingham 018A,E01009001,1679,1613,66
2021,Birmingham 018B,E01009003,1765,1539,226
2021,Birmingham 018C,E01009456,1718,1695,23
2021,Birmingham 018D,E01009458,1385,1385,0
2021,Birmingham 018E,E01009460,1585,1560,25
2021,Birmingham 018F,E01009462,1583,1570,13
2021,Birmingham 019A,E01009234,1465,1465,0
2021,Birmingham 019B,E01009236,1553,1553,0
2021,Birmingham 019C,E01009244,1885,1885,0
2021,Birmingham 019D,E01009248,1759,1759,0
2021,Birmingham 020A,E01009403,1578,1578,0
2021,Birmingham 020B,E01009404,1593,1593,0
2021,Birmingham 020C,E01009405,1487,1487,0
2021,Birmingham 020D,E01009406,1750,1736,14
2021,Birmingham 020E,E01009407,1749,1723,26
2021,Birmingham 021A,E01009439,1448,1437,11
2021,Birmingham 021B,E01009441,1476,1475,1
2021,Birmingham 021C,E01009442,1461,1461,0
2021,Birmingham 021D,E01009443,1213,1213,0
2021,Birmingham 022A,E01009123,1625,1625,0
2021,Birmingham 022B,E01009124,2097,2097,0
2021,Birmingham 022C,E01009125,2037,1971,66
2021,Birmingham 022D,E01009232,1561,1488,73
2021,Birmingham 023A,E01009002,2050,2049,1
2021,Birmingham 023C,E01009006,1556,1556,0
2021,Birmingham 023D,E01009007,1820,1820,0
2021,Birmingham 023G,E01034915,1871,1871,0
2021,Birmingham 023H,E01034916,1495,1478,17
2021,Birmingham 024A,E01009237,1472,1472,0
2021,Birmingham 024B,E01009238,1756,1742,14
2021,Birmingham 024C,E01009240,1524,1524,0
2021,Birmingham 024D,E01009241,1781,1777,4
2021,Birmingham 024E,E01009242,2072,2072,0
2021,Birmingham 025A,E01009005,1754,1704,50
2021,Birmingham 025B,E01009009,1490,1486,4
2021,Birmingham 025C,E01009098,2112,2110,2
2021,Birmingham 025D,E01009100,1934,1908,26
2021,Birmingham 025E,E01009105,1796,1796,0
2021,Birmingham 026A,E01009126,1487,1487,0
2021,Birmingham 026B,E01009408,1777,1775,2
2021,Birmingham 026C,E01009409,1847,1840,7
2021,Birmingham 026D,E01009410,1919,1898,21
2021,Birmingham 029A,E01009096,1675,1675,0
2021,Birmingham 029B,E01009097,2048,1975,73
2021,Birmingham 029C,E01009099,1759,1759,0
2021,Birmingham 029D,E01009101,1521,1470,51
2021,Birmingham 029E,E01009103,1575,1575,0
2021,Birmingham 029F,E01009106,1358,1358,0
2021,Birmingham 030A,E01008915,1781,1781,0
2021,Birmingham 030B,E01009411,1899,1897,2
2021,Birmingham 030C,E01009412,1788,1773,15
2021,Birmingham 030D,E01009413,1812,1785,27
2021,Birmingham 030E,E01009414,2358,2349,9
2021,Birmingham 031A,E01008998,1914,1914,0
2021,Birmingham 031B,E01008999,1586,1566,20
2021,Birmingham 031C,E01009000,1738,1641,97
2021,Birmingham 031D,E01009013,2017,1931,86
2021,Birmingham 031E,E01009400,1687,1638,49
2021,Birmingham 031F,E01009401,1854,1832,22
2021,Birmingham 031H,E01033630,1227,1187,40
2021,Birmingham 031I,E01033646,1829,1729,100
2021,Birmingham 032A,E01009049,1641,1633,8
2021,Birmingham 032B,E01009056,2250,2201,49
2021,Birmingham 032C,E01009263,1631,1572,59
2021,Birmingham 032D,E01009264,1832,1190,642
2021,Birmingham 032E,E01009265,1795,1733,62
2021,Birmingham 033A,E01009051,1815,1813,2
2021,Birmingham 033B,E01009053,1628,1625,3
2021,Birmingham 033C,E01009054,1641,1636,5
2021,Birmingham 033D,E01009058,1975,1975,0
2021,Birmingham 033E,E01009061,1868,1868,0
2021,Birmingham 033F,E01009239,1474,1381,93
2021,Birmingham 034A,E01009266,1780,1778,2
2021,Birmingham 034B,E01009269,1473,1473,0
2021,Birmingham 034C,E01009270,2009,2008,1
2021,Birmingham 034D,E01009271,1621,1621,0
2021,Birmingham 034E,E01009273,1587,1587,0
2021,Birmingham 035A,E01009050,2265,2265,0
2021,Birmingham 035D,E01009057,1984,1959,25
2021,Birmingham 035E,E01009059,1794,1794,0
2021,Birmingham 035F,E01009060,1753,1747,6
2021,Birmingham 035H,E01034917,1672,1672,0
2021,Birmingham 035I,E01034918,1738,1724,14
2021,Birmingham 036A,E01009268,1471,1469,2
2021,Birmingham 036B,E01009272,1394,1394,0
2021,Birmingham 036C,E01009274,2066,2066,0
2021,Birmingham 036D,E01009349,1665,1664,1
2021,Birmingham 036E,E01009351,1723,1723,0
2021,Birmingham 036F,E01009354,1559,1476,83
2021,Birmingham 037A,E01008899,1295,1256,39
2021,Birmingham 037C,E01008901,1809,1809,0
2021,Birmingham 037E,E01008916,1754,1713,41
2021,Birmingham 037G,E01034919,1661,1661,0
2021,Birmingham 037H,E01034920,1884,1874,10
2021,Birmingham 039A,E01009275,1789,1789,0
2021,Birmingham 039B,E01009350,1632,1630,2
2021,Birmingham 039C,E01009352,1809,1809,0
2021,Birmingham 039D,E01009353,1711,1711,0
2021,Birmingham 039E,E01009355,1434,1432,2
2021,Birmingham 039I,E01034921,1426,1426,0
2021,Birmingham 039J,E01034922,1600,1598,2
2021,Birmingham 040A,E01008905,1946,1946,0
2021,Birmingham 040B,E01008907,1804,1801,3
2021,Birmingham 040C,E01009047,1798,1779,19
2021,Birmingham 040D,E01009048,2048,1986,62
2021,Birmingham 040E,E01009062,1855,1847,8
2021,Birmingham 041D,E01008909,2124,2122,2
2021,Birmingham 041H,E01034923,1759,1744,15
2021,Birmingham 041I,E01034924,1558,1558,0
2021,Birmingham 041J,E01034925,1689,1689,0
2021,Birmingham 041K,E01034926,1541,1526,15
2021,Birmingham 042A,E01009084,1987,1987,0
2021,Birmingham 042B,E01009085,2098,2098,0
2021,Birmingham 042C,E01009087,1792,1792,0
2021,Birmingham 042D,E01009089,1791,1791,0
2021,Birmingham 042E,E01009090,2150,2148,2
2021,Birmingham 043A,E01009201,1951,1950,1
2021,Birmingham 043B,E01009202,1784,1782,2
2021,Birmingham 043D,E01034927,1770,1770,0
2021,Birmingham 043E,E01034928,1505,1505,0
2021,Birmingham 044A,E01009082,1514,1514,0
2021,Birmingham 044B,E01009086,2211,2142,69
2021,Birmingham 044C,E01009480,2092,2092,0
2021,Birmingham 044D,E01009481,2752,2747,5
2021,Birmingham 044E,E01009486,2229,2190,39
2021,Birmingham 044F,E01009487,2196,2196,0
2021,Birmingham 045A,E01009088,1593,1593,0
2021,Birmingham 045B,E01009091,1677,1655,22
2021,Birmingham 045C,E01009305,1676,1676,0
2021,Birmingham 045D,E01009307,1559,1559,0
2021,Birmingham 045E,E01009309,1833,1800,33
2021,Birmingham 046A,E01009304,1849,1849,0
2021,Birmingham 046B,E01009306,1684,1646,38
2021,Birmingham 046C,E01009308,1895,1895,0
2021,Birmingham 046D,E01009310,1997,1989,8
2021,Birmingham 047A,E01009348,2097,2052,45
2021,Birmingham 047B,E01009358,2248,2215,33
2021,Birmingham 047C,E01009359,2067,2065,2
2021,Birmingham 047D,E01009360,2785,2741,44
2021,Birmingham 047E,E01009361,2189,2155,34
2021,Birmingham 048A,E01009478,2115,2110,5
2021,Birmingham 048B,E01009479,2236,2220,16
2021,Birmingham 048C,E01009482,1745,1745,0
2021,Birmingham 048D,E01009484,1811,1808,3
2021,Birmingham 048E,E01009485,2050,2047,3
2021,Birmingham 049A,E01008906,1987,1987,0
2021,Birmingham 049B,E01008911,1943,1943,0
2021,Birmingham 049D,E01009347,1581,1562,19
2021,Birmingham 049E,E01033559,1482,1482,0
2021,Birmingham 049F,E01033638,1968,1963,5
2021,Birmingham 050A,E01008910,1755,1524,231
2021,Birmingham 050B,E01008913,2257,2257,0
2021,Birmingham 050E,E01033561,2592,999,1593
2021,Birmingham 050F,E01033617,5671,1339,4332
2021,Birmingham 050G,E01034929,1584,1582,2
2021,Birmingham 050H,E01034930,2226,1122,1104
2021,Birmingham 051B,E01009483,2068,2065,3
2021,Birmingham 051C,E01009488,2560,2547,13
2021,Birmingham 051D,E01009489,2118,2098,20
2021,Birmingham 051E,E01009491,2201,2201,0
2021,Birmingham 051F,E01034931,1917,1917,0
2021,Birmingham 051G,E01034932,1528,1465,63
2021,Birmingham 052B,E01009192,2777,2777,0
2021,Birmingham 052D,E01009199,1439,1433,6
2021,Birmingham 052E,E01009204,2168,2113,55
2021,Birmingham 052G,E01034933,1499,1497,2
2021,Birmingham 052H,E01034934,1639,1639,0
2021,Birmingham 053A,E01009151,2147,2147,0
2021,Birmingham 053B,E01009152,1942,1942,0
2021,Birmingham 053C,E01009153,2103,2089,14
2021,Birmingham 053D,E01009345,2098,1483,615
2021,Birmingham 053E,E01009346,1736,1736,0
2021,Birmingham 054A,E01009092,1762,1762,0
2021,Birmingham 054B,E01009093,1731,1731,0
2021,Birmingham 054C,E01009094,1611,1606,5
2021,Birmingham 054D,E01009298,1632,1632,0
2021,Birmingham 054E,E01009311,1617,1617,0
2021,Birmingham 054F,E01009511,1684,1682,2
2021,Birmingham 055A,E01009475,2325,2325,0
2021,Birmingham 055B,E01009476,2101,2061,40
2021,Birmingham 055C,E01009477,1883,1883,0
2021,Birmingham 055D,E01009490,2161,2161,0
2021,Birmingham 055E,E01009492,2025,2025,0
2021,Birmingham 056A,E01009095,1841,1841,0
2021,Birmingham 056B,E01009507,1621,1594,27
2021,Birmingham 056C,E01009508,1647,1642,5
2021,Birmingham 056D,E01009509,2053,2053,0
2021,Birmingham 056E,E01009510,1751,1705,46
2021,Birmingham 057A,E01009297,1820,1820,0
2021,Birmingham 057B,E01009299,1582,1582,0
2021,Birmingham 057C,E01009300,1937,1937,0
2021,Birmingham 057D,E01009301,1671,1671,0
2021,Birmingham 057E,E01009303,1507,1507,0
2021,Birmingham 058A,E01009195,2759,2759,0
2021,Birmingham 058C,E01009197,1922,1922,0
2021,Birmingham 058F,E01033649,2100,2100,0
2021,Birmingham 058G,E01034935,3407,3370,37
2021,Birmingham 060A,E01009138,2216,2216,0
2021,Birmingham 060B,E01009139,1603,1603,0
2021,Birmingham 060C,E01009140,2198,2185,13
2021,Birmingham 060D,E01009145,1968,1923,45
2021,Birmingham 060E,E01009147,1908,1688,220
2021,Birmingham 062A,E01009512,2016,2016,0
2021,Birmingham 062B,E01009514,1735,1675,60
2021,Birmingham 062C,E01009516,1437,1427,10
2021,Birmingham 062D,E01009517,1993,1993,0
2021,Birmingham 063A,E01009325,1997,1997,0
2021,Birmingham 063D,E01009342,1826,1631,195
2021,Birmingham 063E,E01009343,1853,1853,0
2021,Birmingham 063F,E01033642,3378,3358,20
2021,Birmingham 064A,E01008986,1553,1513,40
2021,Birmingham 064B,E01008987,1595,1595,0
2021,Birmingham 064C,E01008988,2077,1923,154
2021,Birmingham 064D,E01008989,1693,1608,85
2021,Birmingham 064E,E01008990,1179,1148,31
2021,Birmingham 064F,E01008991,1881,1563,318
2021,Birmingham 066A,E01008882,2055,2054,1
2021,Birmingham 066B,E01008896,1897,1896,1
2021,Birmingham 066C,E01008898,1789,1773,16
2021,Birmingham 066D,E01009326,2110,2110,0
2021,Birmingham 066E,E01009341,1650,1643,7
2021,Birmingham 066F,E01009513,2088,2088,0
2021,Birmingham 067A,E01008881,1745,1745,0
2021,Birmingham 067B,E01008897,1978,1969,9
2021,Birmingham 067C,E01009515,1701,1640,61
2021,Birmingham 067D,E01009518,1738,1738,0
2021,Birmingham 067E,E01009521,1658,1658,0
2021,Birmingham 069A,E01009302,1462,1357,105
2021,Birmingham 069B,E01009314,1946,1935,11
2021,Birmingham 069C,E01009321,1963,1963,0
2021,Birmingham 069D,E01009322,1752,1752,0
2021,Birmingham 069E,E01009323,1832,1832,0
2021,Birmingham 070A,E01009329,2683,2683,0
2021,Birmingham 070B,E01009334,1837,1837,0
2021,Birmingham 070C,E01009337,1979,1979,0
2021,Birmingham 070D,E01009338,1807,1807,0
2021,Birmingham 070E,E01009380,1854,1854,0
2021,Birmingham 071A,E01009362,1444,1349,95
2021,Birmingham 071B,E01009363,1779,1734,45
2021,Birmingham 071C,E01009364,1655,1635,20
2021,Birmingham 071D,E01009365,1847,1824,23
2021,Birmingham 071E,E01009379,1899,1885,14
2021,Birmingham 072A,E01009312,1590,1590,0
2021,Birmingham 072B,E01009324,1735,1735,0
2021,Birmingham 072C,E01009519,1461,1461,0
2021,Birmingham 072D,E01009520,1772,1771,1
2021,Birmingham 073A,E01009066,1938,1938,0
2021,Birmingham 073B,E01009070,1630,1580,50
2021,Birmingham 073C,E01009252,1627,1626,1
2021,Birmingham 073D,E01009260,1592,1592,0
2021,Birmingham 073E,E01009261,1747,1747,0
2021,Birmingham 074A,E01008984,1705,1638,67
2021,Birmingham 074B,E01008994,1586,1416,170
2021,Birmingham 074C,E01008996,1880,1844,36
2021,Birmingham 074D,E01008997,1538,1538,0
2021,Birmingham 075A,E01009065,1633,1554,79
2021,Birmingham 075B,E01009067,1505,1503,2
2021,Birmingham 075C,E01009068,1586,1579,7
2021,Birmingham 075D,E01009069,1641,1641,0
2021,Birmingham 075E,E01009072,1776,1776,0
2021,Birmingham 076A,E01008885,1352,1352,0
2021,Birmingham 076B,E01008886,1597,1591,6
2021,Birmingham 076C,E01008888,1645,1644,1
2021,Birmingham 076D,E01009313,1661,1661,0
2021,Birmingham 077A,E01009368,1522,1522,0
2021,Birmingham 077D,E01009371,1947,1946,1
2021,Birmingham 077E,E01009397,1775,1769,6
2021,Birmingham 077F,E01033650,2832,2832,0
2021,Birmingham 078A,E01008883,1999,1977,22
2021,Birmingham 078B,E01008884,2209,2209,0
2021,Birmingham 078C,E01008887,1728,1728,0
2021,Birmingham 078D,E01008889,1789,1704,85
2021,Birmingham 079A,E01008982,1677,1518,159
2021,Birmingham 079C,E01008992,1685,1118,567
2021,Birmingham 079E,E01009283,1766,1571,195
2021,Birmingham 079G,E01034936,2702,920,1782
2021,Birmingham 079H,E01034937,2444,1058,1386
2021,Birmingham 080A,E01009249,1595,1595,0
2021,Birmingham 080B,E01009250,1715,1715,0
2021,Birmingham 080C,E01009251,1490,1490,0
2021,Birmingham 080D,E01009253,1602,1602,0
2021,Birmingham 080E,E01009255,1543,1537,6
2021,Birmingham 080F,E01009257,1624,1624,0
2021,Birmingham 081A,E01009315,1727,1717,10
2021,Birmingham 081B,E01009316,1900,1900,0
2021,Birmingham 081C,E01009317,2072,2068,4
2021,Birmingham 081D,E01009318,1537,1537,0
2021,Birmingham 081E,E01009319,1550,1550,0
2021,Birmingham 081F,E01009320,1628,1608,20
2021,Birmingham 082A,E01009372,1735,1735,0
2021,Birmingham 082B,E01009373,1763,1763,0
2021,Birmingham 082D,E01009396,2148,2148,0
2021,Birmingham 082F,E01033643,3307,3295,12
2021,Birmingham 083A,E01009367,1791,1783,8
2021,Birmingham 083B,E01009375,1972,1972,0
2021,Birmingham 083C,E01009377,1469,1442,27
2021,Birmingham 083D,E01009383,1413,1413,0
2021,Birmingham 083E,E01009399,1644,1643,1
2021,Birmingham 084A,E01009366,1708,1708,0
2021,Birmingham 084B,E01009374,1215,1215,0
2021,Birmingham 084C,E01009376,1561,1559,2
2021,Birmingham 084F,E01033648,2748,2747,1
2021,Birmingham 085A,E01009073,1824,1824,0
2021,Birmingham 085B,E01009074,1772,1772,0
2021,Birmingham 085C,E01009254,1941,1934,7
2021,Birmingham 085D,E01009256,1677,1677,0
2021,Birmingham 085E,E01009258,1524,1524,0
2021,Birmingham 087B,E01009071,1693,1612,81
2021,Birmingham 087C,E01009075,1662,1655,7
2021,Birmingham 087E,E01009078,1535,1402,133
2021,Birmingham 087F,E01033562,2550,2480,70
2021,Birmingham 088C,E01009183,1659,1659,0
2021,Birmingham 088D,E01009186,1785,1722,63
2021,Birmingham 088F,E01034938,1937,1919,18
2021,Birmingham 088G,E01034939,1678,1579,99
2021,Birmingham 089A,E01008890,1849,1820,29
2021,Birmingham 089B,E01008891,1578,1578,0
2021,Birmingham 089C,E01008892,1484,1481,3
2021,Birmingham 089D,E01008893,1706,1701,5
2021,Birmingham 089E,E01008894,1597,1500,97
2021,Birmingham 089F,E01008895,1895,1889,6
2021,Birmingham 089G,E01009015,1850,1827,23
2021,Birmingham 090A,E01009014,2612,2612,0
2021,Birmingham 090B,E01009018,1863,1780,83
2021,Birmingham 090C,E01009026,1988,1988,0
2021,Birmingham 090D,E01009028,1867,1867,0
2021,Birmingham 090E,E01009029,1567,1539,28
2021,Birmingham 092A,E01009182,1607,1499,108
2021,Birmingham 092B,E01009184,1535,1466,69
2021,Birmingham 092C,E01009187,1490,1428,62
2021,Birmingham 092D,E01009188,1479,1469,10
2021,Birmingham 092E,E01009384,1355,1301,54
2021,Birmingham 092F,E01009385,1188,1171,17
2021,Birmingham 093A,E01009185,1729,1678,51
2021,Birmingham 093B,E01009389,1877,1870,7
2021,Birmingham 093C,E01009390,1580,1517,63
2021,Birmingham 093D,E01009394,1755,1737,18
2021,Birmingham 094A,E01008918,1748,1748,0
2021,Birmingham 094B,E01008920,1312,1312,0
2021,Birmingham 094C,E01008921,1446,1446,0
2021,Birmingham 094D,E01008931,1447,1447,0
2021,Birmingham 094E,E01009259,1700,1691,9
2021,Birmingham 095A,E01008919,1640,1640,0
2021,Birmingham 095B,E01009064,1499,1499,0
2021,Birmingham 095C,E01009077,1609,1609,0
2021,Birmingham 095D,E01009291,1476,1476,0
2021,Birmingham 095E,E01009500,1515,1508,7
2021,Birmingham 096A,E01009284,4344,2626,1718
2021,Birmingham 096C,E01009286,2405,2386,19
2021,Birmingham 096E,E01009289,2523,2523,0
2021,Birmingham 096F,E01009290,2434,2434,0
2021,Birmingham 096H,E01034940,2182,1455,727
2021,Birmingham 096I,E01034941,2100,2100,0
2021,Birmingham 097A,E01009017,1799,1799,0
2021,Birmingham 097B,E01009043,1995,1950,45
2021,Birmingham 097C,E01009044,1763,1763,0
2021,Birmingham 097D,E01009045,2047,2038,9
2021,Birmingham 097E,E01009046,1819,1809,10
2021,Birmingham 097F,E01009395,1695,1666,29
2021,Birmingham 098A,E01009016,1652,1651,1
2021,Birmingham 098B,E01009022,1830,1822,8
2021,Birmingham 098C,E01009023,1710,1710,0
2021,Birmingham 098D,E01009030,1885,1885,0
2021,Birmingham 099A,E01009281,1544,1470,74
2021,Birmingham 099B,E01009292,1567,1567,0
2021,Birmingham 099C,E01009294,1933,1916,17
2021,Birmingham 099D,E01009295,1692,1662,30
2021,Birmingham 100A,E01009280,1726,1726,0
2021,Birmingham 100B,E01009282,1712,1614,98
2021,Birmingham 100C,E01009288,1346,1095,251
2021,Birmingham 100D,E01009293,1546,1544,2
2021,Birmingham 100E,E01009296,1498,1498,0
2021,Birmingham 101A,E01008924,1491,1430,61
2021,Birmingham 101B,E01009501,1521,1521,0
2021,Birmingham 101C,E01009502,1447,1447,0
2021,Birmingham 101D,E01009503,1571,1520,51
2021,Birmingham 101E,E01009505,1639,1631,8
2021,Birmingham 102A,E01008917,1247,1245,2
2021,Birmingham 102B,E01008923,1516,1459,57
2021,Birmingham 102C,E01008925,1176,1176,0
2021,Birmingham 102D,E01008927,1303,1303,0
2021,Birmingham 102E,E01008928,1576,1569,7
2021,Birmingham 103A,E01009019,1799,1799,0
2021,Birmingham 103B,E01009020,1590,1590,0
2021,Birmingham 103C,E01009021,1757,1757,0
2021,Birmingham 103D,E01009024,1832,1771,61
2021,Birmingham 103E,E01009025,1607,1607,0
2021,Birmingham 103F,E01009033,1922,1922,0
2021,Birmingham 104A,E01009175,1450,1450,0
2021,Birmingham 104B,E01009177,1535,1535,0
2021,Birmingham 104C,E01009178,1646,1646,0
2021,Birmingham 104D,E01009179,1659,1659,0
2021,Birmingham 104E,E01009189,1412,1412,0
2021,Birmingham 105A,E01008933,1620,1620,0
2021,Birmingham 105B,E01008934,1505,1505,0
2021,Birmingham 105C,E01009031,1817,1817,0
2021,Birmingham 105D,E01009037,1909,1909,0
2021,Birmingham 105E,E01009176,1740,1740,0
2021,Birmingham 106C,E01008929,1596,1596,0
2021,Birmingham 106D,E01008930,1965,1965,0
2021,Birmingham 106E,E01009495,1312,1312,0
2021,Birmingham 106F,E01033629,2552,2442,110
2021,Birmingham 107A,E01008953,1574,1574,0
2021,Birmingham 107B,E01008963,1489,1472,17
2021,Birmingham 107C,E01008964,1452,1401,51
2021,Birmingham 107D,E01008965,1459,1459,0
2021,Birmingham 107E,E01008966,1745,1745,0
2021,Birmingham 108A,E01009032,1902,1902,0
2021,Birmingham 108B,E01009034,1771,1744,27
2021,Birmingham 108C,E01009035,1888,1888,0
2021,Birmingham 108D,E01009036,1584,1580,4
2021,Birmingham 109A,E01009494,1689,1689,0
2021,Birmingham 109B,E01009496,1474,1474,0
2021,Birmingham 109C,E01009497,1796,1796,0
2021,Birmingham 109D,E01009504,1629,1594,35
2021,Birmingham 109E,E01009506,1492,1492,0
2021,Birmingham 110A,E01008967,1588,1584,4
2021,Birmingham 110B,E01008968,1806,1799,7
2021,Birmingham 110C,E01008970,1458,1458,0
2021,Birmingham 110D,E01008981,1534,1503,31
2021,Birmingham 111A,E01008932,1606,1606,0
2021,Birmingham 111B,E01008935,1771,1734,37
2021,Birmingham 111C,E01008936,1650,1640,10
2021,Birmingham 111D,E01008938,1692,1692,0
2021,Birmingham 111E,E01008939,1665,1665,0
2021,Birmingham 112A,E01008951,1410,1410,0
2021,Birmingham 112B,E01008952,1767,1767,0
2021,Birmingham 112C,E01008955,1675,1675,0
2021,Birmingham 112D,E01008956,1414,1366,48
2021,Birmingham 112E,E01008957,1604,1550,54
2021,Birmingham 113A,E01008950,1428,1428,0
2021,Birmingham 113B,E01008954,1432,1430,2
2021,Birmingham 113C,E01008958,1551,1546,5
2021,Birmingham 113D,E01009493,1883,1806,77
2021,Birmingham 115A,E01008937,1604,1604,0
2021,Birmingham 115B,E01008940,1607,1521,86
2021,Birmingham 115C,E01008941,1592,1592,0
2021,Birmingham 115D,E01008944,1744,1734,10
2021,Birmingham 116A,E01008959,1732,1694,38
2021,Birmingham 116B,E01008960,1544,1543,1
2021,Birmingham 116C,E01008961,1413,1382,31
2021,Birmingham 116D,E01008962,2093,2076,17
2021,Birmingham 117A,E01008942,1613,1613,0
2021,Birmingham 117B,E01008943,1457,1423,34
2021,Birmingham 117C,E01008969,1667,1664,3
2021,Birmingham 117D,E01008971,1738,1738,0
2021,Birmingham 118A,E01008972,1871,1831,40
2021,Birmingham 118B,E01008973,1923,1923,0
2021,Birmingham 118C,E01008974,2795,2776,19
2021,Birmingham 118D,E01008975,1479,1466,13
2021,Birmingham 119A,E01009172,1466,1455,11
2021,Birmingham 119B,E01009173,1755,1755,0
2021,Birmingham 119C,E01009174,1221,1221,0
2021,Birmingham 119D,E01009498,1707,1707,0
2021,Birmingham 119E,E01009499,1746,1746,0
2021,Birmingham 120A,E01009205,1536,1527,9
2021,Birmingham 120B,E01009206,1517,1517,0
2021,Birmingham 120C,E01009211,1443,1443,0
2021,Birmingham 120D,E01009218,1624,1563,61
2021,Birmingham 120E,E01009219,1465,1450,15
2021,Birmingham 121A,E01008976,1539,1539,0
2021,Birmingham 121B,E01008978,1405,1366,39
2021,Birmingham 121C,E01008979,1581,1578,3
2021,Birmingham 121D,E01008980,1712,1703,9
2021,Birmingham 122A,E01008945,1813,1813,0
2021,Birmingham 122B,E01008946,1542,1509,33
2021,Birmingham 122C,E01008947,1364,1321,43
2021,Birmingham 122D,E01008948,1439,1439,0
2021,Birmingham 122E,E01008949,1189,1189,0
2021,Birmingham 123A,E01008977,1560,1541,19
2021,Birmingham 123B,E01009109,1408,1408,0
2021,Birmingham 123C,E01009119,1432,1432,0
2021,Birmingham 123D,E01009120,1763,1710,53
2021,Birmingham 124A,E01009162,1604,1604,0
2021,Birmingham 124B,E01009207,1623,1606,17
2021,Birmingham 124C,E01009208,1689,1689,0
2021,Birmingham 124D,E01009209,2044,2043,1
2021,Birmingham 124E,E01009213,1608,1597,11
2021,Birmingham 125B,E01009155,1325,1325,0
2021,Birmingham 125D,E01009157,1448,1448,0
2021,Birmingham 125E,E01009160,1635,1635,0
2021,Birmingham 125F,E01009161,1443,1412,31
2021,Birmingham 125H,E01034942,1864,1856,8
2021,Birmingham 125I,E01034943,1718,1718,0
2021,Birmingham 126A,E01009117,2073,2073,0
2021,Birmingham 126B,E01009210,1818,1809,9
2021,Birmingham 126C,E01009212,1774,1772,2
2021,Birmingham 126D,E01009214,1648,1648,0
2021,Birmingham 126E,E01009215,1815,1815,0
2021,Birmingham 127A,E01009108,1023,1023,0
2021,Birmingham 127B,E01009111,1545,1536,9
2021,Birmingham 127C,E01009112,1617,1504,113
2021,Birmingham 127D,E01009116,1369,1352,17
2021,Birmingham 127E,E01009118,1558,1558,0
2021,Birmingham 128A,E01009107,1675,1673,2
2021,Birmingham 128B,E01009110,1362,1357,5
2021,Birmingham 128C,E01009113,1709,1709,0
2021,Birmingham 128D,E01009114,1411,1411,0
2021,Birmingham 128E,E01009115,1424,1413,11
2021,Birmingham 129A,E01009158,2256,2180,76
2021,Birmingham 129C,E01009165,1382,1369,13
2021,Birmingham 129D,E01009169,1673,1673,0
2021,Birmingham 129E,E01034944,1297,1297,0
2021,Birmingham 129F,E01034945,1488,1488,0
2021,Birmingham 130A,E01009159,2282,2220,62
2021,Birmingham 130B,E01009164,1424,1424,0
2021,Birmingham 130C,E01009167,1494,1492,2
2021,Birmingham 130D,E01009171,1648,1643,5
2021,Birmingham 131A,E01009166,1319,1319,0
2021,Birmingham 131B,E01009168,1440,1440,0
2021,Birmingham 131C,E01009170,1486,1486,0
2021,Birmingham 131D,E01009216,2066,2005,61
2021,Birmingham 131E,E01009217,1569,1565,4
2021,Birmingham 132A,E01009039,1790,1787,3
2021,Birmingham 132B,E01009040,1817,1817,0
2021,Birmingham 132C,E01009041,1711,1711,0
2021,Birmingham 132D,E01009042,1363,1363,0
2021,Birmingham 132E,E01032589,1529,1512,17
2021,Birmingham 133A,E01009262,1787,1749,38
2021,Birmingham 133B,E01009267,1796,1754,42
2021,Birmingham 133C,E01009276,1659,1657,2
2021,Birmingham 133D,E01009278,1737,1737,0
2021,Birmingham 133E,E01009279,1592,1549,43
2021,Birmingham 133F,E01032591,1583,1583,0
2021,Birmingham 134A,E01008995,2431,2125,306
2021,Birmingham 134B,E01033557,2116,1516,600
2021,Birmingham 134C,E01033624,1594,1549,45
2021,Birmingham 134D,E01033626,1216,1216,0
2021,Birmingham 134E,E01033640,1999,1982,17
2021,Birmingham 135B,E01033567,1109,984,125
2021,Birmingham 135C,E01033615,1105,810,295
2021,Birmingham 135D,E01033616,1277,1225,52
2021,Birmingham 135E,E01034946,1051,1008,43
2021,Birmingham 135F,E01034947,1582,1578,4
2021,Birmingham 136A,E01009143,1884,1884,0
2021,Birmingham 136B,E01009146,2304,1559,745
2021,Birmingham 136C,E01033564,1172,1172,0
2021,Birmingham 136E,E01034948,1787,1787,0
2021,Birmingham 136F,E01034949,1308,1308,0
2021,Birmingham 137A,E01009141,1922,1922,0
2021,Birmingham 137B,E01033565,1405,1403,2
2021,Birmingham 137C,E01033618,1220,1220,0
2021,Birmingham 137E,E01033627,1126,1126,0
2021,Birmingham 137F,E01034950,1124,1124,0
2021,Birmingham 137G,E01034951,1107,1107,0
2021,Birmingham 138A,E01033620,1073,1063,10
2021,Birmingham 138B,E01033622,1894,1889,5
2021,Birmingham 138C,E01033623,1465,1464,1
2021,Birmingham 138D,E01033625,1713,1712,1
2021,Birmingham 139A,E01009200,1844,1820,24
2021,Birmingham 139B,E01009327,1662,1662,0
2021,Birmingham 139C,E01009328,2419,2419,0
2021,Birmingham 139D,E01009331,2437,2437,0
2021,Birmingham 139E,E01009332,1930,1881,49
2021,Birmingham 139F,E01009333,1619,1614,5
2021,Birmingham 139G,E01009335,1981,1981,0
2021,Birmingham 139H,E01009344,1828,1825,3
2021,Birmingham 141A,E01009008,1426,1422,4
2021,Birmingham 141B,E01009011,1738,1736,2
2021,Birmingham 141C,E01009012,1501,1497,4
2021,Birmingham 141G,E01009079,1371,1371,0
2021,Birmingham 141F,E01009080,1349,1349,0
2021,Birmingham 141H,E01009081,1371,1364,7
2021,Birmingham 141I,E01009083,1609,1609,0
2021,Birmingham 141E,E01009102,1615,1615,0
2021,Birmingham 141D,E01009104,1712,1665,47
2021,Birmingham 142A,E01009339,1669,1669,0
2021,Birmingham 142D,E01009382,2004,2001,3
2021,Birmingham 142E,E01009392,1723,1723,0
2021,Birmingham 142B,E01034952,1290,1290,0
2021,Birmingham 142C,E01034953,1619,1617,2
2021,Birmingham 143C,E01009391,1915,1915,0
2021,Birmingham 143D,E01009393,1799,1796,3
2021,Birmingham 143A,E01034954,1736,1698,38
2021,Birmingham 143B,E01034955,2148,2148,0
2021,Coventry 001A,E01009589,1699,1699,0
2021,Coventry 001F,E01032536,2171,2171,0
2021,Coventry 001G,E01032537,1975,1956,19
2021,Coventry 001H,E01032538,2227,2227,0
2021,Coventry 002A,E01009590,1533,1506,27
2021,Coventry 002B,E01009591,1589,1589,0
2021,Coventry 002C,E01009593,1665,1665,0
2021,Coventry 002D,E01009598,2142,2142,0
2021,Coventry 004A,E01009604,1437,1437,0
2021,Coventry 004B,E01009605,1749,1747,2
2021,Coventry 004C,E01009607,1620,1620,0
2021,Coventry 004D,E01009608,1634,1634,0
2021,Coventry 004E,E01009610,1525,1525,0
2021,Coventry 005A,E01009564,2093,2093,0
2021,Coventry 005B,E01009575,1311,1300,11
2021,Coventry 005C,E01009606,2237,2207,30
2021,Coventry 005D,E01009609,1570,1570,0
2021,Coventry 006A,E01009524,1523,1520,3
2021,Coventry 006B,E01009525,1519,1519,0
2021,Coventry 006C,E01009527,1620,1620,0
2021,Coventry 006D,E01009594,1479,1479,0
2021,Coventry 007A,E01009577,1732,1732,0
2021,Coventry 007B,E01009579,2257,2254,3
2021,Coventry 007C,E01009581,1761,1755,6
2021,Coventry 007D,E01009584,2134,2117,17
2021,Coventry 007E,E01009585,1861,1861,0
2021,Coventry 007F,E01009709,1262,1262,0
2021,Coventry 008A,E01009576,1605,1599,6
2021,Coventry 008B,E01009578,1385,1378,7
2021,Coventry 008C,E01009582,1678,1666,12
2021,Coventry 008D,E01009583,1583,1583,0
2021,Coventry 008E,E01009586,1827,1827,0
2021,Coventry 009A,E01009565,1783,1783,0
2021,Coventry 009B,E01009566,1987,1969,18
2021,Coventry 009C,E01009567,1723,1719,4
2021,Coventry 009D,E01009568,1862,1860,2
2021,Coventry 010A,E01009523,1641,1571,70
2021,Coventry 010B,E01009526,1562,1509,53
2021,Coventry 010C,E01009528,2165,2164,1
2021,Coventry 010D,E01009531,1594,1581,13
2021,Coventry 011A,E01009587,2318,2318,0
2021,Coventry 011B,E01009624,1544,1544,0
2021,Coventry 011C,E01009625,2408,2408,0
2021,Coventry 011D,E01009626,1688,1688,0
2021,Coventry 012A,E01009622,1836,1735,101
2021,Coventry 012B,E01009623,1563,1554,9
2021,Coventry 012C,E01009627,1815,1815,0
2021,Coventry 012D,E01009628,1563,1563,0
2021,Coventry 013A,E01009599,1089,1089,0
2021,Coventry 013B,E01009663,1445,1445,0
2021,Coventry 013C,E01009710,1299,1299,0
2021,Coventry 013D,E01009711,1925,1899,26
2021,Coventry 014A,E01009522,1910,1910,0
2021,Coventry 014B,E01009529,1523,1523,0
2021,Coventry 014C,E01009530,1405,1405,0
2021,Coventry 014D,E01009645,1451,1451,0
2021,Coventry 015A,E01009569,1360,1360,0
2021,Coventry 015B,E01009570,2282,2280,2
2021,Coventry 015C,E01009571,1590,1561,29
2021,Coventry 015E,E01009573,1500,1500,0
2021,Coventry 015F,E01009574,1610,1565,45
2021,Coventry 015G,E01034735,1658,1658,0
2021,Coventry 015H,E01034736,1719,1719,0
2021,Coventry 016A,E01009655,2041,2041,0
2021,Coventry 016B,E01009656,1627,1627,0
2021,Coventry 016C,E01009659,1870,1870,0
2021,Coventry 016D,E01009662,1416,1416,0
2021,Coventry 016E,E01009664,1582,1582,0
2021,Coventry 017A,E01009643,1410,1410,0
2021,Coventry 017B,E01009644,1606,1606,0
2021,Coventry 017C,E01009647,1882,1853,29
2021,Coventry 017D,E01009648,1504,1504,0
2021,Coventry 017E,E01009652,1464,1464,0
2021,Coventry 017F,E01009653,1595,1595,0
2021,Coventry 018A,E01009613,1303,1303,0
2021,Coventry 018B,E01009657,1629,1629,0
2021,Coventry 018C,E01009712,1524,1524,0
2021,Coventry 018D,E01009714,1493,1493,0
2021,Coventry 018E,E01009716,1688,1685,3
2021,Coventry 019A,E01009580,1336,1334,2
2021,Coventry 019B,E01009713,1450,1417,33
2021,Coventry 019C,E01009715,1411,1409,2
2021,Coventry 019D,E01009717,1472,1472,0
2021,Coventry 019E,E01009718,1830,1775,55
2021,Coventry 020B,E01009630,1844,1844,0
2021,Coventry 020C,E01009631,1567,1557,10
2021,Coventry 020D,E01009632,1813,1724,89
2021,Coventry 020E,E01009650,1514,1443,71
2021,Coventry 020F,E01034737,1841,1805,36
2021,Coventry 020G,E01034738,1431,1431,0
2021,Coventry 021A,E01009614,1456,1456,0
2021,Coventry 021B,E01009654,1839,1839,0
2021,Coventry 021C,E01009658,1783,1763,20
2021,Coventry 021D,E01009660,1731,1731,0
2021,Coventry 022A,E01009646,1514,1514,0
2021,Coventry 022B,E01009692,1178,1138,40
2021,Coventry 022C,E01009693,1484,1484,0
2021,Coventry 022D,E01009694,1428,1428,0
2021,Coventry 023A,E01009695,1585,1585,0
2021,Coventry 023B,E01009696,1438,1414,24
2021,Coventry 023C,E01009704,1418,1418,0
2021,Coventry 023D,E01009705,1352,1352,0
2021,Coventry 024A,E01009636,2530,2530,0
2021,Coventry 024B,E01009637,1853,1853,0
2021,Coventry 024C,E01009638,1886,1665,221
2021,Coventry 024D,E01009639,1741,1741,0
2021,Coventry 024E,E01009640,2146,2146,0
2021,Coventry 024F,E01009641,3286,1944,1342
2021,Coventry 025A,E01009697,2045,2045,0
2021,Coventry 025B,E01009698,1478,1478,0
2021,Coventry 025D,E01009706,1476,1476,0
2021,Coventry 025E,E01034739,1600,1600,0
2021,Coventry 025F,E01034740,1808,1718,90
2021,Coventry 026A,E01009649,1430,1430,0
2021,Coventry 026B,E01009684,1482,1449,33
2021,Coventry 026C,E01009685,1620,1611,9
2021,Coventry 026D,E01009686,1681,1643,38
2021,Coventry 026E,E01009687,1397,1397,0
2021,Coventry 027A,E01009615,1703,1674,29
2021,Coventry 027B,E01009616,1561,1536,25
2021,Coventry 027C,E01009617,1257,1257,0
2021,Coventry 027D,E01009618,1676,1676,0
2021,Coventry 027E,E01009620,2798,2756,42
2021,Coventry 027F,E01009621,1474,1474,0
2021,Coventry 028A,E01009633,2044,2044,0
2021,Coventry 028B,E01009634,2094,2073,21
2021,Coventry 028D,E01009661,2031,2031,0
2021,Coventry 028E,E01034741,1922,937,985
2021,Coventry 028F,E01034742,1149,1147,2
2021,Coventry 029A,E01009674,1733,1715,18
2021,Coventry 029B,E01009699,1433,1433,0
2021,Coventry 029C,E01009700,1665,1665,0
2021,Coventry 029D,E01009701,1498,1498,0
2021,Coventry 029E,E01009702,1652,1572,80
2021,Coventry 030A,E01009688,1501,1501,0
2021,Coventry 030B,E01009689,1658,1657,1
2021,Coventry 030C,E01009690,1461,1461,0
2021,Coventry 030D,E01009691,1291,1291,0
2021,Coventry 031A,E01009548,2774,1992,782
2021,Coventry 031B,E01009553,1927,1616,311
2021,Coventry 031D,E01009651,1538,1432,106
2021,Coventry 031E,E01034743,2043,552,1491
2021,Coventry 031F,E01034744,2870,825,2045
2021,Coventry 032A,E01009676,1639,1639,0
2021,Coventry 032B,E01009681,1316,1301,15
2021,Coventry 032C,E01009682,1435,1435,0
2021,Coventry 032D,E01009683,1906,1842,64
2021,Coventry 033A,E01009532,1345,1319,26
2021,Coventry 033B,E01009535,1369,1369,0
2021,Coventry 033C,E01009536,1464,1464,0
2021,Coventry 033D,E01009543,1789,1752,37
2021,Coventry 033E,E01009707,1811,1811,0
2021,Coventry 033F,E01009708,1406,1375,31
2021,Coventry 034A,E01009554,1344,1322,22
2021,Coventry 034B,E01009555,1474,1443,31
2021,Coventry 034C,E01009556,1522,1506,16
2021,Coventry 034D,E01009557,1384,1366,18
2021,Coventry 034E,E01009558,1408,1390,18
2021,Coventry 034F,E01009559,1343,1288,55
2021,Coventry 035C,E01009537,1494,1464,30
2021,Coventry 035D,E01009538,1535,1535,0
2021,Coventry 035F,E01009612,1532,1532,0
2021,Coventry 035G,E01032527,1610,1610,0
2021,Coventry 035H,E01032528,1566,1566,0
2021,Coventry 035I,E01034745,1388,1388,0
2021,Coventry 035J,E01034746,1660,1660,0
2021,Coventry 036C,E01009679,2222,2221,1
2021,Coventry 036F,E01032532,1494,1457,37
2021,Coventry 036G,E01032533,1913,1753,160
2021,Coventry 036H,E01034747,1999,1808,191
2021,Coventry 036I,E01034748,1355,1355,0
2021,Coventry 037B,E01009549,1621,1621,0
2021,Coventry 037C,E01009550,1718,1718,0
2021,Coventry 037E,E01009552,1578,1578,0
2021,Coventry 037F,E01032534,1796,1796,0
2021,Coventry 037G,E01032535,1248,1242,6
2021,Coventry 038A,E01009544,1556,1534,22
2021,Coventry 038E,E01032529,1259,1259,0
2021,Coventry 038F,E01032530,1887,1835,52
2021,Coventry 038G,E01034749,1925,1900,25
2021,Coventry 038H,E01034750,2799,2799,0
2021,Coventry 039A,E01009539,2076,2075,1
2021,Coventry 039B,E01009540,2031,2031,0
2021,Coventry 039C,E01009541,1677,1675,2
2021,Coventry 039D,E01009542,1904,1886,18
2021,Coventry 040A,E01009560,1482,1482,0
2021,Coventry 040B,E01009561,1602,1602,0
2021,Coventry 040C,E01009562,1592,1592,0
2021,Coventry 040D,E01009563,1711,1711,0
2021,Coventry 040E,E01009672,2124,2124,0
2021,Coventry 041A,E01009666,1386,1386,0
2021,Coventry 041B,E01009667,1313,1313,0
2021,Coventry 041C,E01009668,1653,1653,0
2021,Coventry 041D,E01009670,1683,1683,0
2021,Coventry 042A,E01009665,1269,1269,0
2021,Coventry 042B,E01009669,1284,1284,0
2021,Coventry 042C,E01009671,4120,1269,2851
2021,Coventry 042F,E01033058,2430,2080,350
2021,Coventry 043A,E01009588,1585,1585,0
2021,Coventry 043B,E01009592,1721,1721,0
2021,Coventry 043C,E01009596,2083,2080,3
2021,Coventry 043D,E01009597,1883,1857,26
2021,Coventry 043E,E01032587,1811,1811,0
2021,Dudley 001A,E01009763,2237,2237,0
2021,Dudley 001B,E01009764,1481,1481,0
2021,Dudley 001C,E01009767,1530,1530,0
2021,Dudley 001D,E01009769,1844,1811,33
2021,Dudley 001E,E01009770,1458,1458,0
2021,Dudley 002A,E01009773,1536,1536,0
2021,Dudley 002B,E01009777,1565,1565,0
2021,Dudley 002C,E01009778,1583,1583,0
2021,Dudley 002D,E01009895,1380,1380,0
2021,Dudley 003A,E01009896,1447,1447,0
2021,Dudley 003B,E01009897,1408,1406,2
2021,Dudley 003C,E01009898,1447,1422,25
2021,Dudley 003D,E01009901,1389,1360,29
2021,Dudley 003E,E01009902,1210,1210,0
2021,Dudley 004A,E01009765,1601,1586,15
2021,Dudley 004B,E01009766,1558,1558,0
2021,Dudley 004C,E01009768,1378,1378,0
2021,Dudley 004D,E01009771,1421,1368,53
2021,Dudley 004E,E01009775,1500,1496,4
2021,Dudley 004F,E01009776,1562,1562,0
2021,Dudley 005A,E01009758,1776,1776,0
2021,Dudley 005B,E01009760,1334,1334,0
2021,Dudley 005C,E01009772,1283,1277,6
2021,Dudley 005D,E01009774,1608,1585,23
2021,Dudley 005E,E01009788,1577,1577,0
2021,Dudley 006B,E01009756,1538,1528,10
2021,Dudley 006C,E01009757,2166,2123,43
2021,Dudley 006D,E01009759,1264,1264,0
2021,Dudley 006F,E01009762,1476,1476,0
2021,Dudley 006H,E01034306,1712,1710,2
2021,Dudley 006I,E01034307,1733,1732,1
2021,Dudley 007A,E01009781,1979,1979,0
2021,Dudley 007B,E01009786,1456,1456,0
2021,Dudley 007C,E01009789,1442,1442,0
2021,Dudley 007D,E01009790,1602,1602,0
2021,Dudley 008A,E01009779,1412,1412,0
2021,Dudley 008B,E01009782,1871,1864,7
2021,Dudley 008C,E01009783,1481,1481,0
2021,Dudley 008D,E01009785,1487,1487,0
2021,Dudley 008E,E01009899,1381,1381,0
2021,Dudley 008F,E01009900,1396,1396,0
2021,Dudley 009A,E01009780,2154,2154,0
2021,Dudley 009B,E01009784,1563,1563,0
2021,Dudley 009C,E01009787,1480,1480,0
2021,Dudley 009D,E01009880,1537,1470,67
2021,Dudley 009E,E01009882,1431,1387,44
2021,Dudley 010A,E01009891,1866,1866,0
2021,Dudley 010B,E01009892,1628,1628,0
2021,Dudley 010C,E01009893,1910,1910,0
2021,Dudley 010D,E01009894,1713,1713,0
2021,Dudley 011A,E01009844,1606,1577,29
2021,Dudley 011B,E01009879,2383,2328,55
2021,Dudley 011D,E01009885,1615,1615,0
2021,Dudley 011E,E01034308,1472,1438,34
2021,Dudley 011F,E01034309,1295,1295,0
2021,Dudley 012A,E01009816,1662,1662,0
2021,Dudley 012B,E01009817,1250,1250,0
2021,Dudley 012C,E01009819,1495,1495,0
2021,Dudley 012D,E01009820,1497,1452,45
2021,Dudley 013A,E01009748,1658,1649,9
2021,Dudley 013B,E01009839,1821,1719,102
2021,Dudley 013C,E01009883,1548,1536,12
2021,Dudley 013D,E01009884,1430,1415,15
2021,Dudley 013E,E01009886,1956,1956,0
2021,Dudley 014A,E01009814,1284,1212,72
2021,Dudley 014B,E01009815,1274,1274,0
2021,Dudley 014C,E01009818,1226,1226,0
2021,Dudley 014D,E01009821,1303,1303,0
2021,Dudley 014E,E01009822,1487,1451,36
2021,Dudley 015A,E01009887,1840,1811,29
2021,Dudley 015B,E01009888,1767,1758,9
2021,Dudley 015C,E01009889,2856,2850,6
2021,Dudley 015D,E01009890,1847,1843,4
2021,Dudley 016A,E01009749,2372,2352,20
2021,Dudley 016B,E01009750,1485,1485,0
2021,Dudley 016C,E01009823,1303,1303,0
2021,Dudley 016D,E01009824,1897,1894,3
2021,Dudley 017A,E01009751,1513,1507,6
2021,Dudley 017B,E01009752,1642,1610,32
2021,Dudley 017C,E01009753,1593,1593,0
2021,Dudley 017D,E01009754,1716,1716,0
2021,Dudley 017E,E01009841,1583,1556,27
2021,Dudley 018A,E01009840,1510,1508,2
2021,Dudley 018B,E01009842,1534,1525,9
2021,Dudley 018C,E01009843,1488,1487,1
2021,Dudley 018D,E01009871,1988,1984,4
2021,Dudley 018E,E01009875,1551,1497,54
2021,Dudley 019A,E01009825,1438,1438,0
2021,Dudley 019B,E01009826,1428,1428,0
2021,Dudley 019C,E01009827,1624,1624,0
2021,Dudley 019D,E01009828,1291,1291,0
2021,Dudley 019E,E01009829,1492,1492,0
2021,Dudley 019F,E01009830,1658,1601,57
2021,Dudley 020A,E01009872,1351,1351,0
2021,Dudley 020B,E01009873,1538,1538,0
2021,Dudley 020C,E01009874,1609,1609,0
2021,Dudley 020D,E01009876,1641,1641,0
2021,Dudley 020E,E01009877,1659,1659,0
2021,Dudley 021A,E01009911,1231,1231,0
2021,Dudley 021B,E01009912,2022,2011,11
2021,Dudley 021C,E01009913,1526,1526,0
2021,Dudley 021D,E01009914,1337,1337,0
2021,Dudley 021E,E01009915,1684,1609,75
2021,Dudley 021F,E01009916,1686,1686,0
2021,Dudley 022A,E01009741,2038,2038,0
2021,Dudley 022B,E01009744,2150,2150,0
2021,Dudley 022C,E01009746,1980,1922,58
2021,Dudley 022D,E01009747,1541,1520,21
2021,Dudley 023A,E01009731,1595,1586,9
2021,Dudley 023B,E01009740,2175,2175,0
2021,Dudley 023C,E01009742,1580,1580,0
2021,Dudley 023D,E01009743,1816,1812,4
2021,Dudley 023E,E01009745,1714,1676,38
2021,Dudley 024A,E01009917,1186,1186,0
2021,Dudley 024B,E01009918,1430,1430,0
2021,Dudley 024C,E01009919,1138,1138,0
2021,Dudley 024D,E01009920,1604,1604,0
2021,Dudley 025A,E01009864,1531,1531,0
2021,Dudley 025B,E01009865,1582,1582,0
2021,Dudley 025C,E01009866,1665,1665,0
2021,Dudley 025D,E01009867,1720,1720,0
2021,Dudley 025E,E01009878,2240,2210,30
2021,Dudley 026A,E01009791,1546,1546,0
2021,Dudley 026B,E01009792,1589,1588,1
2021,Dudley 026C,E01009795,1718,1718,0
2021,Dudley 026D,E01009796,1640,1629,11
2021,Dudley 026E,E01009798,2402,2390,12
2021,Dudley 027A,E01009719,1393,1393,0
2021,Dudley 027B,E01009722,1293,1293,0
2021,Dudley 027C,E01009727,1324,1324,0
2021,Dudley 027D,E01009728,1224,1224,0
2021,Dudley 027E,E01009729,1549,1549,0
2021,Dudley 028A,E01009720,1293,1293,0
2021,Dudley 028B,E01009723,1182,1180,2
2021,Dudley 028C,E01009724,1442,1442,0
2021,Dudley 028D,E01009730,1462,1462,0
2021,Dudley 029A,E01009903,1400,1400,0
2021,Dudley 029B,E01009904,1363,1325,38
2021,Dudley 029C,E01009909,1422,1422,0
2021,Dudley 029D,E01009910,1547,1547,0
2021,Dudley 030A,E01009793,1573,1573,0
2021,Dudley 030B,E01009794,1517,1517,0
2021,Dudley 030C,E01009797,1373,1373,0
2021,Dudley 030D,E01009801,1761,1718,43
2021,Dudley 031A,E01009721,2384,2351,33
2021,Dudley 031B,E01009725,1510,1510,0
2021,Dudley 031C,E01009726,1265,1265,0
2021,Dudley 031D,E01009834,1655,1655,0
2021,Dudley 032A,E01009833,1567,1566,1
2021,Dudley 032B,E01009835,1724,1706,18
2021,Dudley 032C,E01009869,1531,1531,0
2021,Dudley 032D,E01009870,1439,1439,0
2021,Dudley 033A,E01009809,1695,1695,0
2021,Dudley 033B,E01009813,1585,1585,0
2021,Dudley 033C,E01009861,1640,1634,6
2021,Dudley 033D,E01009862,1848,1827,21
2021,Dudley 033E,E01009863,1951,1950,1
2021,Dudley 033F,E01009868,1495,1495,0
2021,Dudley 034A,E01009734,1580,1573,7
2021,Dudley 034B,E01009735,1649,1649,0
2021,Dudley 034C,E01009736,1386,1383,3
2021,Dudley 034D,E01009737,1519,1519,0
2021,Dudley 034E,E01009738,1683,1683,0
2021,Dudley 035A,E01009856,2018,2018,0
2021,Dudley 035B,E01009905,1426,1426,0
2021,Dudley 035C,E01009906,1696,1696,0
2021,Dudley 035D,E01009907,1457,1436,21
2021,Dudley 035E,E01009908,1571,1571,0
2021,Dudley 036A,E01009800,1512,1502,10
2021,Dudley 036B,E01009802,1755,1755,0
2021,Dudley 036C,E01009803,1589,1589,0
2021,Dudley 036D,E01009804,1259,1218,41
2021,Dudley 037A,E01009831,1446,1446,0
2021,Dudley 037B,E01009836,1926,1926,0
2021,Dudley 037C,E01009837,1602,1602,0
2021,Dudley 037D,E01009838,1694,1694,0
2021,Dudley 038A,E01009847,1477,1477,0
2021,Dudley 038B,E01009848,1358,1358,0
2021,Dudley 038C,E01009849,1590,1590,0
2021,Dudley 038D,E01009851,1498,1498,0
2021,Dudley 039A,E01009732,1865,1827,38
2021,Dudley 039B,E01009733,1849,1849,0
2021,Dudley 039C,E01009739,1532,1532,0
2021,Dudley 039D,E01009799,1457,1457,0
2021,Dudley 039E,E01009805,1443,1443,0
2021,Dudley 039F,E01009806,1469,1469,0
2021,Dudley 040A,E01009854,1503,1475,28
2021,Dudley 040B,E01009857,1688,1688,0
2021,Dudley 040C,E01009858,1477,1228,249
2021,Dudley 040D,E01009859,1538,1518,20
2021,Dudley 041A,E01009845,1548,1547,1
2021,Dudley 041B,E01009846,1496,1496,0
2021,Dudley 041C,E01009850,1477,1467,10
2021,Dudley 041D,E01009852,1410,1395,15
2021,Dudley 042A,E01009832,1744,1744,0
2021,Dudley 042B,E01009853,1374,1374,0
2021,Dudley 042C,E01009855,1653,1612,41
2021,Dudley 042D,E01009860,1503,1503,0
2021,Dudley 043A,E01009807,1871,1871,0
2021,Dudley 043B,E01009808,1360,1360,0
2021,Dudley 043C,E01009810,1803,1803,0
2021,Dudley 043D,E01009811,1482,1482,0
2021,Dudley 043E,E01009812,1511,1477,34
2021,Sandwell 001A,E01010085,1838,1702,136
2021,Sandwell 001B,E01010086,1761,1751,10
2021,Sandwell 001C,E01010087,1664,1664,0
2021,Sandwell 001D,E01010088,1619,1619,0
2021,Sandwell 001E,E01010089,1875,1867,8
2021,Sandwell 002A,E01009969,2125,2125,0
2021,Sandwell 002B,E01009970,1819,1819,0
2021,Sandwell 002C,E01009971,1709,1709,0
2021,Sandwell 002D,E01009973,2402,2402,0
2021,Sandwell 003A,E01009960,1584,1584,0
2021,Sandwell 003B,E01009961,1244,1244,0
2021,Sandwell 003C,E01009966,1225,1225,0
2021,Sandwell 003D,E01009967,1882,1882,0
2021,Sandwell 003E,E01010092,1877,1877,0
2021,Sandwell 004A,E01009962,1363,1363,0
2021,Sandwell 004B,E01009963,1372,1372,0
2021,Sandwell 004C,E01009964,1628,1628,0
2021,Sandwell 004D,E01009965,1352,1352,0
2021,Sandwell 005A,E01010090,2125,2053,72
2021,Sandwell 005B,E01010091,1704,1703,1
2021,Sandwell 005C,E01010096,1820,1820,0
2021,Sandwell 005D,E01010097,1904,1812,92
2021,Sandwell 006A,E01009968,1535,1535,0
2021,Sandwell 006B,E01009972,1919,1917,2
2021,Sandwell 006C,E01009974,1681,1681,0
2021,Sandwell 006D,E01009975,1694,1694,0
2021,Sandwell 007A,E01010030,1738,1738,0
2021,Sandwell 007B,E01010034,1239,1239,0
2021,Sandwell 007C,E01010035,1331,1331,0
2021,Sandwell 007D,E01010036,2001,2001,0
2021,Sandwell 009A,E01009982,1590,1590,0
2021,Sandwell 009B,E01009983,1596,1566,30
2021,Sandwell 009C,E01010029,1650,1650,0
2021,Sandwell 009D,E01010037,1334,1334,0
2021,Sandwell 010A,E01009991,2358,2283,75
2021,Sandwell 010B,E01009994,1772,1721,51
2021,Sandwell 010C,E01009995,1622,1599,23
2021,Sandwell 010D,E01009996,1640,1640,0
2021,Sandwell 010E,E01009997,1801,1787,14
2021,Sandwell 010F,E01009998,2171,2171,0
2021,Sandwell 011A,E01010008,1648,1648,0
2021,Sandwell 011B,E01010010,1485,1484,1
2021,Sandwell 011C,E01010011,1756,1756,0
2021,Sandwell 011D,E01010012,1438,1428,10
2021,Sandwell 012A,E01010007,1373,1373,0
2021,Sandwell 012B,E01010009,1450,1450,0
2021,Sandwell 012C,E01010013,1340,1340,0
2021,Sandwell 012D,E01010014,1655,1646,9
2021,Sandwell 013A,E01010093,1617,1617,0
2021,Sandwell 013B,E01010094,1677,1675,2
2021,Sandwell 013C,E01010095,2094,2090,4
2021,Sandwell 013D,E01010098,1884,1884,0
2021,Sandwell 013E,E01010099,1821,1821,0
2021,Sandwell 013F,E01010100,2033,2033,0
2021,Sandwell 014A,E01009978,1850,1850,0
2021,Sandwell 014B,E01010031,1544,1544,0
2021,Sandwell 014C,E01010032,1656,1656,0
2021,Sandwell 014D,E01010033,1651,1651,0
2021,Sandwell 014F,E01033886,1645,1590,55
2021,Sandwell 014G,E01033887,1535,1535,0
2021,Sandwell 015A,E01010066,1708,1708,0
2021,Sandwell 015B,E01010067,1761,1761,0
2021,Sandwell 015C,E01010068,1868,1791,77
2021,Sandwell 015D,E01010070,1772,1772,0
2021,Sandwell 015E,E01010075,1547,1547,0
2021,Sandwell 015F,E01010076,2066,2066,0
2021,Sandwell 016A,E01009976,2745,2745,0
2021,Sandwell 016B,E01009977,2025,2022,3
2021,Sandwell 016C,E01009979,2041,2011,30
2021,Sandwell 016D,E01009980,2344,2224,120
2021,Sandwell 016E,E01010069,2648,2648,0
2021,Sandwell 016F,E01010071,1767,1767,0
2021,Sandwell 017A,E01009947,2393,2374,19
2021,Sandwell 017B,E01009992,1802,1802,0
2021,Sandwell 017C,E01009993,1953,1890,63
2021,Sandwell 017D,E01010103,2234,2221,13
2021,Sandwell 017E,E01010104,1756,1743,13
2021,Sandwell 017F,E01010105,1654,1654,0
2021,Sandwell 018A,E01009981,2068,2068,0
2021,Sandwell 018C,E01009985,1817,1807,10
2021,Sandwell 018F,E01033888,1522,1495,27
2021,Sandwell 018G,E01033889,1950,1950,0
2021,Sandwell 019A,E01009986,1682,1682,0
2021,Sandwell 019B,E01009987,1483,1483,0
2021,Sandwell 019C,E01009989,1979,1979,0
2021,Sandwell 019D,E01010106,1917,1851,66
2021,Sandwell 020A,E01009988,2830,2822,8
2021,Sandwell 020B,E01010101,2060,1985,75
2021,Sandwell 020C,E01010102,1883,1883,0
2021,Sandwell 020D,E01010107,2186,2144,42
2021,Sandwell 021A,E01010015,2030,2030,0
2021,Sandwell 021B,E01010016,1840,1840,0
2021,Sandwell 021C,E01010018,2441,2401,40
2021,Sandwell 021D,E01010072,2352,2352,0
2021,Sandwell 021E,E01010073,1664,1664,0
2021,Sandwell 022A,E01010077,1631,1631,0
2021,Sandwell 022B,E01010079,1495,1495,0
2021,Sandwell 022C,E01010080,1990,1955,35
2021,Sandwell 022D,E01010081,1563,1563,0
2021,Sandwell 022E,E01010082,2315,2315,0
2021,Sandwell 022F,E01010083,1869,1869,0
2021,Sandwell 022G,E01010084,1634,1598,36
2021,Sandwell 023A,E01010046,2943,2935,8
2021,Sandwell 023B,E01010047,2150,2110,40
2021,Sandwell 023C,E01010048,1869,1869,0
2021,Sandwell 023D,E01010049,1719,1718,1
2021,Sandwell 023E,E01010050,1739,1735,4
2021,Sandwell 023F,E01010052,1481,1481,0
2021,Sandwell 023G,E01010053,2270,2220,50
2021,Sandwell 024A,E01010017,1976,1976,0
2021,Sandwell 024B,E01010019,1999,1999,0
2021,Sandwell 024C,E01010020,2257,2257,0
2021,Sandwell 024D,E01010021,2026,1997,29
2021,Sandwell 025A,E01010039,2153,2153,0
2021,Sandwell 025B,E01010043,1401,1401,0
2021,Sandwell 025C,E01010044,1544,1544,0
2021,Sandwell 025D,E01010078,1222,1189,33
2021,Sandwell 027A,E01009934,1448,1448,0
2021,Sandwell 027B,E01009935,2370,2370,0
2021,Sandwell 027C,E01009936,1557,1557,0
2021,Sandwell 027D,E01010004,1870,1870,0
2021,Sandwell 028A,E01010054,2077,2008,69
2021,Sandwell 028B,E01010055,2018,2018,0
2021,Sandwell 028C,E01010056,1887,1887,0
2021,Sandwell 028D,E01010057,2240,2170,70
2021,Sandwell 028E,E01010060,2116,2109,7
2021,Sandwell 029A,E01010038,1849,1849,0
2021,Sandwell 029B,E01010040,1424,1424,0
2021,Sandwell 029C,E01010041,1744,1744,0
2021,Sandwell 029D,E01010045,1700,1700,0
2021,Sandwell 030A,E01010000,1823,1817,6
2021,Sandwell 030B,E01010002,2197,2171,26
2021,Sandwell 030C,E01010003,1529,1510,19
2021,Sandwell 030D,E01010005,1643,1631,12
2021,Sandwell 030E,E01010006,1733,1733,0
2021,Sandwell 031A,E01009938,1835,1835,0
2021,Sandwell 031B,E01009943,1629,1571,58
2021,Sandwell 031C,E01009944,1846,1846,0
2021,Sandwell 031D,E01010051,1423,1423,0
2021,Sandwell 031E,E01010058,1678,1678,0
2021,Sandwell 032A,E01009937,1632,1604,28
2021,Sandwell 032B,E01009939,1705,1695,10
2021,Sandwell 032C,E01009940,1538,1538,0
2021,Sandwell 032D,E01009941,1578,1569,9
2021,Sandwell 032E,E01009942,1753,1753,0
2021,Sandwell 033A,E01009929,1752,1752,0
2021,Sandwell 033B,E01009930,1556,1519,37
2021,Sandwell 033C,E01009931,2371,2371,0
2021,Sandwell 033D,E01009932,1598,1554,44
2021,Sandwell 033E,E01009999,1457,1457,0
2021,Sandwell 034A,E01009921,1783,1783,0
2021,Sandwell 034B,E01009922,1366,1366,0
2021,Sandwell 034C,E01009924,1415,1415,0
2021,Sandwell 034D,E01009925,1455,1455,0
2021,Sandwell 034E,E01009926,1408,1408,0
2021,Sandwell 034F,E01009927,1513,1513,0
2021,Sandwell 034G,E01009928,1730,1713,17
2021,Sandwell 035A,E01009933,1422,1422,0
2021,Sandwell 035B,E01009952,2185,2185,0
2021,Sandwell 035C,E01009955,2329,2275,54
2021,Sandwell 035D,E01009956,1643,1642,1
2021,Sandwell 035E,E01009959,1430,1430,0
2021,Sandwell 035F,E01010042,1875,1875,0
2021,Sandwell 036A,E01009923,1520,1520,0
2021,Sandwell 036B,E01010024,1585,1585,0
2021,Sandwell 036C,E01010026,1846,1843,3
2021,Sandwell 036D,E01010027,1619,1618,1
2021,Sandwell 037A,E01010001,1934,1933,1
2021,Sandwell 037B,E01010022,1575,1575,0
2021,Sandwell 037C,E01010023,1829,1829,0
2021,Sandwell 037D,E01010025,1736,1735,1
2021,Sandwell 037E,E01010028,1586,1583,3
2021,Sandwell 038A,E01009953,2094,2090,4
2021,Sandwell 038B,E01009954,1851,1809,42
2021,Sandwell 038C,E01009957,1850,1839,11
2021,Sandwell 038D,E01009958,1582,1581,1
2021,Sandwell 039A,E01009946,1812,1789,23
2021,Sandwell 039B,E01009948,1494,1494,0
2021,Sandwell 039C,E01009949,1613,1613,0
2021,Sandwell 039D,E01009950,1718,1718,0
2021,Sandwell 039E,E01009951,2267,2267,0
2021,Sandwell 039F,E01032592,1786,1786,0
2021,Sandwell 040A,E01010062,2279,2268,11
2021,Sandwell 040D,E01010064,2170,2130,40
2021,Sandwell 040B,E01033890,1477,1477,0
2021,Sandwell 040C,E01033891,1670,1670,0
2021,Sandwell 041D,E01010059,2290,2290,0
2021,Sandwell 041B,E01010061,2041,2041,0
2021,Sandwell 041A,E01033892,2055,2055,0
2021,Sandwell 041C,E01033893,1690,1690,0
2021,Solihull 001A,E01010118,1214,1204,10
2021,Solihull 001B,E01010120,1254,1254,0
2021,Solihull 001C,E01010121,1539,1539,0
2021,Solihull 001D,E01010122,1427,1416,11
2021,Solihull 002A,E01010235,1478,1475,3
2021,Solihull 002B,E01010236,1421,1421,0
2021,Solihull 002C,E01010239,1553,1553,0
2021,Solihull 002D,E01010240,1388,1388,0
2021,Solihull 003A,E01010117,1455,1452,3
2021,Solihull 003B,E01010119,1539,1539,0
2021,Solihull 003C,E01010123,1516,1516,0
2021,Solihull 003D,E01010124,1519,1519,0
2021,Solihull 004A,E01010146,1689,1689,0
2021,Solihull 004B,E01010234,1807,1796,11
2021,Solihull 004C,E01010237,1860,1850,10
2021,Solihull 004D,E01010238,1391,1391,0
2021,Solihull 005A,E01010145,1674,1674,0
2021,Solihull 005B,E01010147,1602,1602,0
2021,Solihull 005C,E01010148,1846,1846,0
2021,Solihull 005D,E01010149,1538,1538,0
2021,Solihull 006A,E01010125,1881,1872,9
2021,Solihull 006B,E01010129,1646,1644,2
2021,Solihull 006C,E01010139,1085,1044,41
2021,Solihull 006D,E01010141,1310,1301,9
2021,Solihull 007A,E01010140,1466,1466,0
2021,Solihull 007B,E01010142,1493,1492,1
2021,Solihull 007C,E01010143,1610,1610,0
2021,Solihull 007D,E01010144,1728,1728,0
2021,Solihull 008A,E01010111,1448,1448,0
2021,Solihull 008B,E01010126,1454,1454,0
2021,Solihull 008C,E01010127,1850,1850,0
2021,Solihull 008D,E01010128,1495,1495,0
2021,Solihull 008E,E01010130,1850,1784,66
2021,Solihull 008F,E01010131,1485,1485,0
2021,Solihull 009A,E01010109,1661,1631,30
2021,Solihull 009B,E01010110,1596,1503,93
2021,Solihull 009C,E01010112,1565,1565,0
2021,Solihull 009D,E01010113,1352,1315,37
2021,Solihull 009E,E01010114,1892,1887,5
2021,Solihull 010A,E01010157,1437,1437,0
2021,Solihull 010B,E01010159,1452,1452,0
2021,Solihull 010C,E01010162,1553,1553,0
2021,Solihull 010D,E01010163,1520,1520,0
2021,Solihull 011A,E01010132,1542,1542,0
2021,Solihull 011B,E01010133,1703,1703,0
2021,Solihull 011C,E01010134,1480,1480,0
2021,Solihull 011D,E01010135,1524,1524,0
2021,Solihull 011E,E01010138,1405,1405,0
2021,Solihull 012A,E01010136,1274,1270,4
2021,Solihull 012B,E01010137,1376,1376,0
2021,Solihull 012C,E01010158,1556,1515,41
2021,Solihull 012D,E01010160,1487,1487,0
2021,Solihull 012E,E01010161,1575,1575,0
2021,Solihull 013A,E01010174,1685,1685,0
2021,Solihull 013B,E01010175,1720,1688,32
2021,Solihull 013C,E01010177,1342,1342,0
2021,Solihull 013D,E01010178,1944,1869,75
2021,Solihull 014A,E01010172,1576,1576,0
2021,Solihull 014B,E01010173,1424,1424,0
2021,Solihull 014C,E01010176,1405,1363,42
2021,Solihull 014D,E01010179,1572,1545,27
2021,Solihull 015A,E01010115,1554,1551,3
2021,Solihull 015B,E01010116,1372,1372,0
2021,Solihull 015C,E01010227,1886,1855,31
2021,Solihull 015D,E01010228,1613,1611,2
2021,Solihull 015E,E01010232,2199,2199,0
2021,Solihull 016A,E01010195,1596,1596,0
2021,Solihull 016B,E01010226,1740,1658,82
2021,Solihull 016C,E01010229,1599,1591,8
2021,Solihull 016D,E01010230,1824,1796,28
2021,Solihull 016E,E01010231,1671,1671,0
2021,Solihull 016F,E01010233,1943,1942,1
2021,Solihull 017A,E01010108,2169,2169,0
2021,Solihull 017B,E01010164,1715,1691,24
2021,Solihull 017C,E01010165,1806,1803,3
2021,Solihull 017D,E01010167,1654,1646,8
2021,Solihull 018A,E01010199,1927,1927,0
2021,Solihull 018B,E01010200,1448,1431,17
2021,Solihull 018C,E01010201,1740,1740,0
2021,Solihull 018D,E01010204,1366,1366,0
2021,Solihull 018E,E01010205,1485,1485,0
2021,Solihull 018F,E01010206,1771,1771,0
2021,Solihull 019A,E01010192,1798,1741,57
2021,Solihull 019B,E01010196,1755,1755,0
2021,Solihull 019C,E01010197,1687,1687,0
2021,Solihull 019D,E01010198,1660,1658,2
2021,Solihull 021A,E01010218,1341,1327,14
2021,Solihull 021B,E01010219,1569,1569,0
2021,Solihull 021C,E01010221,2009,2007,2
2021,Solihull 021D,E01010222,1386,1386,0
2021,Solihull 022A,E01010191,1935,1935,0
2021,Solihull 022B,E01010202,1591,1591,0
2021,Solihull 022C,E01010203,1746,1739,7
2021,Solihull 022D,E01010209,1730,1721,9
2021,Solihull 022E,E01010213,1774,1677,97
2021,Solihull 023A,E01010208,1574,1564,10
2021,Solihull 023B,E01010210,1529,1529,0
2021,Solihull 023C,E01010211,1439,1397,42
2021,Solihull 023D,E01010217,1540,1535,5
2021,Solihull 024A,E01010190,1608,1608,0
2021,Solihull 024B,E01010193,1244,1244,0
2021,Solihull 024C,E01010194,1557,1557,0
2021,Solihull 024D,E01010207,1438,1396,42
2021,Solihull 025A,E01010166,1880,1879,1
2021,Solihull 025B,E01010168,1807,1803,4
2021,Solihull 025C,E01010169,1676,1676,0
2021,Solihull 025D,E01010170,1482,1482,0
2021,Solihull 025E,E01010171,1420,1374,46
2021,Solihull 026A,E01010151,1635,1602,33
2021,Solihull 026B,E01010152,1296,1296,0
2021,Solihull 026C,E01010153,1784,1756,28
2021,Solihull 026D,E01010154,1658,1596,62
2021,Solihull 026E,E01010155,1825,1825,0
2021,Solihull 026F,E01010156,1531,1527,4
2021,Solihull 027A,E01010212,1258,1258,0
2021,Solihull 027B,E01010214,1158,1158,0
2021,Solihull 027C,E01010215,1509,1509,0
2021,Solihull 027D,E01010216,1488,1475,13
2021,Solihull 028A,E01010150,1593,1593,0
2021,Solihull 028B,E01010184,1643,1639,4
2021,Solihull 028C,E01010185,1553,1553,0
2021,Solihull 028D,E01010186,1859,1859,0
2021,Solihull 028E,E01010187,1484,1474,10
2021,Solihull 028F,E01010188,1714,1713,1
2021,Solihull 029A,E01010180,1503,1503,0
2021,Solihull 029B,E01010181,2785,2785,0
2021,Solihull 029D,E01010183,1895,1887,8
2021,Solihull 029E,E01010189,1629,1629,0
2021,Solihull 029F,E01032885,1561,1561,0
2021,Solihull 029G,E01032886,2761,2761,0
2021,Solihull 030A,E01010220,1666,1666,0
2021,Solihull 030B,E01010223,1247,1247,0
2021,Solihull 030C,E01010225,1519,1519,0
2021,Solihull 030D,E01032590,2297,2297,0
2021,Walsall 001A,E01010301,1448,1448,0
2021,Walsall 001B,E01010303,1587,1540,47
2021,Walsall 001C,E01010306,2258,2258,0
2021,Walsall 001D,E01010307,1733,1733,0
2021,Walsall 002A,E01010302,1536,1536,0
2021,Walsall 002B,E01010304,1686,1686,0
2021,Walsall 002C,E01010305,1385,1350,35
2021,Walsall 002D,E01010308,1810,1805,5
2021,Walsall 003A,E01010345,1121,1121,0
2021,Walsall 003B,E01010346,1262,1262,0
2021,Walsall 003C,E01010347,1476,1476,0
2021,Walsall 003D,E01010350,1413,1404,9
2021,Walsall 004A,E01010249,1759,1757,2
2021,Walsall 004B,E01010250,1399,1367,32
2021,Walsall 004C,E01010252,1776,1776,0
2021,Walsall 004D,E01010254,1468,1449,19
2021,Walsall 005A,E01010348,1505,1505,0
2021,Walsall 005B,E01010349,1244,1244,0
2021,Walsall 005C,E01010351,1726,1718,8
2021,Walsall 005D,E01010352,1605,1576,29
2021,Walsall 006A,E01010284,1680,1656,24
2021,Walsall 006B,E01010285,1855,1855,0
2021,Walsall 006C,E01010286,1635,1635,0
2021,Walsall 006D,E01010290,1653,1653,0
2021,Walsall 007A,E01010251,1543,1507,36
2021,Walsall 007B,E01010253,1217,1217,0
2021,Walsall 007C,E01010255,1343,1343,0
2021,Walsall 007D,E01010256,1504,1504,0
2021,Walsall 007E,E01010257,1148,1148,0
2021,Walsall 008A,E01010292,1949,1931,18
2021,Walsall 008B,E01010294,1513,1513,0
2021,Walsall 008C,E01010296,1455,1446,9
2021,Walsall 008D,E01010297,1336,1336,0
2021,Walsall 009A,E01010291,1478,1478,0
2021,Walsall 009B,E01010293,1681,1681,0
2021,Walsall 009C,E01010298,1220,1220,0
2021,Walsall 009D,E01010299,1582,1582,0
2021,Walsall 009E,E01010300,1459,1459,0
2021,Walsall 010A,E01010319,1314,1314,0
2021,Walsall 010B,E01010321,1601,1601,0
2021,Walsall 010C,E01010353,1528,1528,0
2021,Walsall 010D,E01010354,1540,1540,0
2021,Walsall 011A,E01010395,1350,1350,0
2021,Walsall 011B,E01010397,1701,1701,0
2021,Walsall 011C,E01010398,1534,1534,0
2021,Walsall 011D,E01010399,1525,1525,0
2021,Walsall 012A,E01010282,1349,1348,1
2021,Walsall 012B,E01010287,1713,1607,106
2021,Walsall 012C,E01010288,1645,1602,43
2021,Walsall 012D,E01010289,1956,1956,0
2021,Walsall 013B,E01010277,1766,1762,4
2021,Walsall 013D,E01010283,1923,1919,4
2021,Walsall 013F,E01033894,1809,1804,5
2021,Walsall 013G,E01033895,1657,1657,0
2021,Walsall 014A,E01010393,1468,1468,0
2021,Walsall 014B,E01010394,1345,1345,0
2021,Walsall 014C,E01010396,1680,1646,34
2021,Walsall 014D,E01010400,2108,2108,0
2021,Walsall 015A,E01010241,2338,2224,114
2021,Walsall 015B,E01010242,1638,1638,0
2021,Walsall 015C,E01010243,1487,1487,0
2021,Walsall 015D,E01010244,1457,1457,0
2021,Walsall 016A,E01010320,1338,1338,0
2021,Walsall 016B,E01010322,1681,1681,0
2021,Walsall 016C,E01010323,1484,1484,0
2021,Walsall 016D,E01010324,1947,1893,54
2021,Walsall 017A,E01010271,2113,2113,0
2021,Walsall 017B,E01010272,1543,1543,0
2021,Walsall 017C,E01010273,1505,1505,0
2021,Walsall 017D,E01010295,1518,1518,0
2021,Walsall 018B,E01010279,2018,2018,0
2021,Walsall 018D,E01010374,2707,2658,49
2021,Walsall 018E,E01010375,2307,2307,0
2021,Walsall 018F,E01032888,2757,2704,53
2021,Walsall 019A,E01010378,1177,1177,0
2021,Walsall 019B,E01010379,1272,1272,0
2021,Walsall 019C,E01010382,1500,1500,0
2021,Walsall 019D,E01010383,1679,1625,54
2021,Walsall 020A,E01010376,1225,1225,0
2021,Walsall 020B,E01010377,1811,1811,0
2021,Walsall 020C,E01010380,1426,1426,0
2021,Walsall 020D,E01010381,1570,1565,5
2021,Walsall 021A,E01010267,1595,1595,0
2021,Walsall 021B,E01010268,1797,1786,11
2021,Walsall 021C,E01010274,1580,1580,0
2021,Walsall 021D,E01010275,1891,1891,0
2021,Walsall 022A,E01010245,1592,1592,0
2021,Walsall 022B,E01010246,1571,1571,0
2021,Walsall 022C,E01010247,1579,1579,0
2021,Walsall 022D,E01010248,1605,1605,0
2021,Walsall 022E,E01010388,1431,1431,0
2021,Walsall 023A,E01010258,1660,1660,0
2021,Walsall 023B,E01010259,1592,1553,39
2021,Walsall 023C,E01010260,1872,1872,0
2021,Walsall 023D,E01010266,1317,1317,0
2021,Walsall 024A,E01010317,1608,1608,0
2021,Walsall 024B,E01010318,1626,1626,0
2021,Walsall 024C,E01010325,1923,1904,19
2021,Walsall 024D,E01010369,1744,1717,27
2021,Walsall 025A,E01010401,1619,1619,0
2021,Walsall 025B,E01010403,1953,1920,33
2021,Walsall 025C,E01010404,2027,2003,24
2021,Walsall 025D,E01010407,1877,1850,27
2021,Walsall 025E,E01010408,1759,1756,3
2021,Walsall 026A,E01010269,1635,1631,4
2021,Walsall 026B,E01010270,1757,1757,0
2021,Walsall 026C,E01010362,1876,1875,1
2021,Walsall 026D,E01010363,2713,2693,20
2021,Walsall 027A,E01010402,1750,1750,0
2021,Walsall 027B,E01010405,1837,1837,0
2021,Walsall 027C,E01010406,2868,2861,7
2021,Walsall 027D,E01010409,1549,1549,0
2021,Walsall 028A,E01010385,1519,1519,0
2021,Walsall 028B,E01010386,1601,1594,7
2021,Walsall 028C,E01010387,1471,1471,0
2021,Walsall 028D,E01010392,1524,1504,20
2021,Walsall 029A,E01010326,1659,1659,0
2021,Walsall 029B,E01010327,1695,1693,2
2021,Walsall 029C,E01010328,1525,1525,0
2021,Walsall 029D,E01010330,1479,1479,0
2021,Walsall 030A,E01010368,2196,2155,41
2021,Walsall 030B,E01010370,2090,2047,43
2021,Walsall 030D,E01010372,1634,1634,0
2021,Walsall 030E,E01010373,1890,1556,334
2021,Walsall 030F,E01033896,1618,1618,0
2021,Walsall 030G,E01033897,1432,1432,0
2021,Walsall 031A,E01010361,1500,1435,65
2021,Walsall 031B,E01010364,1609,1588,21
2021,Walsall 031C,E01010365,1715,1711,4
2021,Walsall 031D,E01010366,1821,1821,0
2021,Walsall 031E,E01010367,1912,1898,14
2021,Walsall 032A,E01010384,1425,1425,0
2021,Walsall 032B,E01010389,1476,1476,0
2021,Walsall 032C,E01010390,1695,1695,0
2021,Walsall 032D,E01010391,1863,1863,0
2021,Walsall 033A,E01010261,1873,1873,0
2021,Walsall 033B,E01010263,1616,1602,14
2021,Walsall 033C,E01010264,2027,1981,46
2021,Walsall 033D,E01010265,2033,2029,4
2021,Walsall 034A,E01010336,1527,1527,0
2021,Walsall 034B,E01010340,1752,1733,19
2021,Walsall 034C,E01010341,1687,1687,0
2021,Walsall 034D,E01010342,1846,1846,0
2021,Walsall 034E,E01010343,1601,1601,0
2021,Walsall 034F,E01010344,1851,1851,0
2021,Walsall 035A,E01010331,1654,1650,4
2021,Walsall 035B,E01010332,2003,1998,5
2021,Walsall 035C,E01010333,1611,1611,0
2021,Walsall 035D,E01010334,1577,1577,0
2021,Walsall 036A,E01010262,1796,1796,0
2021,Walsall 036B,E01010309,2218,2218,0
2021,Walsall 036C,E01010311,2773,2773,0
2021,Walsall 036D,E01010316,1706,1704,2
2021,Walsall 037A,E01010335,1635,1635,0
2021,Walsall 037B,E01010337,1378,1378,0
2021,Walsall 037C,E01010338,1886,1850,36
2021,Walsall 037D,E01010339,1526,1525,1
2021,Walsall 038A,E01010310,2168,2167,1
2021,Walsall 038B,E01010312,1796,1796,0
2021,Walsall 038C,E01010313,1527,1493,34
2021,Walsall 038D,E01010314,1668,1668,0
2021,Walsall 038E,E01010315,1953,1953,0
2021,Walsall 039A,E01010329,1672,1672,0
2021,Walsall 039B,E01010355,1434,1434,0
2021,Walsall 039C,E01010356,1480,1480,0
2021,Walsall 039D,E01010357,2323,2323,0
2021,Walsall 039E,E01010358,1537,1537,0
2021,Walsall 039F,E01010359,1523,1523,0
2021,Walsall 039G,E01010360,1462,1462,0
2021,Wolverhampton 001A,E01010434,1765,1765,0
2021,Wolverhampton 001B,E01010436,1432,1432,0
2021,Wolverhampton 001C,E01010437,1154,1154,0
2021,Wolverhampton 001D,E01010438,1409,1409,0
2021,Wolverhampton 001E,E01010439,1379,1346,33
2021,Wolverhampton 001F,E01010440,1592,1590,2
2021,Wolverhampton 001G,E01010441,1356,1356,0
2021,Wolverhampton 002A,E01010495,1749,1748,1
2021,Wolverhampton 002B,E01010497,1113,1113,0
2021,Wolverhampton 002C,E01010499,1469,1414,55
2021,Wolverhampton 002D,E01010500,1456,1456,0
2021,Wolverhampton 003A,E01010496,1409,1409,0
2021,Wolverhampton 003B,E01010498,1336,1336,0
2021,Wolverhampton 003C,E01010541,1394,1394,0
2021,Wolverhampton 003D,E01010543,1417,1417,0
2021,Wolverhampton 004A,E01010456,1486,1486,0
2021,Wolverhampton 004B,E01010457,1589,1589,0
2021,Wolverhampton 004C,E01010462,1692,1609,83
2021,Wolverhampton 004D,E01010481,1507,1478,29
2021,Wolverhampton 005A,E01010555,1501,1501,0
2021,Wolverhampton 005B,E01010556,1427,1427,0
2021,Wolverhampton 005C,E01010557,1423,1423,0
2021,Wolverhampton 005D,E01010559,1422,1422,0
2021,Wolverhampton 005E,E01010560,1710,1707,3
2021,Wolverhampton 006B,E01010501,1444,1444,0
2021,Wolverhampton 006C,E01010502,1383,1383,0
2021,Wolverhampton 006D,E01010503,1254,1254,0
2021,Wolverhampton 006E,E01034310,1042,1024,18
2021,Wolverhampton 006F,E01034311,2289,2282,7
2021,Wolverhampton 007A,E01010482,1486,1463,23
2021,Wolverhampton 007B,E01010483,1484,1484,0
2021,Wolverhampton 007C,E01010484,1349,1349,0
2021,Wolverhampton 007D,E01010485,2196,2189,7
2021,Wolverhampton 008A,E01010458,1752,1752,0
2021,Wolverhampton 008B,E01010459,1550,1544,6
2021,Wolverhampton 008C,E01010460,1585,1582,3
2021,Wolverhampton 008D,E01010461,1572,1572,0
2021,Wolverhampton 008E,E01010566,1843,1843,0
2021,Wolverhampton 009A,E01010539,1571,1571,0
2021,Wolverhampton 009B,E01010540,1460,1434,26
2021,Wolverhampton 009C,E01010542,1603,1603,0
2021,Wolverhampton 009D,E01010544,1513,1513,0
2021,Wolverhampton 009E,E01010545,1681,1681,0
2021,Wolverhampton 010A,E01010554,1407,1407,0
2021,Wolverhampton 010B,E01010558,1637,1577,60
2021,Wolverhampton 010C,E01010562,1545,1545,0
2021,Wolverhampton 010D,E01010563,1406,1406,0
2021,Wolverhampton 010E,E01010567,1529,1529,0
2021,Wolverhampton 011A,E01010478,1456,1454,2
2021,Wolverhampton 011B,E01010479,1629,1629,0
2021,Wolverhampton 011C,E01010480,1398,1398,0
2021,Wolverhampton 011D,E01010486,1695,1695,0
2021,Wolverhampton 012A,E01010474,1659,1593,66
2021,Wolverhampton 012B,E01010561,1575,1575,0
2021,Wolverhampton 012C,E01010564,2539,2537,2
2021,Wolverhampton 012D,E01010565,1806,1806,0
2021,Wolverhampton 013A,E01010522,1754,1754,0
2021,Wolverhampton 013B,E01010523,1727,1727,0
2021,Wolverhampton 013C,E01010524,1795,1795,0
2021,Wolverhampton 013D,E01010525,1849,1849,0
2021,Wolverhampton 014A,E01010546,1752,1610,142
2021,Wolverhampton 014B,E01010547,1473,1441,32
2021,Wolverhampton 014C,E01010548,1437,1436,1
2021,Wolverhampton 014D,E01010549,1518,1518,0
2021,Wolverhampton 014E,E01010553,1594,1585,9
2021,Wolverhampton 015A,E01010471,1801,1801,0
2021,Wolverhampton 015B,E01010472,2651,2651,0
2021,Wolverhampton 015C,E01010473,2135,2135,0
2021,Wolverhampton 015D,E01010475,1660,1603,57
2021,Wolverhampton 015E,E01010476,1956,1956,0
2021,Wolverhampton 015F,E01010477,1672,1672,0
2021,Wolverhampton 016A,E01010526,1488,1488,0
2021,Wolverhampton 016B,E01010527,1901,1901,0
2021,Wolverhampton 016C,E01010528,1608,988,620
2021,Wolverhampton 016D,E01010529,1746,1746,0
2021,Wolverhampton 017A,E01010506,1554,1544,10
2021,Wolverhampton 017B,E01010508,1601,1541,60
2021,Wolverhampton 017C,E01010510,1545,1524,21
2021,Wolverhampton 017D,E01010511,1791,1791,0
2021,Wolverhampton 017E,E01010512,1402,1334,68
2021,Wolverhampton 018A,E01010442,1386,1345,41
2021,Wolverhampton 018B,E01010443,1691,1691,0
2021,Wolverhampton 018C,E01010444,1274,1274,0
2021,Wolverhampton 018D,E01010445,1475,1475,0
2021,Wolverhampton 018E,E01010447,1886,1886,0
2021,Wolverhampton 018F,E01010448,1699,1697,2
2021,Wolverhampton 019A,E01010509,1532,1532,0
2021,Wolverhampton 019B,E01010550,1655,1655,0
2021,Wolverhampton 019C,E01010551,1589,1589,0
2021,Wolverhampton 019D,E01010552,1866,1866,0
2021,Wolverhampton 020A,E01010463,1838,1814,24
2021,Wolverhampton 020B,E01010464,1627,1627,0
2021,Wolverhampton 020C,E01010465,1688,1688,0
2021,Wolverhampton 020D,E01010466,1610,1610,0
2021,Wolverhampton 020E,E01010470,1593,1593,0
2021,Wolverhampton 020G,E01034312,1895,1214,681
2021,Wolverhampton 020H,E01034313,1281,1093,188
2021,Wolverhampton 021A,E01010487,1525,1525,0
2021,Wolverhampton 021B,E01010488,1462,1460,2
2021,Wolverhampton 021C,E01010493,1543,1542,1
2021,Wolverhampton 021D,E01010504,1579,1514,65
2021,Wolverhampton 021E,E01010505,1239,1226,13
2021,Wolverhampton 021F,E01010507,1459,1409,50
2021,Wolverhampton 022A,E01010418,1492,1492,0
2021,Wolverhampton 022B,E01010421,1658,1658,0
2021,Wolverhampton 022C,E01010423,1607,1607,0
2021,Wolverhampton 022D,E01010424,1556,1556,0
2021,Wolverhampton 023A,E01010417,1634,1634,0
2021,Wolverhampton 023B,E01010419,1757,1756,1
2021,Wolverhampton 023C,E01010420,1357,1357,0
2021,Wolverhampton 023D,E01010425,1321,1321,0
2021,Wolverhampton 023E,E01010446,1656,1656,0
2021,Wolverhampton 026A,E01010467,1615,1512,103
2021,Wolverhampton 026B,E01010468,1526,1526,0
2021,Wolverhampton 026C,E01010469,1447,1447,0
2021,Wolverhampton 026D,E01010516,1427,1427,0
2021,Wolverhampton 026E,E01010518,1628,1627,1
2021,Wolverhampton 027A,E01010414,2213,2208,5
2021,Wolverhampton 027B,E01010415,1818,1818,0
2021,Wolverhampton 027C,E01010416,1894,1893,1
2021,Wolverhampton 027D,E01010422,1868,1805,63
2021,Wolverhampton 028A,E01010489,1499,1499,0
2021,Wolverhampton 028B,E01010490,1916,1916,0
2021,Wolverhampton 028C,E01010491,1567,1567,0
2021,Wolverhampton 028D,E01010492,1280,1280,0
2021,Wolverhampton 028E,E01010494,1579,1579,0
2021,Wolverhampton 029A,E01010449,2492,2479,13
2021,Wolverhampton 029B,E01010450,2676,2611,65
2021,Wolverhampton 029C,E01010451,2033,2033,0
2021,Wolverhampton 029D,E01010452,1659,1659,0
2021,Wolverhampton 029E,E01010455,2645,2645,0
2021,Wolverhampton 030A,E01010427,1827,1706,121
2021,Wolverhampton 030B,E01010431,1555,1551,4
2021,Wolverhampton 030C,E01010432,1529,1529,0
2021,Wolverhampton 030D,E01010519,1551,1464,87
2021,Wolverhampton 030E,E01010520,1680,1680,0
2021,Wolverhampton 031A,E01010513,1548,1492,56
2021,Wolverhampton 031B,E01010514,1650,1650,0
2021,Wolverhampton 031C,E01010515,1662,1662,0
2021,Wolverhampton 031D,E01010517,1708,1708,0
2021,Wolverhampton 032A,E01010533,1790,1762,28
2021,Wolverhampton 032B,E01010535,1579,1579,0
2021,Wolverhampton 032C,E01010536,1659,1659,0
2021,Wolverhampton 032D,E01010537,1460,1460,0
2021,Wolverhampton 033A,E01010410,2432,2432,0
2021,Wolverhampton 033B,E01010411,2160,2160,0
2021,Wolverhampton 033C,E01010412,2141,2141,0
2021,Wolverhampton 033D,E01010413,1702,1702,0
2021,Wolverhampton 034A,E01010531,1785,1732,53
2021,Wolverhampton 034B,E01010532,1740,1664,76
2021,Wolverhampton 034C,E01010534,1501,1501,0
2021,Wolverhampton 034D,E01010538,1561,1561,0
2021,Wolverhampton 035A,E01010426,1517,1340,177
2021,Wolverhampton 035B,E01010428,1609,1609,0
2021,Wolverhampton 035C,E01010429,1359,1344,15
2021,Wolverhampton 035D,E01010430,1842,1842,0
2021,Wolverhampton 035E,E01010433,1376,1376,0
2021,Wolverhampton 035G,E01010454,1708,1708,0
2021,Wolverhampton 035H,E01010530,1939,1939,0
2021,Wolverhampton 035I,E01034314,1724,1705,19
2021,Wolverhampton 035J,E01034315,1289,1289,0
