date,geography,geography code,Marital and civil partnership status: Total; measures: Value,Marital and civil partnership status: Never married and never registered a civil partnership; measures: Value,Marital and civil partnership status: Married or in a registered civil partnership; measures: Value,Marital and civil partnership status: Married or in a registered civil partnership: Married; measures: Value,Marital and civil partnership status: Married or in a registered civil partnership: Married: Opposite sex; measures: Value,Marital and civil partnership status: Married or in a registered civil partnership: Married: Same sex; measures: Value,Marital and civil partnership status: Married or in a registered civil partnership: In a registered civil partnership; measures: Value,Marital and civil partnership status: Married or in a registered civil partnership: In a registered civil partnership: Opposite sex; measures: Value,Marital and civil partnership status: Married or in a registered civil partnership: In a registered civil partnership: Same sex; measures: Value,"Marital and civil partnership status: Separated, but still legally married or still legally in a civil partnership; measures: Value","Marital and civil partnership status: Separated, but still legally married or still legally in a civil partnership: Separated, but still married; measures: Value","Marital and civil partnership status: Separated, but still legally married or still legally in a civil partnership: Separated, but still in a registered civil partnership; measures: Value",Marital and civil partnership status: Divorced or civil partnership dissolved; measures: Value,Marital and civil partnership status: Divorced or civil partnership dissolved: Divorced; measures: Value,Marital and civil partnership status: Divorced or civil partnership dissolved: Formerly in a civil partnership now legally dissolved; measures: Value,Marital and civil partnership status: Widowed or surviving civil partnership partner; measures: Value,Marital and civil partnership status: Widowed or surviving civil partnership partner: Widowed; measures: Value,Marital and civil partnership status: Widowed or surviving civil partnership partner: Surviving partner from civil partnership; measures: Value
2021,Bolton 001,E02000984,6371,1808,3604,3585,3574,11,19,4,15,109,109,0,491,489,2,359,359,0
2021,Bolton 002,E02000985,6211,1677,3421,3412,3397,15,9,2,7,100,99,1,538,537,1,475,475,0
2021,Bolton 003,E02000986,6879,2219,3328,3316,3305,11,12,6,6,148,147,1,686,684,2,498,497,1
2021,Bolton 004,E02000987,6128,2412,2305,2299,2278,21,6,0,6,154,152,2,777,776,1,480,478,2
2021,Bolton 005,E02000988,7144,2790,3087,3075,3058,17,12,2,10,165,164,1,618,616,2,484,484,0
2021,Bolton 006,E02000989,7072,1921,3757,3753,3733,20,4,0,4,120,118,2,631,630,1,643,642,1
2021,Bolton 007,E02000990,6918,2435,3285,3281,3264,17,4,0,4,155,155,0,640,640,0,403,403,0
2021,Bolton 008,E02000991,6222,2118,3049,3042,3029,13,7,2,5,134,134,0,539,539,0,382,382,0
2021,Bolton 009,E02000992,5196,1683,2495,2486,2477,9,9,2,7,103,103,0,511,510,1,404,404,0
2021,Bolton 010,E02000993,6246,2999,2042,2032,2022,10,10,8,2,169,168,1,723,723,0,313,313,0
2021,Bolton 011,E02000994,6646,2539,3024,3019,3008,11,5,2,3,182,179,3,575,575,0,326,325,1
2021,Bolton 012,E02000995,6542,2206,3066,3055,3038,17,11,4,7,131,131,0,683,681,2,456,456,0
2021,Bolton 013,E02000996,6368,3006,2061,2046,2039,7,15,10,5,182,181,1,684,683,1,435,434,1
2021,Bolton 014,E02000997,5306,1726,2613,2603,2590,13,10,4,6,115,112,3,484,482,2,368,368,0
2021,Bolton 015,E02000998,7744,3152,3440,3417,3395,22,23,20,3,208,206,2,589,588,1,355,355,0
2021,Bolton 016,E02000999,6750,3166,2290,2276,2263,13,14,6,8,201,201,0,654,654,0,439,439,0
2021,Bolton 017,E02001000,7440,3132,2801,2796,2782,14,5,0,5,225,224,1,753,751,2,529,529,0
2021,Bolton 018,E02001001,6674,2299,3297,3290,3278,12,7,4,3,163,163,0,526,526,0,389,389,0
2021,Bolton 019,E02001002,7670,2990,3281,3263,3246,17,18,4,14,178,177,1,746,744,2,475,475,0
2021,Bolton 020,E02001003,6033,1482,3658,3647,3641,6,11,2,9,93,92,1,346,346,0,454,454,0
2021,Bolton 021,E02001004,6765,2462,3296,3286,3279,7,10,8,2,152,152,0,470,468,2,385,384,1
2021,Bolton 022,E02001005,7258,2861,3367,3360,3341,19,7,6,1,156,155,1,457,457,0,417,416,1
2021,Bolton 023,E02001006,6209,2162,3270,3262,3259,3,8,4,4,121,121,0,360,360,0,296,296,0
2021,Bolton 024,E02001007,8351,2714,3931,3914,3902,12,17,10,7,221,219,2,811,810,1,674,673,1
2021,Bolton 025,E02001008,6348,2308,3099,3090,3082,8,9,6,3,161,161,0,426,426,0,354,354,0
2021,Bolton 026,E02001009,5673,2031,2668,2653,2643,10,15,6,9,138,134,4,497,496,1,339,339,0
2021,Bolton 027,E02001010,4921,2142,1958,1954,1944,10,4,0,4,149,147,2,423,423,0,249,249,0
2021,Bolton 028,E02001011,8086,2476,4140,4126,4111,15,14,2,12,160,160,0,814,813,1,496,496,0
2021,Bolton 029,E02001012,7077,2494,3570,3560,3542,18,10,10,0,143,143,0,498,498,0,372,372,0
2021,Bolton 030,E02001013,4990,1417,2719,2711,2711,0,8,4,4,104,104,0,382,381,1,368,367,1
2021,Bolton 031,E02001014,6886,2625,2798,2790,2761,29,8,6,2,169,169,0,845,844,1,449,449,0
2021,Bolton 032,E02001015,6732,2934,2163,2148,2126,22,15,4,11,223,220,3,894,894,0,518,518,0
2021,Bolton 033,E02001016,6503,3040,2307,2298,2277,21,9,4,5,205,203,2,614,614,0,337,335,2
2021,Bolton 034,E02001017,8686,3540,3469,3461,3437,24,8,4,4,213,213,0,874,874,0,590,589,1
2021,Bolton 035,E02001018,6242,2041,3209,3202,3189,13,7,2,5,115,115,0,572,570,2,305,305,0
2021,Bury 001,E02001019,7392,2725,3208,3194,3186,8,14,4,10,166,165,1,857,855,2,436,436,0
2021,Bury 002,E02001020,4980,1155,2977,2974,2968,6,3,0,3,56,56,0,365,362,3,427,426,1
2021,Bury 003,E02001021,6322,1803,3424,3412,3388,24,12,4,8,118,118,0,541,540,1,436,436,0
2021,Bury 004,E02001022,6612,2323,2996,2988,2952,36,8,4,4,155,152,3,601,599,2,537,537,0
2021,Bury 005,E02001023,4560,1448,2307,2303,2296,7,4,0,4,89,89,0,411,411,0,305,305,0
2021,Bury 006,E02001024,6609,2140,3281,3271,3262,9,10,4,6,138,138,0,635,634,1,415,415,0
2021,Bury 007,E02001025,6278,2607,2429,2411,2395,16,18,8,10,198,195,3,676,674,2,368,368,0
2021,Bury 008,E02001026,8594,3656,3578,3563,3544,19,15,11,4,256,256,0,715,714,1,389,388,1
2021,Bury 009,E02001027,5787,2505,2067,2064,2046,18,3,1,2,151,151,0,720,719,1,344,344,0
2021,Bury 010,E02001028,6180,1380,3747,3735,3725,10,12,10,2,89,88,1,409,409,0,555,555,0
2021,Bury 011,E02001029,5999,2274,2679,2671,2658,13,8,4,4,159,155,4,555,552,3,332,332,0
2021,Bury 012,E02001030,5126,1671,2650,2641,2629,12,9,1,8,87,87,0,445,444,1,273,273,0
2021,Bury 013,E02001031,5476,2006,2398,2392,2374,18,6,2,4,159,159,0,559,556,3,354,354,0
2021,Bury 014,E02001032,6235,2375,2668,2666,2646,20,2,0,2,128,128,0,606,605,1,458,458,0
2021,Bury 015,E02001033,4848,2052,1842,1833,1818,15,9,6,3,162,161,1,566,566,0,226,226,0
2021,Bury 016,E02001034,6813,3253,2029,2019,2007,12,10,2,8,230,227,3,864,862,2,437,437,0
2021,Bury 017,E02001035,5982,1848,3129,3121,3110,11,8,6,2,92,92,0,455,455,0,458,458,0
2021,Bury 018,E02001036,5873,2401,2445,2442,2418,24,3,2,1,164,163,1,571,570,1,292,290,2
2021,Bury 019,E02001037,5970,1680,3277,3263,3257,6,14,10,4,87,87,0,441,440,1,485,485,0
2021,Bury 020,E02001038,4705,1914,1811,1792,1773,19,19,8,11,115,115,0,539,536,3,326,326,0
2021,Bury 021,E02001039,6587,2950,2420,2407,2396,11,13,7,6,188,185,3,634,634,0,395,395,0
2021,Bury 022,E02001040,5278,1939,2446,2434,2408,26,12,0,12,116,115,1,432,430,2,345,345,0
2021,Bury 023,E02001041,6351,2814,2325,2304,2279,25,21,10,11,170,169,1,592,589,3,450,447,3
2021,Bury 024,E02001042,5316,1958,2483,2461,2436,25,22,8,14,101,101,0,458,455,3,316,314,2
2021,Bury 025,E02001043,4600,1807,1934,1925,1901,24,9,2,7,106,106,0,413,412,1,340,340,0
2021,Bury 026,E02001044,6398,2034,3672,3656,3645,11,16,8,8,82,81,1,329,329,0,281,281,0
2021,Manchester 001,E02001045,6462,3125,2052,2045,2020,25,7,2,5,222,220,2,651,651,0,412,412,0
2021,Manchester 002,E02001046,8419,4064,3082,3064,3021,43,18,4,14,229,228,1,694,691,3,350,350,0
2021,Manchester 003,E02001047,8093,3851,2777,2768,2755,13,9,6,3,262,260,2,740,739,1,463,462,1
2021,Manchester 004,E02001048,7017,2700,3261,3248,3226,22,13,0,13,187,185,2,537,537,0,332,332,0
2021,Manchester 005,E02001049,8171,3626,3089,3085,3063,22,4,0,4,213,211,2,667,666,1,576,576,0
2021,Manchester 006,E02001050,6014,2752,2202,2179,2155,24,23,14,9,208,201,7,558,554,4,294,291,3
2021,Manchester 007,E02001051,6795,3092,2581,2564,2540,24,17,12,5,259,257,2,522,520,2,341,341,0
2021,Manchester 008,E02001052,10538,3808,5384,5363,5348,15,21,8,13,290,289,1,583,583,0,473,472,1
2021,Manchester 009,E02001053,8454,4399,2643,2627,2601,26,16,8,8,341,341,0,725,724,1,346,345,1
2021,Manchester 011,E02001055,7214,3603,2218,2203,2172,31,15,6,9,270,269,1,709,706,3,414,414,0
2021,Manchester 012,E02001056,6471,3311,1938,1931,1924,7,7,2,5,258,258,0,597,595,2,367,365,2
2021,Manchester 015,E02001059,8879,4604,2927,2900,2858,42,27,10,17,320,318,2,696,694,2,332,331,1
2021,Manchester 017,E02001061,8087,3916,2752,2738,2717,21,14,4,10,280,279,1,742,738,4,397,395,2
2021,Manchester 018,E02001062,7878,4641,2351,2339,2312,27,12,4,8,218,217,1,473,470,3,195,193,2
2021,Manchester 019,E02001063,9688,7479,1599,1568,1524,44,31,5,26,142,141,1,348,346,2,120,119,1
2021,Manchester 020,E02001064,7858,3464,3179,3167,3152,15,12,8,4,230,229,1,625,625,0,360,360,0
2021,Manchester 021,E02001065,7066,3398,2565,2557,2548,9,8,6,2,218,218,0,568,568,0,317,316,1
2021,Manchester 022,E02001066,9719,6170,2808,2798,2785,13,10,6,4,169,168,1,344,342,2,228,227,1
2021,Manchester 023,E02001067,8110,3838,2967,2954,2936,18,13,6,7,305,304,1,673,673,0,327,326,1
2021,Manchester 024,E02001068,8374,4386,2758,2733,2694,39,25,6,19,282,282,0,619,615,4,329,327,2
2021,Manchester 025,E02001069,9705,6017,2765,2756,2706,50,9,4,5,234,231,3,443,441,2,246,246,0
2021,Manchester 026,E02001070,10448,7133,2597,2570,2544,26,27,8,19,160,159,1,336,335,1,222,222,0
2021,Manchester 028,E02001072,7362,4082,2399,2364,2326,38,35,4,31,144,143,1,528,522,6,209,209,0
2021,Manchester 029,E02001073,7903,4176,2768,2699,2633,66,69,18,51,154,149,5,507,504,3,298,297,1
2021,Manchester 030,E02001074,9179,4580,3306,3286,3246,40,20,4,16,211,211,0,608,605,3,474,474,0
2021,Manchester 031,E02001075,6933,3494,2623,2605,2583,22,18,2,16,191,191,0,409,406,3,216,216,0
2021,Manchester 032,E02001076,10394,8607,1397,1388,1369,19,9,3,6,59,58,1,199,199,0,132,132,0
2021,Manchester 033,E02001077,6128,3118,2301,2253,2206,47,48,4,44,98,97,1,368,362,6,243,243,0
2021,Manchester 034,E02001078,8416,3580,3727,3696,3666,30,31,4,27,175,173,2,487,484,3,447,447,0
2021,Manchester 035,E02001079,7693,4695,2106,2099,2078,21,7,4,3,151,149,2,444,443,1,297,295,2
2021,Manchester 036,E02001080,8795,6712,1435,1432,1418,14,3,2,1,116,115,1,309,309,0,223,222,1
2021,Manchester 037,E02001081,5135,2509,1936,1897,1845,52,39,8,31,90,89,1,382,379,3,218,217,1
2021,Manchester 038,E02001082,5889,3860,1524,1506,1484,22,18,4,14,79,75,4,265,264,1,161,161,0
2021,Manchester 039,E02001083,7149,4800,1685,1672,1638,34,13,4,9,100,100,0,417,412,5,147,147,0
2021,Manchester 040,E02001084,7238,4235,2239,2190,2172,18,49,4,45,111,111,0,373,373,0,280,280,0
2021,Manchester 041,E02001085,6616,3226,2319,2313,2292,21,6,4,2,204,202,2,535,534,1,332,332,0
2021,Manchester 042,E02001086,5630,3043,1704,1692,1659,33,12,2,10,140,136,4,438,437,1,305,304,1
2021,Manchester 043,E02001087,7767,3617,3188,3153,3120,33,35,14,21,104,103,1,510,505,5,348,347,1
2021,Manchester 044,E02001088,6945,3370,2364,2353,2335,18,11,7,4,190,190,0,649,647,2,372,369,3
2021,Manchester 045,E02001089,6509,2630,3035,3017,2986,31,18,4,14,95,95,0,413,412,1,336,336,0
2021,Manchester 046,E02001090,5804,2533,2285,2276,2246,30,9,1,8,130,127,3,521,521,0,335,334,1
2021,Manchester 047,E02001091,6789,2977,2490,2480,2460,20,10,4,6,147,147,0,769,765,4,406,406,0
2021,Manchester 048,E02001092,7063,3440,2497,2492,2452,40,5,2,3,198,196,2,599,597,2,329,328,1
2021,Manchester 049,E02001093,7356,3768,2273,2266,2254,12,7,4,3,269,266,3,669,669,0,377,377,0
2021,Manchester 050,E02001094,7154,3796,2052,2038,2026,12,14,8,6,257,255,2,723,720,3,326,325,1
2021,Manchester 051,E02001095,6992,3548,2126,2099,2082,17,27,12,15,196,194,2,735,732,3,387,386,1
2021,Manchester 052,E02001096,6397,3065,2220,2216,2194,22,4,0,4,152,151,1,622,620,2,338,335,3
2021,Manchester 053,E02001097,6628,3419,1975,1961,1942,19,14,10,4,189,189,0,696,694,2,349,349,0
2021,Manchester 054,E02006902,7325,5691,1131,1077,1032,45,54,13,41,121,119,2,299,295,4,83,82,1
2021,Manchester 055,E02006912,9981,8422,1022,964,885,79,58,8,50,117,110,7,291,283,8,129,128,1
2021,Manchester 056,E02006913,6277,3663,2076,2058,2041,17,18,4,14,104,103,1,271,268,3,163,162,1
2021,Manchester 057,E02006914,7569,6845,509,491,458,33,18,0,18,45,42,3,146,139,7,24,24,0
2021,Manchester 058,E02006915,6935,3511,2533,2509,2484,25,24,4,20,221,216,5,442,439,3,228,227,1
2021,Manchester 059,E02006916,6291,4935,876,860,815,45,16,8,8,131,129,2,253,247,6,96,93,3
2021,Manchester 060,E02006917,6262,5109,868,842,808,34,26,6,20,51,50,1,197,188,9,37,37,0
2021,Manchester 061,E02006983,5831,3808,1328,1306,1259,47,22,4,18,162,159,3,361,355,6,172,171,1
2021,Manchester 062,E02006984,5108,3844,865,849,816,33,16,2,14,77,75,2,239,236,3,83,83,0
2021,Manchester 063,E02006985,6474,2457,3412,3398,3379,19,14,10,4,149,148,1,273,273,0,183,183,0
2021,Manchester 064,E02006986,4568,2024,1981,1976,1960,16,5,0,5,120,120,0,295,294,1,148,148,0
2021,Oldham 001,E02001098,4975,1591,2351,2347,2345,2,4,2,2,97,97,0,473,472,1,463,463,0
2021,Oldham 002,E02001099,4663,1840,1807,1804,1793,11,3,0,3,127,127,0,554,554,0,335,335,0
2021,Oldham 003,E02001100,4999,1648,2357,2347,2334,13,10,4,6,103,103,0,456,452,4,435,435,0
2021,Oldham 004,E02001101,4703,1467,2348,2343,2339,4,5,2,3,104,104,0,430,430,0,354,354,0
2021,Oldham 005,E02001102,4862,1780,2217,2207,2191,16,10,4,6,137,137,0,452,451,1,276,274,2
2021,Oldham 006,E02001103,4650,1244,2526,2518,2498,20,8,0,8,86,85,1,414,414,0,380,380,0
2021,Oldham 007,E02001104,5681,2269,2542,2534,2521,13,8,6,2,134,134,0,479,478,1,257,257,0
2021,Oldham 008,E02001105,4952,1757,2150,2146,2138,8,4,2,2,106,106,0,509,509,0,430,430,0
2021,Oldham 009,E02001106,4994,1924,1960,1958,1943,15,2,0,2,128,128,0,553,553,0,429,429,0
2021,Oldham 010,E02001107,5227,1828,2578,2575,2564,11,3,2,1,126,126,0,386,385,1,309,309,0
2021,Oldham 011,E02001108,4336,2181,1341,1334,1324,10,7,6,1,142,141,1,435,433,2,237,237,0
2021,Oldham 012,E02001109,6072,2625,2264,2255,2243,12,9,6,3,174,173,1,642,642,0,367,367,0
2021,Oldham 013,E02001110,5439,1515,2863,2850,2836,14,13,4,9,112,109,3,553,553,0,396,395,1
2021,Oldham 014,E02001111,6370,3003,2187,2172,2161,11,15,8,7,275,274,1,579,579,0,326,326,0
2021,Oldham 015,E02001112,5005,1535,2720,2710,2703,7,10,2,8,86,86,0,371,371,0,293,293,0
2021,Oldham 016,E02001113,6713,2614,3302,3292,3274,18,10,4,6,161,161,0,276,275,1,360,360,0
2021,Oldham 017,E02001114,6902,2638,2999,2991,2983,8,8,4,4,178,178,0,598,598,0,489,489,0
2021,Oldham 018,E02001115,4854,1889,1973,1970,1965,5,3,0,3,117,117,0,530,526,4,345,345,0
2021,Oldham 019,E02001116,5456,1796,2944,2940,2927,13,4,4,0,158,158,0,321,321,0,237,237,0
2021,Oldham 020,E02001117,5012,1428,2685,2681,2668,13,4,0,4,83,82,1,433,432,1,383,383,0
2021,Oldham 021,E02001118,5056,1557,2582,2582,2571,11,0,0,0,92,91,1,447,447,0,378,376,2
2021,Oldham 022,E02001119,8656,2843,4763,4759,4747,12,4,4,0,334,333,1,319,319,0,397,396,1
2021,Oldham 024,E02001121,6031,2309,2980,2971,2959,12,9,2,7,185,185,0,322,322,0,235,235,0
2021,Oldham 026,E02001123,5196,2251,1960,1950,1934,16,10,2,8,183,183,0,513,513,0,289,289,0
2021,Oldham 027,E02001124,5266,2484,1848,1846,1836,10,2,2,0,166,165,1,508,508,0,260,260,0
2021,Oldham 028,E02001125,6359,2626,2618,2610,2597,13,8,2,6,143,140,3,521,520,1,451,451,0
2021,Oldham 029,E02001126,6646,2930,2566,2545,2530,15,21,10,11,202,201,1,615,614,1,333,333,0
2021,Oldham 030,E02001127,5755,2649,2140,2128,2117,11,12,8,4,173,171,2,486,486,0,307,305,2
2021,Oldham 031,E02001128,5985,2594,2247,2243,2234,9,4,4,0,173,173,0,560,559,1,411,410,1
2021,Oldham 032,E02001129,5439,2621,1713,1701,1681,20,12,4,8,157,156,1,546,546,0,402,402,0
2021,Oldham 033,E02001130,4909,1751,2239,2234,2223,11,5,0,5,96,96,0,440,440,0,383,383,0
2021,Oldham 034,E02001131,4417,1760,1899,1896,1886,10,3,2,1,79,77,2,306,306,0,373,373,0
2021,Oldham 036,E02007000,5309,1900,2692,2682,2671,11,10,8,2,157,157,0,328,328,0,232,232,0
2021,Oldham 037,E02007001,6154,2102,3335,3334,3318,16,1,0,1,146,146,0,276,276,0,295,295,0
2021,Rochdale 001,E02001132,5459,2105,2152,2149,2135,14,3,2,1,175,175,0,644,643,1,383,383,0
2021,Rochdale 002,E02001133,5282,1797,2577,2575,2561,14,2,2,0,107,106,1,497,494,3,304,304,0
2021,Rochdale 003,E02001134,5258,1554,2770,2764,2747,17,6,2,4,124,122,2,451,451,0,359,359,0
2021,Rochdale 004,E02001135,6116,2505,2413,2406,2392,14,7,4,3,217,217,0,624,621,3,357,357,0
2021,Rochdale 005,E02001136,7728,2889,3493,3483,3467,16,10,4,6,176,176,0,689,685,4,481,478,3
2021,Rochdale 006,E02001137,5183,1610,2697,2686,2669,17,11,0,11,120,119,1,478,478,0,278,278,0
2021,Rochdale 007,E02001138,7213,1984,3903,3893,3875,18,10,2,8,132,131,1,633,630,3,561,561,0
2021,Rochdale 008,E02001139,7519,2830,3639,3633,3628,5,6,4,2,226,225,1,462,462,0,362,362,0
2021,Rochdale 009,E02001140,6099,2471,2566,2565,2555,10,1,0,1,168,167,1,561,560,1,333,333,0
2021,Rochdale 010,E02001141,8997,3664,3719,3700,3685,15,19,12,7,310,307,3,818,818,0,486,486,0
2021,Rochdale 011,E02001142,5043,1310,2838,2832,2827,5,6,4,2,88,88,0,383,383,0,424,424,0
2021,Rochdale 012,E02001143,8499,3501,3599,3583,3570,13,16,4,12,252,251,1,716,715,1,431,430,1
2021,Rochdale 013,E02001144,5206,1996,2208,2202,2193,9,6,6,0,146,144,2,529,529,0,327,327,0
2021,Rochdale 014,E02001145,5778,1976,2657,2650,2640,10,7,3,4,143,143,0,611,611,0,391,389,2
2021,Rochdale 015,E02001146,7557,2746,3716,3711,3698,13,5,2,3,204,204,0,478,478,0,413,413,0
2021,Rochdale 016,E02001147,7799,3327,3074,3054,3027,27,20,10,10,242,242,0,713,709,4,443,443,0
2021,Rochdale 017,E02001148,8337,3196,3474,3464,3449,15,10,4,6,216,215,1,829,823,6,622,622,0
2021,Rochdale 018,E02001149,8150,3612,2707,2699,2680,19,8,0,8,300,300,0,981,980,1,550,550,0
2021,Rochdale 019,E02001150,6888,2895,2633,2631,2602,29,2,0,2,208,204,4,695,694,1,457,457,0
2021,Rochdale 020,E02001151,8078,3046,3617,3608,3591,17,9,6,3,196,196,0,737,735,2,482,481,1
2021,Rochdale 021,E02001152,7679,3373,2941,2936,2918,18,5,1,4,216,213,3,718,714,4,431,431,0
2021,Rochdale 022,E02001153,9079,4258,3041,3014,2999,15,27,14,13,313,311,2,918,918,0,549,549,0
2021,Rochdale 023,E02001154,8075,3557,2971,2964,2953,11,7,2,5,250,248,2,810,808,2,487,487,0
2021,Rochdale 024,E02001155,5884,2515,2047,2036,2024,12,11,2,9,214,213,1,669,668,1,439,439,0
2021,Rochdale 025,E02001156,8036,2676,4063,4050,4029,21,13,2,11,140,140,0,588,586,2,569,569,0
2021,Salford 001,E02001157,6345,3303,1770,1755,1730,25,15,12,3,237,234,3,681,678,3,354,354,0
2021,Salford 002,E02001158,4744,2255,1551,1541,1532,9,10,5,5,119,118,1,514,514,0,305,305,0
2021,Salford 003,E02001159,5842,2790,2031,2013,1981,32,18,9,9,181,181,0,564,561,3,276,276,0
2021,Salford 004,E02001160,5373,2387,2079,2066,2042,24,13,4,9,124,123,1,492,488,4,291,291,0
2021,Salford 005,E02001161,4866,1985,2040,2029,2018,11,11,8,3,94,93,1,455,453,2,292,291,1
2021,Salford 006,E02001162,4844,2049,1823,1823,1812,11,0,0,0,121,121,0,492,491,1,359,358,1
2021,Salford 007,E02001163,8150,3337,3463,3450,3420,30,13,2,11,141,138,3,712,708,4,497,496,1
2021,Salford 008,E02001164,6032,3301,1828,1817,1793,24,11,2,9,199,199,0,477,476,1,227,227,0
2021,Salford 009,E02001165,4962,2226,1867,1861,1834,27,6,0,6,90,90,0,464,463,1,315,315,0
2021,Salford 010,E02001166,5400,1838,2991,2978,2942,36,13,0,13,70,68,2,277,277,0,224,224,0
2021,Salford 011,E02001167,5341,2342,2201,2183,2165,18,18,8,10,126,125,1,405,402,3,267,267,0
2021,Salford 012,E02001168,7853,3404,3021,3009,2988,21,12,4,8,192,191,1,718,715,3,518,518,0
2021,Salford 013,E02001169,8920,2770,4791,4780,4756,24,11,2,9,126,126,0,703,703,0,530,530,0
2021,Salford 014,E02001170,7971,2301,4324,4313,4278,35,11,6,5,125,124,1,624,623,1,597,596,1
2021,Salford 015,E02001171,5073,1895,2390,2386,2368,18,4,2,2,97,95,2,362,361,1,329,329,0
2021,Salford 017,E02001173,7666,5042,1626,1607,1575,32,19,4,15,216,215,1,505,505,0,277,277,0
2021,Salford 018,E02001174,4853,2311,1789,1778,1758,20,11,6,5,101,101,0,348,343,5,304,304,0
2021,Salford 019,E02001175,5937,2880,2065,2053,2035,18,12,3,9,149,149,0,515,515,0,328,327,1
2021,Salford 020,E02001176,9864,4304,3646,3621,3568,53,25,10,15,223,219,4,977,969,8,714,713,1
2021,Salford 021,E02001177,10876,5721,3390,3372,3331,41,18,4,14,285,282,3,904,899,5,576,576,0
2021,Salford 023,E02001179,5882,3499,1515,1500,1475,25,15,2,13,150,149,1,405,405,0,313,313,0
2021,Salford 024,E02001180,4643,2743,1096,1091,1076,15,5,2,3,144,143,1,459,457,2,201,199,2
2021,Salford 025,E02001181,4679,2325,1425,1414,1400,14,11,7,4,148,148,0,540,540,0,241,241,0
2021,Salford 026,E02001182,5806,3001,1746,1737,1705,32,9,2,7,168,167,1,590,588,2,301,301,0
2021,Salford 027,E02001183,5888,3190,1752,1742,1733,9,10,4,6,180,178,2,512,510,2,254,253,1
2021,Salford 029,E02001185,7761,3039,3179,3171,3159,12,8,0,8,191,191,0,768,768,0,584,583,1
2021,Salford 030,E02001186,8265,3549,3219,3215,3196,19,4,2,2,178,175,3,845,845,0,474,474,0
2021,Salford 031,E02006957,5058,2214,2186,2182,2178,4,4,0,4,128,127,1,363,361,2,167,167,0
2021,Salford 032,E02006958,6136,3529,1806,1800,1764,36,6,0,6,153,147,6,371,371,0,277,276,1
2021,Salford 033,E02006959,7590,6171,998,975,936,39,23,4,19,104,98,6,254,247,7,63,58,5
2021,Salford 034,E02006960,8400,6525,1276,1257,1221,36,19,10,9,140,135,5,336,329,7,123,123,0
2021,Salford 035,E02006961,5558,3762,1143,1131,1109,22,12,4,8,159,153,6,332,331,1,162,161,1
2021,Salford 036,E02006962,4648,3636,722,709,696,13,13,3,10,58,57,1,162,162,0,70,69,1
2021,Salford 037,E02006963,5695,4050,1317,1297,1243,54,20,8,12,62,58,4,221,219,2,45,44,1
2021,Stockport 001,E02001187,5704,2425,2248,2230,2218,12,18,8,10,120,120,0,517,515,2,394,392,2
2021,Stockport 002,E02001188,6821,3573,2136,2132,2122,10,4,0,4,187,187,0,628,626,2,297,297,0
2021,Stockport 003,E02001189,6806,2693,2974,2966,2948,18,8,6,2,152,152,0,573,571,2,414,414,0
2021,Stockport 004,E02001190,5971,3399,1522,1507,1497,10,15,4,11,160,159,1,529,528,1,361,361,0
2021,Stockport 005,E02001191,4867,1612,2347,2336,2326,10,11,2,9,91,90,1,457,457,0,360,360,0
2021,Stockport 006,E02001192,5445,2048,2506,2488,2463,25,18,2,16,114,114,0,383,380,3,394,394,0
2021,Stockport 007,E02001193,5262,2607,1718,1711,1685,26,7,4,3,108,108,0,574,573,1,255,255,0
2021,Stockport 008,E02001194,5112,1619,2691,2675,2650,25,16,3,13,79,79,0,389,389,0,334,332,2
2021,Stockport 009,E02001195,6178,2353,2639,2631,2611,20,8,4,4,139,139,0,585,583,2,462,462,0
2021,Stockport 010,E02001196,6510,2095,3159,3152,3146,6,7,3,4,134,134,0,580,579,1,542,542,0
2021,Stockport 011,E02001197,5000,1720,2494,2489,2464,25,5,0,5,85,85,0,449,446,3,252,252,0
2021,Stockport 012,E02001198,6098,2281,2481,2465,2448,17,16,7,9,138,136,2,604,601,3,594,593,1
2021,Stockport 013,E02001199,6459,2201,3220,3202,3176,26,18,4,14,135,134,1,522,519,3,381,379,2
2021,Stockport 014,E02001200,6345,3412,1596,1573,1555,18,23,8,15,194,192,2,828,828,0,315,315,0
2021,Stockport 015,E02001201,4642,1918,1927,1913,1902,11,14,8,6,94,94,0,428,425,3,275,275,0
2021,Stockport 016,E02001202,5300,2843,1522,1509,1476,33,13,2,11,149,149,0,559,555,4,227,227,0
2021,Stockport 017,E02001203,4841,1065,3050,3039,3019,20,11,2,9,59,59,0,353,353,0,314,314,0
2021,Stockport 018,E02001204,7157,3021,2988,2971,2940,31,17,4,13,142,142,0,614,610,4,392,390,2
2021,Stockport 019,E02001205,6900,3189,2519,2513,2489,24,6,4,2,165,162,3,718,716,2,309,306,3
2021,Stockport 020,E02001206,5923,1795,2992,2989,2983,6,3,1,2,122,122,0,526,526,0,488,488,0
2021,Stockport 021,E02001207,5661,1753,2901,2893,2888,5,8,2,6,114,114,0,502,502,0,391,391,0
2021,Stockport 022,E02001208,6205,2603,2462,2452,2418,34,10,0,10,125,124,1,599,597,2,416,416,0
2021,Stockport 023,E02001209,6228,2758,2383,2365,2339,26,18,6,12,152,152,0,623,620,3,312,311,1
2021,Stockport 024,E02001210,5822,2342,2273,2264,2254,10,9,3,6,146,146,0,659,657,2,402,402,0
2021,Stockport 025,E02001211,5267,1472,2950,2945,2928,17,5,2,3,100,100,0,382,382,0,363,363,0
2021,Stockport 026,E02001212,5196,2497,1820,1813,1792,21,7,1,6,151,151,0,477,477,0,251,251,0
2021,Stockport 027,E02001213,8041,2833,3704,3686,3660,26,18,5,13,161,160,1,818,816,2,525,524,1
2021,Stockport 028,E02001214,6503,1919,3502,3498,3493,5,4,2,2,121,119,2,455,452,3,506,505,1
2021,Stockport 029,E02001215,4964,1410,2574,2565,2559,6,9,4,5,91,91,0,463,463,0,426,426,0
2021,Stockport 030,E02001216,6355,1859,3438,3432,3409,23,6,4,2,99,99,0,443,441,2,516,515,1
2021,Stockport 031,E02001217,5526,2123,2211,2202,2188,14,9,4,5,129,129,0,620,619,1,443,443,0
2021,Stockport 032,E02001218,4870,1254,2852,2847,2834,13,5,4,1,78,77,1,347,347,0,339,339,0
2021,Stockport 033,E02001219,4406,1203,2454,2450,2442,8,4,0,4,53,53,0,354,354,0,342,342,0
2021,Stockport 034,E02001220,4527,1298,2418,2416,2396,20,2,0,2,100,100,0,430,428,2,281,281,0
2021,Stockport 035,E02001221,4886,1303,2838,2834,2827,7,4,0,4,64,64,0,310,310,0,371,370,1
2021,Stockport 036,E02001222,5253,1490,2957,2953,2949,4,4,0,4,54,54,0,334,334,0,418,418,0
2021,Stockport 037,E02001223,5510,1307,3217,3211,3203,8,6,2,4,68,68,0,457,456,1,461,457,4
2021,Stockport 038,E02001224,5035,1154,2957,2950,2932,18,7,2,5,61,60,1,385,385,0,478,478,0
2021,Stockport 039,E02001225,5916,1644,3260,3252,3242,10,8,1,7,100,99,1,481,477,4,431,431,0
2021,Stockport 040,E02001226,5690,1835,2909,2898,2882,16,11,6,5,114,114,0,428,427,1,404,403,1
2021,Stockport 041,E02001227,4596,940,2884,2882,2877,5,2,2,0,48,48,0,306,305,1,418,418,0
2021,Stockport 042,E02001228,5140,1197,3149,3149,3129,20,0,0,0,55,55,0,304,304,0,435,435,0
2021,Tameside 001,E02001229,8413,3316,3481,3467,3433,34,14,7,7,186,180,6,925,924,1,505,504,1
2021,Tameside 002,E02001230,4888,1445,2672,2670,2637,33,2,0,2,94,94,0,329,329,0,348,348,0
2021,Tameside 003,E02001231,5575,2065,2591,2587,2565,22,4,2,2,125,125,0,487,487,0,307,305,2
2021,Tameside 004,E02001232,6753,2797,2716,2710,2695,15,6,0,6,166,166,0,641,640,1,433,432,1
2021,Tameside 005,E02001233,6341,2340,2625,2622,2607,15,3,0,3,190,189,1,652,652,0,534,534,0
2021,Tameside 006,E02001234,6109,2665,2301,2285,2263,22,16,6,10,164,163,1,583,582,1,396,396,0
2021,Tameside 007,E02001235,5749,2355,2393,2378,2348,30,15,2,13,144,139,5,554,551,3,303,303,0
2021,Tameside 008,E02001236,4678,2139,1532,1516,1496,20,16,2,14,185,179,6,480,480,0,342,341,1
2021,Tameside 009,E02001237,5720,2344,2263,2255,2238,17,8,6,2,160,159,1,639,637,2,314,314,0
2021,Tameside 010,E02001238,6551,2606,2697,2691,2677,14,6,4,2,153,152,1,621,618,3,474,472,2
2021,Tameside 011,E02001239,7597,3325,2916,2904,2858,46,12,4,8,203,199,4,679,672,7,474,473,1
2021,Tameside 012,E02001240,5189,2185,2106,2102,2086,16,4,2,2,132,127,5,463,463,0,303,302,1
2021,Tameside 013,E02001241,8443,3832,3035,3022,3001,21,13,6,7,300,300,0,819,804,15,457,455,2
2021,Tameside 014,E02001242,5708,2053,2714,2709,2695,14,5,2,3,100,100,0,418,417,1,423,421,2
2021,Tameside 015,E02001243,6937,2472,3161,3155,3133,22,6,4,2,188,175,13,706,703,3,410,410,0
2021,Tameside 016,E02001244,4486,1466,2179,2176,2166,10,3,0,3,101,94,7,387,386,1,353,353,0
2021,Tameside 017,E02001245,6488,2815,2418,2413,2394,19,5,2,3,184,183,1,685,683,2,386,386,0
2021,Tameside 018,E02001246,5967,2465,2221,2214,2201,13,7,0,7,160,153,7,648,646,2,473,473,0
2021,Tameside 019,E02001247,5985,2561,2236,2229,2217,12,7,3,4,153,149,4,671,669,2,364,364,0
2021,Tameside 020,E02001248,9328,4231,3276,3256,3218,38,20,2,18,320,316,4,993,993,0,508,508,0
2021,Tameside 021,E02001249,5183,2236,1943,1935,1919,16,8,2,6,134,133,1,544,542,2,326,326,0
2021,Tameside 022,E02001250,5427,1808,2649,2637,2615,22,12,4,8,89,89,0,517,517,0,364,364,0
2021,Tameside 023,E02001251,5120,1863,2266,2258,2237,21,8,0,8,133,131,2,498,496,2,360,360,0
2021,Tameside 024,E02001252,6301,2152,2979,2970,2945,25,9,6,3,122,121,1,516,513,3,532,532,0
2021,Tameside 025,E02001253,4143,1600,1749,1744,1736,8,5,0,5,100,100,0,423,422,1,271,271,0
2021,Tameside 026,E02001254,4611,1849,1789,1777,1768,9,12,6,6,131,129,2,478,478,0,364,364,0
2021,Tameside 027,E02001255,5669,2825,1748,1741,1720,21,7,2,5,185,182,3,577,576,1,334,334,0
2021,Tameside 028,E02001256,8152,3384,3241,3236,3214,22,5,2,3,235,231,4,717,716,1,575,569,6
2021,Tameside 029,E02001257,7479,2901,2791,2781,2764,17,10,0,10,239,238,1,803,803,0,745,744,1
2021,Tameside 030,E02001258,6152,2032,2940,2936,2916,20,4,0,4,124,122,2,575,574,1,481,481,0
2021,Trafford 001,E02001259,9222,4993,2996,2989,2939,50,7,1,6,258,254,4,616,611,5,359,359,0
2021,Trafford 002,E02001260,6154,2000,3178,3164,3152,12,14,6,8,94,93,1,514,513,1,368,368,0
2021,Trafford 003,E02001261,6918,3460,2478,2467,2449,18,11,4,7,167,165,2,526,518,8,287,287,0
2021,Trafford 004,E02001262,6861,2913,3004,2978,2942,36,26,6,20,136,136,0,442,441,1,366,365,1
2021,Trafford 005,E02001263,6859,1988,3733,3720,3709,11,13,2,11,96,95,1,519,519,0,523,523,0
2021,Trafford 006,E02001264,6736,2555,3190,3184,3154,30,6,2,4,114,113,1,512,510,2,365,364,1
2021,Trafford 007,E02001265,6636,2313,3076,3066,3048,18,10,2,8,136,136,0,676,676,0,435,435,0
2021,Trafford 008,E02001266,5578,2273,2271,2265,2248,17,6,2,4,151,151,0,567,565,2,316,313,3
2021,Trafford 009,E02001267,6050,2291,2491,2481,2458,23,10,0,10,137,135,2,638,633,5,493,493,0
2021,Trafford 010,E02001268,5817,1746,3096,3087,3068,19,9,2,7,84,84,0,454,454,0,437,437,0
2021,Trafford 011,E02001269,6713,2918,2666,2652,2612,40,14,0,14,167,165,2,550,549,1,412,411,1
2021,Trafford 012,E02001270,6722,2437,3141,3132,3122,10,9,4,5,132,131,1,583,581,2,429,427,2
2021,Trafford 013,E02001271,5218,1887,2323,2313,2296,17,10,2,8,126,126,0,535,533,2,347,346,1
2021,Trafford 014,E02001272,6367,1948,3355,3342,3312,30,13,8,5,141,140,1,508,508,0,415,415,0
2021,Trafford 015,E02001273,7602,2635,3666,3649,3632,17,17,1,16,151,151,0,718,716,2,432,431,1
2021,Trafford 016,E02001274,6541,1624,3948,3937,3920,17,11,0,11,84,83,1,386,384,2,499,498,1
2021,Trafford 017,E02001275,6214,2813,2109,2104,2087,17,5,2,3,182,182,0,650,649,1,460,460,0
2021,Trafford 018,E02001276,6241,2338,2796,2782,2764,18,14,10,4,141,141,0,575,570,5,391,391,0
2021,Trafford 019,E02001277,7083,2985,2882,2874,2857,17,8,2,6,182,182,0,721,718,3,313,310,3
2021,Trafford 020,E02001278,6757,1904,3933,3925,3907,18,8,5,3,88,88,0,450,449,1,382,379,3
2021,Trafford 021,E02001279,6536,1672,4038,4024,4014,10,14,2,12,73,73,0,397,395,2,356,355,1
2021,Trafford 022,E02001280,6609,2374,2888,2879,2872,7,9,6,3,143,143,0,697,697,0,507,507,0
2021,Trafford 023,E02001281,6177,1523,3690,3672,3660,12,18,10,8,72,70,2,443,442,1,449,449,0
2021,Trafford 024,E02001282,7827,2925,3685,3674,3639,35,11,9,2,123,121,2,699,699,0,395,395,0
2021,Trafford 025,E02001283,7666,2414,4000,3981,3964,17,19,4,15,156,155,1,628,626,2,468,468,0
2021,Trafford 026,E02001284,6268,1692,3712,3705,3666,39,7,4,3,96,94,2,458,456,2,310,310,0
2021,Trafford 027,E02001285,6314,1783,3424,3415,3406,9,9,3,6,103,103,0,543,541,2,461,460,1
2021,Trafford 028,E02001286,6468,1511,3990,3980,3977,3,10,2,8,86,85,1,374,373,1,507,506,1
2021,Wigan 001,E02001287,5435,1823,2733,2727,2704,23,6,0,6,82,82,0,486,483,3,311,311,0
2021,Wigan 002,E02001288,6958,2165,3582,3569,3551,18,13,4,9,130,130,0,597,597,0,484,484,0
2021,Wigan 003,E02001289,8492,2312,4581,4577,4556,21,4,2,2,144,144,0,783,783,0,672,672,0
2021,Wigan 004,E02001290,5142,1623,2539,2518,2510,8,21,10,11,95,95,0,468,467,1,417,417,0
2021,Wigan 005,E02001291,6330,2442,2726,2720,2703,17,6,0,6,157,157,0,596,596,0,409,408,1
2021,Wigan 006,E02001292,6764,2247,3287,3278,3264,14,9,4,5,145,145,0,597,596,1,488,488,0
2021,Wigan 007,E02001293,5221,1730,2584,2565,2555,10,19,10,9,88,87,1,435,433,2,384,384,0
2021,Wigan 008,E02001294,6670,2905,2549,2541,2524,17,8,6,2,175,173,2,631,628,3,410,410,0
2021,Wigan 009,E02001295,5940,2682,1821,1803,1781,22,18,10,8,193,188,5,830,828,2,414,414,0
2021,Wigan 010,E02001296,6643,3357,1929,1918,1908,10,11,5,6,193,190,3,740,739,1,424,424,0
2021,Wigan 011,E02001297,5420,2101,2244,2236,2226,10,8,0,8,133,132,1,552,551,1,390,390,0
2021,Wigan 012,E02001298,6340,2867,2231,2224,2213,11,7,4,3,175,173,2,677,674,3,390,390,0
2021,Wigan 013,E02001299,7213,2747,3080,3061,3044,17,19,10,9,177,175,2,690,689,1,519,519,0
2021,Wigan 014,E02001300,6473,2608,2518,2507,2492,15,11,10,1,170,168,2,665,665,0,512,511,1
2021,Wigan 015,E02001301,7258,3261,2474,2468,2448,20,6,4,2,201,196,5,834,834,0,488,488,0
2021,Wigan 016,E02001302,6403,2434,2650,2646,2641,5,4,2,2,139,139,0,622,619,3,558,558,0
2021,Wigan 017,E02001303,6989,3181,2448,2436,2407,29,12,2,10,230,228,2,749,744,5,381,380,1
2021,Wigan 018,E02001304,10563,3166,5448,5431,5411,20,17,6,11,207,207,0,946,946,0,796,795,1
2021,Wigan 019,E02001305,7093,2309,3576,3566,3541,25,10,4,6,102,100,2,597,597,0,509,508,1
2021,Wigan 020,E02001306,6000,1889,3073,3063,3056,7,10,0,10,98,98,0,544,544,0,396,396,0
2021,Wigan 021,E02001307,9497,2722,5381,5375,5363,12,6,2,4,144,142,2,727,726,1,523,523,0
2021,Wigan 022,E02001308,4996,1757,2198,2196,2192,4,2,0,2,110,110,0,543,543,0,388,388,0
2021,Wigan 023,E02001309,6888,2681,2740,2734,2718,16,6,4,2,180,180,0,787,784,3,500,500,0
2021,Wigan 024,E02001310,7257,3094,2822,2806,2791,15,16,6,10,167,166,1,725,723,2,449,448,1
2021,Wigan 025,E02001311,6728,2615,2803,2793,2783,10,10,6,4,165,165,0,738,737,1,407,406,1
2021,Wigan 026,E02001312,7005,3081,2767,2760,2739,21,7,0,7,178,177,1,626,625,1,353,353,0
2021,Wigan 027,E02001313,6472,2594,2533,2522,2502,20,11,3,8,182,178,4,702,701,1,461,461,0
2021,Wigan 028,E02001314,6334,2062,3264,3260,3248,12,4,4,0,115,115,0,557,555,2,336,335,1
2021,Wigan 029,E02001315,7680,2738,3676,3668,3636,32,8,4,4,134,134,0,679,677,2,453,451,2
2021,Wigan 030,E02001316,5933,2871,1834,1824,1809,15,10,4,6,219,217,2,695,694,1,314,313,1
2021,Wigan 031,E02001317,7387,2872,3130,3124,3112,12,6,1,5,194,193,1,667,667,0,524,523,1
2021,Wigan 032,E02001318,6496,2309,2905,2895,2887,8,10,6,4,142,138,4,623,622,1,517,517,0
2021,Wigan 033,E02001319,6734,2951,2372,2356,2342,14,16,10,6,181,180,1,762,760,2,468,468,0
2021,Wigan 034,E02001320,6091,2394,2415,2410,2396,14,5,2,3,148,147,1,677,675,2,457,457,0
2021,Wigan 035,E02001321,6587,2111,3260,3256,3230,26,4,2,2,152,152,0,583,583,0,481,480,1
2021,Wigan 036,E02001322,6086,1936,2881,2876,2872,4,5,0,5,140,140,0,604,604,0,525,525,0
2021,Wigan 037,E02001323,6343,2131,2941,2930,2918,12,11,8,3,143,141,2,663,659,4,465,464,1
2021,Wigan 038,E02001324,6669,2647,2690,2674,2655,19,16,6,10,161,161,0,696,693,3,475,475,0
2021,Wigan 039,E02001325,7463,2421,3743,3735,3717,18,8,2,6,146,146,0,659,658,1,494,493,1
2021,Wigan 040,E02001326,6701,2235,3288,3284,3262,22,4,2,2,119,119,0,595,593,2,464,461,3
2021,Birmingham 001,E02001827,5183,1441,2809,2805,2798,7,4,4,0,86,86,0,430,429,1,417,417,0
2021,Birmingham 002,E02001828,5859,1649,3084,3079,3068,11,5,2,3,110,110,0,506,506,0,510,510,0
2021,Birmingham 003,E02001829,7135,1865,4208,4203,4185,18,5,2,3,81,81,0,516,516,0,465,465,0
2021,Birmingham 004,E02001830,8124,2152,4788,4777,4767,10,11,2,9,106,106,0,489,489,0,589,589,0
2021,Birmingham 005,E02001831,8332,3252,3461,3445,3432,13,16,6,10,215,214,1,863,863,0,541,541,0
2021,Birmingham 006,E02001832,6586,1994,3522,3502,3491,11,20,5,15,108,106,2,509,509,0,453,452,1
2021,Birmingham 007,E02001833,4814,1571,2542,2536,2529,7,6,4,2,83,83,0,324,323,1,294,292,2
2021,Birmingham 008,E02001834,4645,2116,1692,1677,1671,6,15,8,7,130,126,4,443,443,0,264,264,0
2021,Birmingham 009,E02001835,6969,2507,3236,3221,3203,18,15,4,11,116,116,0,607,606,1,503,502,1
2021,Birmingham 010,E02001836,7458,2265,4086,4066,4041,25,20,1,19,139,138,1,486,486,0,482,480,2
2021,Birmingham 011,E02001837,8001,3983,2577,2573,2562,11,4,4,0,271,267,4,734,734,0,436,436,0
2021,Birmingham 012,E02001838,6334,1794,3512,3506,3492,14,6,2,4,91,91,0,469,469,0,468,467,1
2021,Birmingham 013,E02001839,5182,2111,2043,2031,2023,8,12,6,6,129,128,1,485,483,2,414,414,0
2021,Birmingham 014,E02001840,7270,3493,2381,2362,2352,10,19,8,11,244,241,3,724,724,0,428,428,0
2021,Birmingham 015,E02001841,5014,1274,2981,2975,2969,6,6,0,6,79,78,1,280,278,2,400,400,0
2021,Birmingham 016,E02001842,6420,2455,2921,2917,2906,11,4,2,2,162,160,2,485,483,2,397,396,1
2021,Birmingham 017,E02001843,5306,2269,2150,2142,2124,18,8,4,4,117,117,0,427,426,1,343,343,0
2021,Birmingham 018,E02001844,8175,3040,3425,3405,3370,35,20,2,18,192,192,0,782,781,1,736,736,0
2021,Birmingham 019,E02001845,5190,2178,2142,2136,2126,10,6,4,2,114,113,1,487,487,0,269,269,0
2021,Birmingham 020,E02001846,6316,2945,2189,2174,2162,12,15,5,10,202,201,1,624,624,0,356,356,0
2021,Birmingham 021,E02001847,4571,1477,2341,2337,2332,5,4,0,4,69,69,0,388,388,0,296,296,0
2021,Birmingham 022,E02001848,5373,2519,1933,1918,1913,5,15,10,5,167,165,2,413,412,1,341,340,1
2021,Birmingham 023,E02001849,6492,3405,1926,1899,1887,12,27,14,13,221,219,2,685,682,3,255,255,0
2021,Birmingham 024,E02001850,6634,2620,3061,3057,3045,12,4,0,4,161,161,0,412,411,1,380,380,0
2021,Birmingham 025,E02001851,7242,3127,2780,2746,2731,15,34,4,30,201,200,1,668,667,1,466,466,0
2021,Birmingham 026,E02001852,5592,2563,2059,2043,2032,11,16,10,6,161,161,0,477,477,0,332,332,0
2021,Birmingham 029,E02001855,7730,3949,2188,2182,2175,7,6,3,3,234,234,0,794,793,1,565,564,1
2021,Birmingham 030,E02001856,7343,3550,2752,2713,2700,13,39,0,39,227,227,0,529,527,2,285,284,1
2021,Birmingham 031,E02001857,11134,5945,3359,3324,3303,21,35,20,15,374,370,4,1005,1002,3,451,451,0
2021,Birmingham 032,E02001858,7382,3668,2604,2598,2587,11,6,4,2,229,226,3,567,566,1,314,313,1
2021,Birmingham 033,E02001859,7666,3038,3657,3648,3632,16,9,7,2,221,221,0,399,399,0,351,351,0
2021,Birmingham 034,E02001860,6342,2572,2837,2814,2809,5,23,20,3,186,186,0,419,416,3,328,328,0
2021,Birmingham 035,E02001861,8297,3780,3449,3434,3422,12,15,8,7,240,239,1,481,481,0,347,347,0
2021,Birmingham 036,E02001862,7506,3075,3232,3223,3217,6,9,6,3,278,276,2,496,496,0,425,425,0
2021,Birmingham 037,E02001863,6173,2644,2693,2685,2680,5,8,4,4,188,188,0,349,347,2,299,299,0
2021,Birmingham 039,E02001865,8593,3533,3871,3863,3854,9,8,4,4,281,280,1,464,464,0,444,442,2
2021,Birmingham 040,E02001866,7161,3214,2985,2979,2972,7,6,3,3,219,218,1,388,388,0,355,355,0
2021,Birmingham 041,E02001867,6221,2838,2528,2522,2510,12,6,4,2,220,220,0,332,332,0,303,303,0
2021,Birmingham 042,E02001868,7197,2692,3738,3728,3719,9,10,6,4,149,149,0,279,279,0,339,339,0
2021,Birmingham 043,E02001869,4650,2282,1572,1565,1555,10,7,6,1,217,216,1,382,382,0,197,197,0
2021,Birmingham 044,E02001870,9172,3501,4516,4515,4500,15,1,0,1,291,291,0,441,441,0,423,423,0
2021,Birmingham 045,E02001871,6386,2926,2179,2155,2138,17,24,8,16,192,192,0,606,606,0,483,483,0
2021,Birmingham 046,E02001872,5638,2818,1744,1737,1726,11,7,2,5,149,149,0,550,548,2,377,377,0
2021,Birmingham 047,E02001873,8420,4184,2938,2916,2902,14,22,18,4,360,359,1,599,598,1,339,339,0
2021,Birmingham 048,E02001874,7036,2809,3327,3323,3310,13,4,4,0,248,247,1,330,330,0,322,322,0
2021,Birmingham 049,E02001875,6477,3461,2133,2117,2103,14,16,6,10,258,257,1,388,388,0,237,236,1
2021,Birmingham 050,E02001876,13701,10845,2005,1988,1977,11,17,8,9,228,225,3,424,422,2,199,199,0
2021,Birmingham 051,E02001877,8741,3503,4165,4157,4143,14,8,6,2,293,292,1,389,389,0,391,391,0
2021,Birmingham 052,E02001878,6812,2876,3032,3017,3003,14,15,8,7,216,216,0,393,392,1,295,295,0
2021,Birmingham 053,E02001879,7679,3805,2814,2806,2785,21,8,4,4,221,221,0,469,467,2,370,370,0
2021,Birmingham 054,E02001880,7085,3436,2481,2471,2464,7,10,10,0,226,225,1,590,588,2,352,352,0
2021,Birmingham 055,E02001881,7331,2951,3462,3451,3436,15,11,8,3,237,237,0,365,365,0,316,315,1
2021,Birmingham 056,E02001882,6678,2778,2808,2806,2786,20,2,2,0,193,192,1,491,491,0,408,408,0
2021,Birmingham 057,E02001883,6389,3169,2010,2000,1977,23,10,0,10,208,207,1,606,606,0,396,396,0
2021,Birmingham 058,E02001884,6910,2673,3467,3459,3451,8,8,6,2,207,207,0,281,281,0,282,282,0
2021,Birmingham 060,E02001886,8069,3819,3308,3297,3264,33,11,0,11,201,201,0,434,434,0,307,307,0
2021,Birmingham 062,E02001888,5319,2358,2021,2004,1997,7,17,10,7,148,145,3,409,407,2,383,382,1
2021,Birmingham 063,E02001889,6473,2470,3290,3286,3277,9,4,2,2,174,174,0,245,245,0,294,294,0
2021,Birmingham 064,E02001890,8503,4373,2997,2968,2935,33,29,4,25,217,217,0,578,575,3,338,337,1
2021,Birmingham 066,E02001892,7975,3189,3705,3694,3684,10,11,10,1,233,233,0,493,493,0,355,355,0
2021,Birmingham 067,E02001893,6880,2590,3142,3133,3123,10,9,2,7,138,136,2,559,557,2,451,451,0
2021,Birmingham 069,E02001895,6910,3179,2380,2368,2358,10,12,6,6,198,196,2,647,644,3,506,504,2
2021,Birmingham 070,E02001896,7211,2688,3641,3635,3627,8,6,6,0,210,210,0,288,288,0,384,384,0
2021,Birmingham 071,E02001897,6262,2847,2437,2427,2416,11,10,3,7,282,281,1,427,427,0,269,268,1
2021,Birmingham 072,E02001898,5331,1961,2523,2515,2502,13,8,6,2,116,115,1,386,384,2,345,344,1
2021,Birmingham 073,E02001899,6953,2136,3684,3665,3642,23,19,4,15,122,122,0,476,476,0,535,535,0
2021,Birmingham 074,E02001900,5393,2503,1980,1960,1937,23,20,2,18,163,163,0,471,469,2,276,274,2
2021,Birmingham 075,E02001901,6804,3108,2765,2739,2701,38,26,8,18,126,122,4,505,501,4,300,300,0
2021,Birmingham 076,E02001902,4889,1962,2160,2151,2149,2,9,4,5,110,110,0,369,369,0,288,288,0
2021,Birmingham 077,E02001903,5842,2175,2828,2825,2800,25,3,3,0,198,198,0,324,324,0,317,317,0
2021,Birmingham 078,E02001904,5615,2365,2404,2392,2387,5,12,6,6,166,165,1,394,394,0,286,286,0
2021,Birmingham 079,E02001905,9185,6088,2413,2390,2371,19,23,4,19,73,72,1,305,296,9,306,306,0
2021,Birmingham 080,E02001906,7667,3070,3363,3358,3338,20,5,0,5,190,190,0,609,608,1,435,435,0
2021,Birmingham 081,E02001907,8449,3413,3554,3547,3526,21,7,0,7,192,191,1,740,738,2,550,547,3
2021,Birmingham 082,E02001908,6526,2428,3305,3303,3285,18,2,2,0,206,205,1,257,257,0,330,330,0
2021,Birmingham 083,E02001909,6015,2514,2755,2751,2734,17,4,4,0,182,180,2,313,313,0,251,251,0
2021,Birmingham 084,E02001910,5432,2431,2221,2214,2186,28,7,4,3,178,178,0,318,318,0,284,284,0
2021,Birmingham 085,E02001911,6388,3046,2221,2212,2201,11,9,2,7,213,213,0,590,588,2,318,317,1
2021,Birmingham 087,E02001913,6277,3496,1875,1864,1848,16,11,2,9,122,120,2,461,461,0,323,321,2
2021,Birmingham 088,E02001914,5583,2349,2473,2457,2434,23,16,1,15,131,131,0,323,322,1,307,307,0
2021,Birmingham 089,E02001915,9532,4146,3680,3662,3608,54,18,14,4,256,255,1,864,860,4,586,584,2
2021,Birmingham 090,E02001916,7267,3014,3233,3217,3212,5,16,6,10,216,216,0,477,477,0,327,327,0
2021,Birmingham 092,E02001918,7256,3651,2472,2425,2392,33,47,18,29,171,170,1,627,627,0,335,335,0
2021,Birmingham 093,E02001919,5720,2555,2345,2329,2319,10,16,5,11,126,126,0,373,370,3,321,318,3
2021,Birmingham 094,E02001920,5933,2729,2151,2147,2134,13,4,4,0,164,164,0,561,561,0,328,328,0
2021,Birmingham 095,E02001921,6024,2672,2366,2356,2342,14,10,2,8,156,153,3,510,510,0,320,319,1
2021,Birmingham 096,E02001922,15228,13984,846,843,823,20,3,2,1,94,92,2,178,178,0,126,126,0
2021,Birmingham 097,E02001923,8514,3130,4230,4226,4211,15,4,2,2,183,183,0,462,462,0,509,508,1
2021,Birmingham 098,E02001924,5443,2024,2575,2566,2559,7,9,2,7,145,145,0,425,425,0,274,274,0
2021,Birmingham 099,E02001925,5493,2394,2205,2199,2178,21,6,2,4,113,113,0,405,401,4,376,376,0
2021,Birmingham 100,E02001926,6546,3360,2330,2310,2286,24,20,2,18,119,118,1,412,411,1,325,325,0
2021,Birmingham 101,E02001927,5817,2667,2073,2068,2062,6,5,1,4,173,172,1,523,521,2,381,381,0
2021,Birmingham 102,E02001928,5385,2363,1956,1947,1933,14,9,0,9,150,150,0,577,576,1,339,339,0
2021,Birmingham 103,E02001929,7521,3420,2911,2905,2889,16,6,2,4,254,254,0,572,570,2,364,364,0
2021,Birmingham 104,E02001930,6232,2744,2576,2534,2512,22,42,8,34,124,121,3,501,494,7,287,286,1
2021,Birmingham 105,E02001931,6834,2373,3427,3422,3407,15,5,4,1,155,154,1,469,468,1,410,410,0
2021,Birmingham 106,E02001932,5567,2663,1888,1872,1859,13,16,6,10,174,174,0,537,537,0,305,305,0
2021,Birmingham 107,E02001933,6061,2799,2223,2207,2183,24,16,8,8,169,169,0,537,535,2,333,332,1
2021,Birmingham 108,E02001934,5551,1967,2838,2833,2827,6,5,2,3,93,93,0,303,303,0,350,350,0
2021,Birmingham 109,E02001935,6347,2356,2834,2821,2797,24,13,4,9,166,166,0,514,513,1,477,477,0
2021,Birmingham 110,E02001936,5118,1668,2692,2673,2650,23,19,5,14,76,76,0,333,333,0,349,349,0
2021,Birmingham 111,E02001937,6352,2808,2494,2475,2463,12,19,6,13,168,168,0,530,529,1,352,351,1
2021,Birmingham 112,E02001938,6452,3128,2346,2330,2302,28,16,4,12,148,143,5,539,536,3,291,291,0
2021,Birmingham 113,E02001939,5192,1918,2135,2132,2124,8,3,0,3,143,142,1,524,522,2,472,472,0
2021,Birmingham 115,E02001941,4886,2204,1741,1723,1718,5,18,8,10,165,165,0,453,453,0,323,323,0
2021,Birmingham 116,E02001942,5444,2360,2062,2048,2028,20,14,6,8,149,148,1,518,516,2,355,355,0
2021,Birmingham 117,E02001943,5127,2250,2011,1999,1980,19,12,6,6,120,119,1,452,450,2,294,294,0
2021,Birmingham 118,E02001944,6477,2850,2523,2508,2487,21,15,0,15,132,130,2,638,636,2,334,334,0
2021,Birmingham 119,E02001945,5906,2970,1889,1881,1868,13,8,8,0,171,171,0,615,615,0,261,261,0
2021,Birmingham 120,E02001946,6219,2229,2932,2913,2901,12,19,7,12,127,127,0,545,543,2,386,386,0
2021,Birmingham 121,E02001947,4652,2338,1355,1349,1345,4,6,4,2,142,141,1,524,523,1,293,292,1
2021,Birmingham 122,E02001948,5903,2429,2384,2375,2361,14,9,0,9,188,188,0,516,514,2,386,386,0
2021,Birmingham 123,E02001949,4734,2206,1648,1637,1628,9,11,6,5,129,128,1,461,460,1,290,290,0
2021,Birmingham 124,E02001950,6967,2739,2961,2949,2929,20,12,6,6,167,164,3,623,621,2,477,476,1
2021,Birmingham 125,E02001951,7123,3562,2167,2150,2126,24,17,12,5,219,219,0,799,796,3,376,376,0
2021,Birmingham 126,E02001952,6954,3447,2016,1997,1979,18,19,8,11,235,234,1,862,861,1,394,393,1
2021,Birmingham 127,E02001953,5785,2134,2674,2665,2639,26,9,0,9,113,113,0,451,451,0,413,413,0
2021,Birmingham 128,E02001954,5689,2788,1716,1713,1703,10,3,2,1,194,193,1,679,679,0,312,312,0
2021,Birmingham 129,E02001955,6327,2932,2099,2091,2069,22,8,4,4,191,190,1,689,688,1,416,416,0
2021,Birmingham 130,E02001956,5404,2323,2090,2088,2067,21,2,0,2,151,149,2,550,550,0,290,290,0
2021,Birmingham 131,E02001957,6338,2634,2628,2618,2611,7,10,4,6,115,115,0,556,556,0,405,405,0
2021,Birmingham 132,E02006807,6439,2167,3395,3391,3379,12,4,2,2,125,125,0,379,378,1,373,373,0
2021,Birmingham 133,E02006809,8256,2759,4423,4415,4398,17,8,8,0,157,156,1,408,408,0,509,509,0
2021,Birmingham 134,E02006895,7735,5237,1773,1751,1737,14,22,12,10,159,156,3,410,410,0,156,154,2
2021,Birmingham 135,E02006896,5398,3768,1151,1139,1102,37,12,4,8,122,121,1,263,259,4,94,94,0
2021,Birmingham 136,E02006897,7107,4911,1464,1452,1438,14,12,5,7,211,210,1,390,390,0,131,131,0
2021,Birmingham 137,E02006898,6928,4834,1453,1426,1395,31,27,8,19,162,159,3,379,378,1,100,99,1
2021,Birmingham 138,E02006899,5844,4359,1022,1020,984,36,2,0,2,121,121,0,287,286,1,55,54,1
2021,Birmingham 139,E02006900,11095,4399,5416,5407,5389,18,9,8,1,335,335,0,459,459,0,486,486,0
2021,Birmingham 141,E02007038,10292,4489,4011,4000,3972,28,11,4,7,310,309,1,881,880,1,601,599,2
2021,Birmingham 142,E02007039,5995,2216,3049,3043,3032,11,6,6,0,154,153,1,276,276,0,300,300,0
2021,Birmingham 143,E02007040,5195,1864,2701,2698,2689,9,3,3,0,175,175,0,264,264,0,191,191,0
2021,Coventry 001,E02001958,6428,2772,2471,2462,2447,15,9,2,7,151,151,0,675,674,1,359,359,0
2021,Coventry 002,E02001959,5461,2028,2525,2523,2508,15,2,0,2,115,115,0,438,438,0,355,355,0
2021,Coventry 004,E02001961,6085,2696,2247,2243,2237,6,4,0,4,174,174,0,609,609,0,359,358,1
2021,Coventry 005,E02001962,5403,2216,2361,2359,2347,12,2,0,2,155,154,1,406,405,1,265,265,0
2021,Coventry 006,E02001963,5050,1813,2306,2304,2280,24,2,0,2,98,98,0,485,483,2,348,348,0
2021,Coventry 007,E02001964,7825,3661,2779,2754,2740,14,25,14,11,291,291,0,732,729,3,362,360,2
2021,Coventry 008,E02001965,6542,2285,3061,3036,3026,10,25,20,5,165,165,0,592,591,1,439,439,0
2021,Coventry 009,E02001966,5418,2245,2533,2525,2519,6,8,6,2,145,144,1,275,275,0,220,220,0
2021,Coventry 010,E02001967,5762,1742,2962,2949,2935,14,13,4,9,83,82,1,523,523,0,452,452,0
2021,Coventry 011,E02001968,6007,2404,2676,2653,2638,15,23,10,13,170,170,0,463,463,0,294,294,0
2021,Coventry 012,E02001969,5315,2253,2023,2017,2009,8,6,2,4,147,144,3,545,544,1,347,347,0
2021,Coventry 013,E02001970,4694,1674,2056,2049,2040,9,7,6,1,115,115,0,430,430,0,419,419,0
2021,Coventry 014,E02001971,4924,1756,2330,2322,2299,23,8,7,1,109,109,0,462,462,0,267,267,0
2021,Coventry 015,E02001972,8506,3524,3735,3720,3708,12,15,8,7,326,324,2,592,590,2,329,329,0
2021,Coventry 016,E02001973,6634,2970,2502,2477,2471,6,25,16,9,192,190,2,653,652,1,317,317,0
2021,Coventry 017,E02001974,7693,2776,3596,3588,3567,21,8,6,2,149,148,1,697,694,3,475,475,0
2021,Coventry 018,E02001975,5997,2197,2758,2749,2742,7,9,8,1,133,133,0,550,548,2,359,359,0
2021,Coventry 019,E02001976,5960,2153,2675,2665,2657,8,10,10,0,159,159,0,592,592,0,381,381,0
2021,Coventry 020,E02001977,8171,4439,2456,2451,2429,22,5,2,3,211,208,3,709,708,1,356,356,0
2021,Coventry 021,E02001978,5327,2027,2471,2459,2447,12,12,12,0,118,117,1,418,418,0,293,293,0
2021,Coventry 022,E02001979,4634,1500,2251,2242,2232,10,9,4,5,85,85,0,387,385,2,411,411,0
2021,Coventry 023,E02001980,4927,1336,2687,2676,2671,5,11,4,7,91,89,2,401,401,0,412,411,1
2021,Coventry 024,E02001981,10421,6091,3200,3165,3152,13,35,22,13,261,261,0,546,546,0,323,323,0
2021,Coventry 025,E02001982,6816,2536,3117,3109,3093,16,8,4,4,167,167,0,610,607,3,386,386,0
2021,Coventry 026,E02001983,6252,2578,2589,2581,2562,19,8,2,6,123,122,1,613,613,0,349,349,0
2021,Coventry 027,E02001984,8289,3365,3639,3608,3590,18,31,20,11,155,154,1,709,706,3,421,421,0
2021,Coventry 028,E02001985,8217,6324,1298,1293,1291,2,5,4,1,121,121,0,321,320,1,153,153,0
2021,Coventry 029,E02001986,6362,2899,2224,2207,2188,19,17,10,7,168,167,1,709,707,2,362,361,1
2021,Coventry 030,E02001987,5210,3238,1183,1170,1157,13,13,2,11,99,96,3,438,436,2,252,252,0
2021,Coventry 031,E02001988,10342,8088,1336,1326,1309,17,10,6,4,137,137,0,572,572,0,209,207,2
2021,Coventry 032,E02001989,5040,2232,2026,2016,1996,20,10,8,2,114,111,3,407,407,0,261,261,0
2021,Coventry 033,E02001990,7541,2326,3942,3925,3907,18,17,16,1,141,141,0,585,584,1,547,547,0
2021,Coventry 034,E02001991,7273,2637,3408,3399,3375,24,9,8,1,113,112,1,577,577,0,538,538,0
2021,Coventry 035,E02001992,8116,3477,3182,3158,3145,13,24,16,8,246,244,2,744,743,1,467,467,0
2021,Coventry 036,E02001993,7399,3925,2457,2448,2436,12,9,4,5,147,146,1,536,536,0,334,334,0
2021,Coventry 037,E02001994,6450,2225,3201,3192,3184,8,9,2,7,118,114,4,492,491,1,414,414,0
2021,Coventry 038,E02001995,7605,3254,3078,3059,3021,38,19,8,11,182,181,1,621,621,0,470,470,0
2021,Coventry 039,E02001996,5744,2745,1888,1853,1846,7,35,25,10,197,197,0,585,583,2,329,328,1
2021,Coventry 040,E02001997,7013,1832,4096,4091,4083,8,5,0,5,88,88,0,447,446,1,550,550,0
2021,Coventry 041,E02001998,4895,1428,2701,2699,2695,4,2,0,2,72,67,5,352,352,0,342,342,0
2021,Coventry 042,E02001999,8239,5210,2402,2393,2384,9,9,2,7,60,60,0,267,267,0,300,299,1
2021,Coventry 043,E02006805,6895,2865,2889,2877,2853,24,12,10,2,192,189,3,596,595,1,353,353,0
2021,Dudley 001,E02002000,6811,2867,2723,2715,2708,7,8,2,6,208,207,1,560,558,2,453,452,1
2021,Dudley 002,E02002001,5018,1907,2145,2136,2125,11,9,4,5,127,126,1,479,476,3,360,360,0
2021,Dudley 003,E02002002,5947,1484,3449,3445,3437,8,4,2,2,69,69,0,401,399,2,544,544,0
2021,Dudley 004,E02002003,7432,2574,3497,3494,3474,20,3,3,0,155,154,1,630,629,1,576,576,0
2021,Dudley 005,E02002004,6038,2395,2508,2502,2490,12,6,2,4,167,167,0,493,490,3,475,475,0
2021,Dudley 006,E02002005,7281,3244,2900,2858,2840,18,42,36,6,195,195,0,545,545,0,397,397,0
2021,Dudley 007,E02002006,5195,2062,2109,2101,2096,5,8,2,6,149,148,1,541,539,2,334,334,0
2021,Dudley 008,E02002007,7511,2444,3663,3654,3636,18,9,2,7,150,150,0,575,572,3,679,679,0
2021,Dudley 009,E02002008,6732,2279,3521,3511,3505,6,10,8,2,140,140,0,452,452,0,340,340,0
2021,Dudley 010,E02002009,5304,2224,2270,2267,2258,9,3,2,1,143,143,0,401,401,0,266,265,1
2021,Dudley 011,E02002010,6583,2898,2296,2291,2277,14,5,2,3,206,206,0,711,710,1,472,472,0
2021,Dudley 012,E02002011,4982,1414,2622,2619,2607,12,3,0,3,97,97,0,440,438,2,409,409,0
2021,Dudley 013,E02002012,6720,2720,2539,2523,2514,9,16,6,10,215,215,0,681,680,1,565,564,1
2021,Dudley 014,E02002013,5632,1468,3099,3088,3081,7,11,4,7,101,101,0,428,428,0,536,536,0
2021,Dudley 015,E02002014,6308,2750,2605,2594,2576,18,11,6,5,177,177,0,440,438,2,336,336,0
2021,Dudley 016,E02002015,5703,2072,2694,2686,2674,12,8,2,6,102,102,0,463,463,0,372,372,0
2021,Dudley 017,E02002016,6198,2746,2300,2285,2272,13,15,4,11,172,172,0,569,569,0,411,411,0
2021,Dudley 018,E02002017,6445,2541,2645,2641,2634,7,4,4,0,156,152,4,652,652,0,451,450,1
2021,Dudley 019,E02002018,7496,2017,4189,4189,4169,20,0,0,0,113,113,0,514,514,0,663,663,0
2021,Dudley 020,E02002019,6055,2502,2577,2563,2549,14,14,4,10,153,153,0,459,459,0,364,364,0
2021,Dudley 021,E02002020,7970,2521,3908,3900,3869,31,8,0,8,155,155,0,726,724,2,660,660,0
2021,Dudley 022,E02002021,6236,2968,1966,1956,1940,16,10,4,6,197,193,4,697,691,6,408,408,0
2021,Dudley 023,E02002022,6940,2837,2719,2708,2688,20,11,4,7,245,244,1,758,756,2,381,381,0
2021,Dudley 024,E02002023,4485,1493,2165,2156,2135,21,9,0,9,93,93,0,419,418,1,315,315,0
2021,Dudley 025,E02002024,7052,2684,3207,3189,3175,14,18,10,8,147,146,1,582,581,1,432,432,0
2021,Dudley 026,E02002025,7059,2741,3070,3059,3001,58,11,2,9,192,189,3,634,633,1,422,422,0
2021,Dudley 027,E02002026,5669,1751,2936,2931,2920,11,5,2,3,91,91,0,492,492,0,399,399,0
2021,Dudley 028,E02002027,4574,1299,2616,2610,2599,11,6,2,4,97,97,0,369,369,0,193,193,0
2021,Dudley 029,E02002028,4841,1457,2362,2356,2352,4,6,4,2,84,84,0,473,473,0,465,465,0
2021,Dudley 030,E02002029,5118,1658,2579,2579,2565,14,0,0,0,79,78,1,388,388,0,414,414,0
2021,Dudley 031,E02002030,5502,2163,2205,2194,2186,8,11,4,7,140,140,0,586,586,0,408,407,1
2021,Dudley 032,E02002031,5106,1859,2367,2358,2345,13,9,4,5,131,129,2,451,451,0,298,298,0
2021,Dudley 033,E02002032,8107,3288,3287,3261,3237,24,26,6,20,188,187,1,855,853,2,489,489,0
2021,Dudley 034,E02002033,6373,2258,3015,3010,2992,18,5,0,5,110,110,0,549,548,1,441,440,1
2021,Dudley 035,E02002034,6811,2656,2668,2654,2640,14,14,4,10,182,181,1,854,852,2,451,450,1
2021,Dudley 036,E02002035,5075,1394,2869,2856,2848,8,13,5,8,79,79,0,351,351,0,382,381,1
2021,Dudley 037,E02002036,5310,2158,2091,2087,2076,11,4,0,4,169,169,0,564,563,1,328,327,1
2021,Dudley 038,E02002037,4906,1575,2427,2425,2413,12,2,2,0,83,82,1,487,484,3,334,334,0
2021,Dudley 039,E02002038,7940,2964,3299,3294,3266,28,5,2,3,227,223,4,862,862,0,588,588,0
2021,Dudley 040,E02002039,5136,1631,2461,2456,2438,18,5,2,3,170,170,0,442,439,3,432,432,0
2021,Dudley 041,E02002040,5028,1170,3004,2997,2986,11,7,3,4,62,62,0,349,349,0,443,443,0
2021,Dudley 042,E02002041,5205,1312,2888,2880,2875,5,8,2,6,82,82,0,417,417,0,506,506,0
2021,Dudley 043,E02002042,6646,1783,3682,3678,3665,13,4,0,4,113,112,1,535,535,0,533,533,0
2021,Sandwell 001,E02002043,6807,2789,2907,2901,2887,14,6,3,3,160,160,0,513,509,4,438,437,1
2021,Sandwell 002,E02002044,6186,2464,2752,2746,2737,9,6,2,4,154,154,0,475,475,0,341,341,0
2021,Sandwell 003,E02002045,6129,2412,2616,2611,2601,10,5,0,5,155,154,1,502,502,0,444,444,0
2021,Sandwell 004,E02002046,4150,1795,1635,1633,1623,10,2,2,0,129,129,0,309,308,1,282,281,1
2021,Sandwell 005,E02002047,6157,2328,2632,2625,2611,14,7,1,6,165,164,1,524,523,1,508,506,2
2021,Sandwell 006,E02002048,5715,1756,2951,2944,2937,7,7,0,7,123,123,0,434,434,0,451,450,1
2021,Sandwell 007,E02002049,4978,1996,2212,2205,2201,4,7,4,3,115,115,0,356,356,0,299,299,0
2021,Sandwell 009,E02002051,4503,2011,1736,1728,1721,7,8,4,4,137,137,0,335,335,0,284,284,0
2021,Sandwell 010,E02002052,8802,3634,3659,3654,3638,16,5,2,3,203,202,1,687,687,0,619,619,0
2021,Sandwell 011,E02002053,5066,1844,2286,2282,2278,4,4,2,2,138,138,0,421,419,2,377,377,0
2021,Sandwell 012,E02002054,4732,1767,2142,2135,2129,6,7,5,2,108,108,0,365,365,0,350,350,0
2021,Sandwell 013,E02002055,8638,3320,3881,3868,3851,17,13,11,2,231,229,2,642,641,1,564,564,0
2021,Sandwell 014,E02002056,7462,3341,2825,2799,2793,6,26,16,10,207,206,1,601,598,3,488,488,0
2021,Sandwell 015,E02002057,8406,3332,3525,3520,3501,19,5,0,5,273,272,1,713,710,3,563,563,0
2021,Sandwell 016,E02002058,10591,4219,4631,4616,4596,20,15,10,5,300,298,2,851,849,2,590,589,1
2021,Sandwell 017,E02002059,9410,3601,4147,4133,4114,19,14,2,12,252,252,0,765,764,1,645,644,1
2021,Sandwell 018,E02002060,5486,2180,2460,2452,2441,11,8,7,1,127,127,0,378,377,1,341,341,0
2021,Sandwell 019,E02002061,5479,2116,2520,2518,2514,4,2,2,0,128,128,0,366,365,1,349,349,0
2021,Sandwell 020,E02002062,7048,2960,2900,2895,2876,19,5,4,1,183,183,0,566,566,0,439,439,0
2021,Sandwell 021,E02002063,7946,3112,3505,3489,3464,25,16,8,8,219,218,1,682,682,0,428,428,0
2021,Sandwell 022,E02002064,9664,3813,4316,4307,4298,9,9,4,5,220,218,2,806,805,1,509,509,0
2021,Sandwell 023,E02002065,10569,3772,5444,5431,5406,25,13,4,9,278,278,0,519,516,3,556,556,0
2021,Sandwell 024,E02002066,6258,2514,2750,2744,2728,16,6,4,2,158,158,0,518,518,0,318,318,0
2021,Sandwell 025,E02002067,5019,1856,2338,2330,2316,14,8,2,6,99,98,1,337,337,0,389,387,2
2021,Sandwell 027,E02002069,5675,2307,2233,2223,2209,14,10,8,2,158,158,0,551,551,0,426,426,0
2021,Sandwell 028,E02002070,7720,3125,3301,3294,3278,16,7,4,3,220,220,0,557,551,6,517,517,0
2021,Sandwell 029,E02002071,5254,2127,2114,2109,2096,13,5,1,4,167,164,3,454,454,0,392,392,0
2021,Sandwell 030,E02002072,7155,2711,3038,3030,3015,15,8,6,2,214,214,0,742,742,0,450,449,1
2021,Sandwell 031,E02002073,6381,2513,2748,2741,2736,5,7,2,5,149,148,1,539,538,1,432,432,0
2021,Sandwell 032,E02002074,6508,2463,2873,2866,2861,5,7,6,1,182,182,0,506,506,0,484,484,0
2021,Sandwell 033,E02002075,7082,2751,2941,2933,2912,21,8,2,6,180,180,0,680,679,1,530,530,0
2021,Sandwell 034,E02002076,8496,3900,3238,3216,3165,51,22,6,16,259,258,1,702,698,4,397,393,4
2021,Sandwell 035,E02002077,8671,3503,3533,3517,3503,14,16,6,10,228,227,1,828,825,3,579,579,0
2021,Sandwell 036,E02002078,5290,1753,2683,2682,2670,12,1,0,1,97,97,0,360,359,1,397,396,1
2021,Sandwell 037,E02002079,6849,2675,2899,2894,2883,11,5,3,2,173,171,2,637,636,1,465,465,0
2021,Sandwell 038,E02002080,5786,2307,2380,2371,2363,8,9,6,3,153,153,0,565,565,0,381,381,0
2021,Sandwell 039,E02006810,8780,3184,4148,4136,4122,14,12,8,4,245,245,0,617,615,2,586,586,0
2021,Sandwell 040,E02006943,5491,2405,2291,2283,2251,32,8,4,4,183,183,0,360,360,0,252,252,0
2021,Sandwell 041,E02006944,5696,2201,2714,2707,2700,7,7,2,5,247,247,0,355,355,0,179,179,0
2021,Solihull 001,E02002081,4602,1530,2237,2235,2225,10,2,0,2,92,90,2,361,358,3,382,382,0
2021,Solihull 002,E02002082,4403,2149,1428,1425,1416,9,3,0,3,132,131,1,437,435,2,257,257,0
2021,Solihull 003,E02002083,5044,1584,2684,2681,2671,10,3,2,1,81,80,1,292,291,1,403,403,0
2021,Solihull 004,E02002084,5107,2442,1775,1765,1750,15,10,6,4,143,141,2,450,448,2,297,297,0
2021,Solihull 005,E02002085,5080,2279,1870,1850,1836,14,20,7,13,134,133,1,447,445,2,350,348,2
2021,Solihull 006,E02002086,4599,2250,1399,1395,1380,15,4,2,2,131,128,3,527,527,0,292,292,0
2021,Solihull 007,E02002087,4744,2333,1475,1468,1461,7,7,2,5,148,147,1,467,467,0,321,321,0
2021,Solihull 008,E02002088,7327,3566,2262,2252,2230,22,10,8,2,240,238,2,771,769,2,488,488,0
2021,Solihull 009,E02002089,6665,2601,2962,2950,2937,13,12,4,8,126,126,0,529,527,2,447,447,0
2021,Solihull 010,E02002090,4800,1649,2452,2449,2441,8,3,0,3,90,90,0,326,325,1,283,283,0
2021,Solihull 011,E02002091,6243,2120,2984,2974,2958,16,10,6,4,117,117,0,514,514,0,508,508,0
2021,Solihull 012,E02002092,5916,2109,2666,2659,2646,13,7,6,1,121,121,0,568,568,0,452,451,1
2021,Solihull 013,E02002093,5586,2004,2564,2552,2541,11,12,6,6,115,115,0,485,484,1,418,418,0
2021,Solihull 014,E02002094,4989,1327,2877,2875,2871,4,2,2,0,59,59,0,307,307,0,419,419,0
2021,Solihull 015,E02002095,7077,2337,3530,3518,3511,7,12,6,6,131,131,0,623,621,2,456,456,0
2021,Solihull 016,E02002096,8447,2299,4618,4609,4587,22,9,6,3,133,133,0,650,648,2,747,747,0
2021,Solihull 017,E02002097,6110,1735,3341,3329,3310,19,12,10,2,96,96,0,528,527,1,410,410,0
2021,Solihull 018,E02002098,7768,2322,4155,4148,4130,18,7,0,7,146,146,0,565,565,0,580,580,0
2021,Solihull 019,E02002099,5705,1278,3597,3587,3580,7,10,4,6,79,79,0,303,303,0,448,448,0
2021,Solihull 021,E02002101,5190,1782,2354,2350,2334,16,4,2,2,108,105,3,532,531,1,414,414,0
2021,Solihull 022,E02002102,7027,2127,3605,3596,3587,9,9,6,3,155,155,0,604,602,2,536,536,0
2021,Solihull 023,E02002103,5108,1369,2830,2828,2823,5,2,2,0,86,86,0,395,395,0,428,428,0
2021,Solihull 024,E02002104,4879,1183,2925,2921,2915,6,4,2,2,67,67,0,381,381,0,323,323,0
2021,Solihull 025,E02002105,6791,1709,3989,3979,3965,14,10,6,4,104,104,0,475,475,0,514,514,0
2021,Solihull 026,E02002106,7983,1824,4772,4768,4753,15,4,0,4,128,126,2,580,579,1,679,679,0
2021,Solihull 027,E02002107,4489,1121,2658,2652,2642,10,6,2,4,77,77,0,359,359,0,274,274,0
2021,Solihull 028,E02002108,7850,1836,4805,4793,4788,5,12,4,8,89,88,1,558,558,0,562,562,0
2021,Solihull 029,E02002109,9634,3366,4906,4896,4882,14,10,4,6,177,176,1,801,799,2,384,384,0
2021,Solihull 030,E02006808,5347,1812,2708,2693,2684,9,15,8,7,92,92,0,370,370,0,365,365,0
2021,Walsall 001,E02002110,5635,2043,2576,2571,2563,8,5,2,3,127,125,2,528,528,0,361,360,1
2021,Walsall 002,E02002111,5118,2004,2015,2006,1988,18,9,4,5,115,115,0,538,536,2,446,446,0
2021,Walsall 003,E02002112,4372,1385,2199,2188,2183,5,11,2,9,71,71,0,381,381,0,336,336,0
2021,Walsall 004,E02002113,5169,1928,2245,2234,2215,19,11,6,5,121,121,0,515,513,2,360,360,0
2021,Walsall 005,E02002114,5099,1569,2408,2401,2387,14,7,3,4,96,96,0,523,523,0,503,503,0
2021,Walsall 006,E02002115,5465,2146,2277,2275,2266,9,2,0,2,108,108,0,451,451,0,483,481,2
2021,Walsall 007,E02002116,5717,1715,2948,2946,2934,12,2,2,0,96,96,0,478,478,0,480,480,0
2021,Walsall 008,E02002117,5218,1940,2293,2276,2266,10,17,7,10,120,110,10,513,513,0,352,351,1
2021,Walsall 009,E02002118,5741,2487,2109,2094,2086,8,15,6,9,171,157,14,510,509,1,464,464,0
2021,Walsall 010,E02002119,4900,1714,2329,2325,2320,5,4,0,4,97,97,0,375,375,0,385,385,0
2021,Walsall 011,E02002120,4950,1673,2568,2559,2550,9,9,0,9,74,74,0,373,370,3,262,262,0
2021,Walsall 012,E02002121,5045,2191,1885,1875,1868,7,10,8,2,144,133,11,415,413,2,410,410,0
2021,Walsall 013,E02002122,5046,2423,1929,1914,1905,9,15,6,9,137,137,0,315,313,2,242,242,0
2021,Walsall 014,E02002123,5207,2050,2210,2201,2191,10,9,4,5,108,107,1,449,449,0,390,390,0
2021,Walsall 015,E02002124,5781,2031,2398,2392,2386,6,6,6,0,124,123,1,595,594,1,633,632,1
2021,Walsall 016,E02002125,5134,2047,2090,2078,2073,5,12,4,8,125,125,0,524,524,0,348,348,0
2021,Walsall 017,E02002126,4970,2352,1624,1609,1590,19,15,10,5,158,158,0,523,520,3,313,313,0
2021,Walsall 018,E02002127,7135,2949,3023,3000,2990,10,23,12,11,231,231,0,543,543,0,389,389,0
2021,Walsall 019,E02002128,4636,1584,2133,2123,2117,6,10,4,6,88,87,1,391,388,3,440,440,0
2021,Walsall 020,E02002129,5008,1748,2346,2342,2339,3,4,2,2,103,102,1,397,396,1,414,414,0
2021,Walsall 021,E02002130,5143,2151,2117,2108,2094,14,9,6,3,129,126,3,444,444,0,302,301,1
2021,Walsall 022,E02002131,6524,1774,3678,3666,3653,13,12,8,4,95,95,0,466,466,0,511,511,0
2021,Walsall 023,E02002132,4936,1949,2057,2048,2038,10,9,4,5,111,110,1,458,457,1,361,361,0
2021,Walsall 024,E02002133,5716,2145,2501,2488,2468,20,13,2,11,138,138,0,565,565,0,367,367,0
2021,Walsall 025,E02002134,7101,3041,2754,2738,2715,23,16,8,8,197,194,3,665,664,1,444,444,0
2021,Walsall 026,E02002135,5981,2542,2475,2470,2457,13,5,4,1,168,166,2,504,503,1,292,291,1
2021,Walsall 027,E02002136,6273,2457,2738,2728,2717,11,10,7,3,178,176,2,586,583,3,314,314,0
2021,Walsall 028,E02002137,5102,1239,2947,2938,2928,10,9,6,3,77,77,0,324,324,0,515,515,0
2021,Walsall 029,E02002138,5061,1725,2559,2553,2547,6,6,6,0,112,111,1,348,347,1,317,317,0
2021,Walsall 030,E02002139,8429,3903,3069,3063,3041,22,6,2,4,338,334,4,660,656,4,459,459,0
2021,Walsall 031,E02002140,6357,2312,3004,2994,2980,14,10,4,6,204,203,1,422,420,2,415,415,0
2021,Walsall 032,E02002141,5293,1457,2986,2979,2973,6,7,2,5,90,90,0,377,375,2,383,383,0
2021,Walsall 033,E02002142,5544,2371,2264,2251,2236,15,13,8,5,171,169,2,444,443,1,294,294,0
2021,Walsall 034,E02002143,7363,2636,3731,3721,3704,17,10,8,2,218,218,0,400,399,1,378,378,0
2021,Walsall 035,E02002144,5665,1382,3452,3448,3439,9,4,2,2,81,81,0,264,264,0,486,486,0
2021,Walsall 036,E02002145,6169,2636,2448,2429,2421,8,19,12,7,204,204,0,569,567,2,312,311,1
2021,Walsall 037,E02002146,4970,1828,2353,2340,2334,6,13,8,5,83,83,0,389,388,1,317,317,0
2021,Walsall 038,E02002147,6814,3009,2676,2663,2642,21,13,10,3,168,168,0,558,558,0,403,403,0
2021,Walsall 039,E02002148,9318,3125,4561,4550,4535,15,11,2,9,162,159,3,702,702,0,768,768,0
2021,Wolverhampton 001,E02002149,8182,3067,3534,3523,3494,29,11,4,7,196,196,0,679,679,0,706,705,1
2021,Wolverhampton 002,E02002150,4577,1769,2023,2016,2010,6,7,3,4,93,93,0,375,374,1,317,317,0
2021,Wolverhampton 003,E02002151,4418,1896,1609,1597,1586,11,12,6,6,126,126,0,537,537,0,250,250,0
2021,Wolverhampton 004,E02002152,4677,2106,1701,1696,1694,2,5,2,3,130,130,0,412,409,3,328,328,0
2021,Wolverhampton 005,E02002153,6110,2416,2452,2448,2439,9,4,0,4,115,114,1,585,585,0,542,542,0
2021,Wolverhampton 006,E02002154,5725,2415,2414,2401,2375,26,13,4,9,141,141,0,461,460,1,294,294,0
2021,Wolverhampton 007,E02002155,4518,2209,1498,1480,1467,13,18,8,10,184,183,1,351,351,0,276,276,0
2021,Wolverhampton 008,E02002156,6664,2392,3043,3037,3026,11,6,1,5,144,144,0,604,604,0,481,480,1
2021,Wolverhampton 009,E02002157,6377,2172,3136,3127,3114,13,9,0,9,116,116,0,534,534,0,419,419,0
2021,Wolverhampton 010,E02002158,6140,2225,2640,2635,2622,13,5,0,5,138,138,0,590,588,2,547,547,0
2021,Wolverhampton 011,E02002159,4530,2068,1738,1732,1726,6,6,4,2,132,131,1,338,336,2,254,254,0
2021,Wolverhampton 012,E02002160,6089,2124,3000,2990,2977,13,10,4,6,99,99,0,443,442,1,423,423,0
2021,Wolverhampton 013,E02002161,5261,2252,2201,2194,2179,15,7,2,5,134,133,1,470,468,2,204,204,0
2021,Wolverhampton 014,E02002162,6569,1875,3345,3334,3308,26,11,2,9,133,130,3,545,542,3,671,671,0
2021,Wolverhampton 015,E02002163,8948,4135,3207,3184,3175,9,23,16,7,258,256,2,848,848,0,500,498,2
2021,Wolverhampton 016,E02002164,5291,2897,1691,1687,1674,13,4,4,0,148,148,0,329,326,3,226,224,2
2021,Wolverhampton 017,E02002165,6559,3213,2204,2198,2182,16,6,0,6,187,185,2,634,633,1,321,321,0
2021,Wolverhampton 018,E02002166,7256,3186,2664,2650,2630,20,14,6,8,191,188,3,702,701,1,513,513,0
2021,Wolverhampton 019,E02002167,5526,1810,2633,2624,2620,4,9,2,7,140,137,3,580,580,0,363,363,0
2021,Wolverhampton 020,E02002168,9262,4933,2942,2926,2914,12,16,6,10,267,267,0,741,738,3,379,379,0
2021,Wolverhampton 021,E02002169,7324,2075,3976,3959,3940,19,17,2,15,115,115,0,550,550,0,608,608,0
2021,Wolverhampton 022,E02002170,4984,1925,2257,2253,2240,13,4,2,2,99,99,0,375,375,0,328,327,1
2021,Wolverhampton 023,E02002171,6027,2444,2474,2463,2451,12,11,8,3,153,153,0,512,511,1,444,444,0
2021,Wolverhampton 026,E02002174,6351,2179,2989,2983,2967,16,6,2,4,137,136,1,571,568,3,475,475,0
2021,Wolverhampton 027,E02002175,6074,2552,2448,2438,2426,12,10,7,3,172,169,3,495,494,1,407,405,2
2021,Wolverhampton 028,E02002176,6243,2422,2700,2693,2677,16,7,2,5,142,142,0,598,597,1,381,381,0
2021,Wolverhampton 029,E02002177,8790,3753,3552,3541,3500,41,11,2,9,244,242,2,729,729,0,512,512,0
2021,Wolverhampton 030,E02002178,6746,1989,3749,3745,3733,12,4,2,2,112,112,0,388,388,0,508,508,0
2021,Wolverhampton 031,E02002179,5328,1623,2821,2819,2803,16,2,0,2,93,93,0,404,403,1,387,387,0
2021,Wolverhampton 032,E02002180,5247,1810,2497,2496,2479,17,1,0,1,117,117,0,398,398,0,425,425,0
2021,Wolverhampton 033,E02002181,6442,2780,2585,2578,2561,17,7,4,3,170,170,0,527,526,1,380,380,0
2021,Wolverhampton 034,E02002182,5341,2110,2301,2296,2283,13,5,4,1,121,120,1,428,428,0,381,381,0
2021,Wolverhampton 035,E02006894,10866,4233,4958,4942,4912,30,16,10,6,280,277,3,737,737,0,658,656,2
