date,geography,geography code,Household composition: Total; measures: Value,Household composition: One person household; measures: Value,Household composition: One person household: Aged 66 years and over; measures: Value,Household composition: One person household: Other; measures: Value,Household composition: Single family household; measures: Value,Household composition: Single family household: All aged 66 years and over; measures: Value,Household composition: Single family household: Married or civil partnership couple; measures: Value,Household composition: Single family household: Married or civil partnership couple: No children; measures: Value,Household composition: Single family household: Married or civil partnership couple: Dependent children; measures: Value,Household composition: Single family household: Married or civil partnership couple: All children non-dependent; measures: Value,Household composition: Single family household: Cohabiting couple family; measures: Value,Household composition: Single family household: Cohabiting couple family: No children; measures: Value,Household composition: Single family household: Cohabiting couple family: With dependent children; measures: Value,Household composition: Single family household: Cohabiting couple family: All children non-dependent; measures: Value,Household composition: Single family household: Lone parent family; measures: Value,Household composition: Single family household: Lone parent family: With dependent children; measures: Value,Household composition: Single family household: Lone parent family: All children non-dependent; measures: Value,Household composition: Single family household: Other single family household; measures: Value,Household composition: Single family household: Other single family household: Other family composition; measures: Value,Household composition: Other household types; measures: Value,Household composition: Other household types: With dependent children; measures: Value,"Household composition: Other household types: Other, including all full-time students and all aged 66 years and over; measures: Value"
2021,Bolton 001,E02000984,3209,775,397,378,2338,475,1267,417,602,248,354,176,157,21,229,139,90,13,13,96,45,51
2021,Bolton 002,E02000985,3225,863,522,341,2258,527,1137,399,505,233,322,156,145,21,265,157,108,7,7,104,44,60
2021,Bolton 003,E02000986,3646,1185,574,611,2336,369,1183,411,538,234,439,244,169,26,337,194,143,8,8,125,71,54
2021,Bolton 004,E02000987,3464,1313,549,764,2056,269,849,346,322,181,468,251,184,33,451,273,178,19,19,95,41,54
2021,Bolton 005,E02000988,3635,1250,499,751,2151,221,1051,301,540,210,367,152,189,26,496,326,170,16,16,234,141,93
2021,Bolton 006,E02000989,3743,1099,726,373,2539,626,1214,451,491,272,402,194,175,33,289,148,141,8,8,105,48,57
2021,Bolton 007,E02000990,3691,1084,438,646,2461,372,1200,455,505,240,507,287,183,37,369,238,131,13,13,146,74,72
2021,Bolton 008,E02000991,3249,938,415,523,2167,282,1107,382,513,212,401,183,194,24,357,213,144,20,20,144,91,53
2021,Bolton 009,E02000992,2759,809,402,407,1835,341,846,316,382,148,375,179,160,36,257,157,100,16,16,115,47,68
2021,Bolton 010,E02000993,3449,1124,386,738,2130,123,810,208,429,173,474,189,248,37,702,501,201,21,21,195,113,82
2021,Bolton 011,E02000994,3317,1189,392,797,1846,105,1018,207,663,148,250,102,134,14,457,309,148,16,16,282,184,98
2021,Bolton 012,E02000995,3425,1016,497,519,2256,382,1065,325,540,200,351,145,172,34,436,282,154,22,22,153,81,72
2021,Bolton 013,E02000996,3382,1057,392,665,2170,200,759,227,351,181,470,132,293,45,706,508,198,35,35,155,86,69
2021,Bolton 014,E02000997,2719,772,341,431,1824,308,903,286,428,189,325,173,130,22,265,160,105,23,23,123,65,58
2021,Bolton 015,E02000998,3699,1209,355,854,2110,162,1125,228,693,204,292,137,133,22,466,332,134,65,65,380,227,153
2021,Bolton 016,E02000999,3635,1775,482,1293,1623,75,813,198,504,111,242,147,76,19,448,246,202,45,45,237,127,110
2021,Bolton 017,E02001000,4065,1513,564,949,2306,281,907,332,382,193,509,269,206,34,584,389,195,25,25,246,121,125
2021,Bolton 018,E02001001,3211,887,335,552,2086,225,1144,278,646,220,292,141,131,20,402,277,125,23,23,238,155,83
2021,Bolton 019,E02001002,4075,1163,503,660,2717,400,1137,410,449,278,522,193,289,40,630,425,205,28,28,195,114,81
2021,Bolton 020,E02001003,2829,673,401,272,1978,478,1105,342,519,244,177,97,66,14,202,106,96,16,16,178,116,62
2021,Bolton 021,E02001004,3060,898,297,601,1862,115,1087,224,682,181,176,71,94,11,417,242,175,67,67,300,199,101
2021,Bolton 022,E02001005,3388,1105,349,756,1931,158,1016,236,623,157,300,177,112,11,410,262,148,47,47,352,240,112
2021,Bolton 023,E02001006,2760,628,226,402,1853,120,1142,229,701,212,175,63,97,15,388,231,157,28,28,279,180,99
2021,Bolton 024,E02001007,4393,1303,691,612,2882,593,1272,447,525,300,479,184,254,41,518,293,225,20,20,208,86,122
2021,Bolton 025,E02001008,2830,698,289,409,1863,96,1108,181,774,153,181,58,103,20,462,292,170,16,16,269,184,85
2021,Bolton 026,E02001009,2977,973,414,559,1835,217,943,254,504,185,272,111,134,27,379,245,134,24,24,169,111,58
2021,Bolton 027,E02001010,2485,755,218,537,1528,122,641,180,352,109,336,155,162,19,410,268,142,19,19,202,124,78
2021,Bolton 028,E02001011,4233,1193,596,597,2891,513,1477,536,626,315,516,246,238,32,367,206,161,18,18,149,69,80
2021,Bolton 029,E02001012,2982,631,312,319,1987,197,1073,245,629,199,290,92,167,31,407,245,162,20,20,364,263,101
2021,Bolton 030,E02001013,2500,647,362,285,1738,345,909,284,435,190,248,119,102,27,227,127,100,9,9,115,56,59
2021,Bolton 031,E02001014,3786,1255,525,730,2378,302,1030,393,420,217,511,248,229,34,515,325,190,20,20,153,74,79
2021,Bolton 032,E02001015,3856,1631,629,1002,2050,241,730,274,296,160,511,242,234,35,543,333,210,25,25,175,85,90
2021,Bolton 033,E02001016,3341,899,341,558,2209,169,866,245,450,171,471,162,257,52,681,467,214,22,22,233,141,92
2021,Bolton 034,E02001017,4663,1509,657,852,2940,362,1262,437,525,300,698,261,381,56,592,385,207,26,26,214,108,106
2021,Bolton 035,E02001018,3110,705,314,391,2274,282,1239,436,531,272,419,190,197,32,325,194,131,9,9,131,77,54
2021,Bury 001,E02001019,4072,1356,586,770,2574,399,1161,420,561,180,554,320,203,31,445,283,162,15,15,142,64,78
2021,Bury 002,E02001020,2512,621,434,187,1819,525,924,302,437,185,187,84,87,16,174,91,83,9,9,72,23,49
2021,Bury 003,E02001021,3177,847,420,427,2243,385,1265,484,533,248,332,162,139,31,248,150,98,13,13,87,31,56
2021,Bury 004,E02001022,3368,1036,513,523,2149,341,1024,380,440,204,391,205,165,21,373,214,159,20,20,183,90,93
2021,Bury 005,E02001023,2321,591,319,272,1615,308,762,249,354,159,233,81,135,17,300,186,114,12,12,115,58,57
2021,Bury 006,E02001024,3377,871,438,433,2404,399,1197,394,551,252,436,192,211,33,363,209,154,9,9,102,45,57
2021,Bury 007,E02001025,3425,1141,406,735,2100,202,869,276,427,166,394,157,190,47,595,408,187,40,40,184,94,90
2021,Bury 008,E02001026,4379,1494,368,1126,2484,124,1176,321,683,172,494,286,174,34,635,412,223,55,55,401,248,153
2021,Bury 009,E02001027,3179,1137,349,788,1896,175,785,237,409,139,446,230,183,33,477,341,136,13,13,146,63,83
2021,Bury 010,E02001028,3096,778,566,212,2224,617,1184,385,544,255,229,108,103,18,192,93,99,2,2,94,48,46
2021,Bury 011,E02001029,2876,887,335,552,1724,153,897,227,498,172,299,157,123,19,347,215,132,28,28,265,172,93
2021,Bury 012,E02001030,2510,569,258,311,1847,282,989,355,406,228,328,144,161,23,234,129,105,14,14,94,40,54
2021,Bury 013,E02001031,2951,1035,432,603,1758,228,828,278,410,140,313,158,134,21,371,234,137,18,18,158,88,70
2021,Bury 014,E02001032,3277,973,475,498,2161,315,929,340,370,219,451,199,226,26,441,283,158,25,25,143,69,74
2021,Bury 015,E02001033,2684,880,315,565,1699,146,706,232,330,144,413,183,195,35,422,308,114,12,12,105,50,55
2021,Bury 016,E02001034,4088,1774,496,1278,2135,190,733,265,336,132,494,225,231,38,673,489,184,45,45,179,74,105
2021,Bury 017,E02001035,2995,801,464,337,2058,401,1073,322,494,257,280,143,121,16,293,152,141,11,11,136,77,59
2021,Bury 018,E02001036,3091,865,316,549,2073,260,880,295,410,175,450,203,202,45,462,319,143,21,21,153,77,76
2021,Bury 019,E02001037,3035,841,472,369,2077,448,1105,357,540,208,302,178,108,16,211,108,103,11,11,117,44,73
2021,Bury 020,E02001038,2674,1041,420,621,1503,165,684,238,325,121,326,203,104,19,302,185,117,26,26,130,50,80
2021,Bury 021,E02001039,3513,1026,429,597,2282,176,942,282,475,185,461,209,220,32,684,470,214,19,19,205,104,101
2021,Bury 022,E02001040,2632,794,369,425,1692,247,877,264,440,173,347,191,139,17,200,107,93,21,21,146,67,79
2021,Bury 023,E02001041,3400,1149,507,642,2072,184,883,296,435,152,544,339,168,37,437,257,180,24,24,179,74,105
2021,Bury 024,E02001042,2894,1069,428,641,1667,235,907,307,466,134,298,193,92,13,219,109,110,8,8,158,59,99
2021,Bury 025,E02001043,2372,740,281,459,1512,159,718,210,385,123,329,169,131,29,297,181,116,9,9,120,54,66
2021,Bury 026,E02001044,2791,561,246,315,1998,229,1364,230,934,200,156,84,53,19,234,127,107,15,15,232,134,98
2021,Manchester 001,E02001045,3604,1278,521,757,2111,186,742,231,355,156,374,124,206,44,776,506,270,33,33,215,107,108
2021,Manchester 002,E02001046,4378,1301,395,906,2719,162,1149,327,611,211,532,218,258,56,824,582,242,52,52,358,206,152
2021,Manchester 003,E02001047,4360,1557,599,958,2520,192,1019,293,517,209,446,158,241,47,813,520,293,50,50,283,151,132
2021,Manchester 004,E02001048,3484,1125,376,749,2045,196,1089,238,665,186,255,125,115,15,464,298,166,41,41,314,208,106
2021,Manchester 005,E02001049,4209,1209,517,692,2707,278,1119,341,507,271,499,206,245,48,759,493,266,52,52,293,130,163
2021,Manchester 006,E02001050,3160,1042,298,744,1830,83,777,193,482,102,266,115,126,25,642,482,160,62,62,288,170,118
2021,Manchester 007,E02001051,3526,975,327,648,2235,157,903,238,455,210,336,125,181,30,784,597,187,55,55,316,185,131
2021,Manchester 008,E02001052,4414,1195,386,809,2572,82,1649,226,1195,228,228,113,103,12,529,297,232,84,84,647,462,185
2021,Manchester 009,E02001053,4589,1580,426,1154,2618,103,937,207,594,136,375,121,212,42,1129,782,347,74,74,391,238,153
2021,Manchester 011,E02001055,3989,1463,461,1002,2261,139,783,254,370,159,418,151,222,45,862,629,233,59,59,265,134,131
2021,Manchester 012,E02001056,3445,1155,378,777,2030,109,681,144,416,121,325,121,170,34,867,590,277,48,48,260,147,113
2021,Manchester 015,E02001059,4801,1589,369,1220,2712,119,1058,275,650,133,528,294,205,29,914,649,265,93,93,500,207,293
2021,Manchester 017,E02001061,4322,1403,453,950,2546,124,997,259,582,156,431,178,218,35,895,644,251,99,99,373,184,189
2021,Manchester 018,E02001062,3570,1213,244,969,1859,47,860,152,607,101,252,141,88,23,606,372,234,94,94,498,136,362
2021,Manchester 019,E02001063,3466,1312,170,1142,1472,18,587,187,357,43,335,265,60,10,401,246,155,131,131,682,93,589
2021,Manchester 020,E02001064,3907,1264,325,939,2287,70,1137,212,767,158,287,122,135,30,710,458,252,83,83,356,206,150
2021,Manchester 021,E02001065,3843,1209,356,853,2352,152,893,233,479,181,437,170,224,43,797,616,181,73,73,282,123,159
2021,Manchester 022,E02001066,3448,1141,171,970,1415,35,815,151,553,111,191,139,43,9,285,158,127,89,89,892,236,656
2021,Manchester 023,E02001067,4123,1216,387,829,2510,88,1056,175,749,132,394,132,217,45,895,647,248,77,77,397,231,166
2021,Manchester 024,E02001068,4119,1315,383,932,2259,41,942,139,718,85,250,150,89,11,898,576,322,128,128,545,251,294
2021,Manchester 025,E02001069,4304,1224,250,974,2128,48,954,150,727,77,305,194,100,11,691,497,194,130,130,952,162,790
2021,Manchester 026,E02001070,3139,1038,219,819,1306,55,738,177,438,123,203,169,34,0,249,126,123,61,61,795,228,567
2021,Manchester 028,E02001072,3898,1635,249,1386,1778,68,821,227,500,94,506,357,134,15,329,209,120,54,54,485,139,346
2021,Manchester 029,E02001073,3985,1399,422,977,2090,144,1008,305,564,139,647,480,150,17,245,132,113,46,46,496,109,387
2021,Manchester 030,E02001074,4226,1342,356,986,2312,114,1128,221,693,214,333,207,96,30,679,386,293,58,58,572,263,309
2021,Manchester 031,E02001075,3452,1144,257,887,1871,45,917,208,605,104,487,326,145,16,367,223,144,55,55,437,167,270
2021,Manchester 032,E02001076,2799,665,121,544,919,36,458,126,268,64,185,132,42,11,166,85,81,74,74,1215,97,1118
2021,Manchester 033,E02001077,3043,957,294,663,1693,127,830,219,458,153,494,337,142,15,214,114,100,28,28,393,120,273
2021,Manchester 034,E02001078,3801,987,446,541,2343,208,1270,277,746,247,401,238,143,20,428,235,193,36,36,471,206,265
2021,Manchester 035,E02001079,3441,952,307,645,1858,78,744,166,417,161,322,194,101,27,643,366,277,71,71,631,129,502
2021,Manchester 036,E02001080,3426,1017,294,723,1259,93,485,130,278,77,364,288,66,10,225,127,98,92,92,1150,74,1076
2021,Manchester 037,E02001081,2800,907,342,565,1694,106,805,297,404,104,509,361,136,12,258,144,114,16,16,199,60,139
2021,Manchester 038,E02001082,2901,1030,179,851,1347,93,580,196,327,57,468,407,51,10,172,98,74,34,34,524,51,473
2021,Manchester 039,E02001083,4077,1679,224,1455,1948,52,703,270,380,53,898,777,110,11,254,157,97,41,41,450,49,401
2021,Manchester 040,E02001084,3327,985,328,657,1753,151,857,253,472,132,385,258,106,21,317,177,140,43,43,589,82,507
2021,Manchester 041,E02001085,3202,804,308,496,2090,87,856,163,538,155,322,130,144,48,797,465,332,28,28,308,194,114
2021,Manchester 042,E02001086,2950,1036,294,742,1680,93,639,208,353,78,489,348,115,26,422,252,170,37,37,234,74,160
2021,Manchester 043,E02001087,4333,1552,544,1008,2445,283,1220,396,695,129,707,549,143,15,206,110,96,29,29,336,39,297
2021,Manchester 044,E02001088,3787,1190,427,763,2342,158,917,276,479,162,474,225,220,29,760,499,261,33,33,255,104,151
2021,Manchester 045,E02001089,3202,836,352,484,2125,233,1138,318,628,192,464,308,134,22,257,126,131,33,33,241,95,146
2021,Manchester 046,E02001090,3143,1135,470,665,1763,202,837,282,398,157,413,243,147,23,283,151,132,28,28,245,77,168
2021,Manchester 047,E02001091,3883,1424,529,895,2285,274,893,308,416,169,490,237,211,42,594,376,218,34,34,174,78,96
2021,Manchester 048,E02001092,3853,1345,386,959,2257,156,955,271,476,208,446,191,226,29,654,446,208,46,46,251,129,122
2021,Manchester 049,E02001093,3916,1202,393,809,2393,150,827,225,454,148,528,218,275,35,843,610,233,45,45,321,173,148
2021,Manchester 050,E02001094,3942,1189,401,788,2441,108,771,177,452,142,496,198,258,40,1010,760,250,56,56,312,174,138
2021,Manchester 051,E02001095,3737,1194,449,745,2241,136,789,239,371,179,476,184,238,54,786,512,274,54,54,302,135,167
2021,Manchester 052,E02001096,3425,1098,394,704,2087,191,805,269,349,187,419,175,205,39,620,383,237,52,52,240,110,130
2021,Manchester 053,E02001097,3527,1071,385,686,2147,130,721,227,340,154,475,167,254,54,766,517,249,55,55,309,147,162
2021,Manchester 054,E02006902,4354,1956,100,1856,1603,20,456,265,167,24,829,781,44,4,174,99,75,124,124,795,24,771
2021,Manchester 055,E02006912,5024,2260,244,2016,1762,43,378,302,67,9,1112,1083,26,3,62,21,41,167,167,1002,8,994
2021,Manchester 056,E02006913,3180,1144,161,983,1510,36,663,169,406,88,462,407,46,9,281,183,98,68,68,526,161,365
2021,Manchester 057,E02006914,2212,984,47,937,747,4,192,99,83,10,383,358,25,0,87,57,30,81,81,481,14,467
2021,Manchester 058,E02006915,3037,866,153,713,1828,48,909,144,638,127,269,157,93,19,539,351,188,63,63,343,167,176
2021,Manchester 059,E02006916,3802,1585,157,1428,1529,14,345,171,152,22,779,718,56,5,290,178,112,101,101,688,39,649
2021,Manchester 060,E02006917,3815,1785,67,1718,1341,14,345,242,90,13,789,770,18,1,77,25,52,116,116,689,10,679
2021,Manchester 061,E02006983,3228,1136,236,900,1611,40,482,196,218,68,585,468,99,18,455,278,177,49,49,481,109,372
2021,Manchester 062,E02006984,2965,1140,106,1034,1263,24,345,175,142,28,625,583,34,8,184,114,70,85,85,562,44,518
2021,Manchester 063,E02006985,2513,444,119,325,1633,52,1023,111,782,130,114,44,65,5,382,255,127,62,62,436,292,144
2021,Manchester 064,E02006986,2322,696,158,538,1358,46,693,124,517,52,225,134,84,7,353,238,115,41,41,268,130,138
2021,Oldham 001,E02001098,2728,923,532,391,1715,372,755,289,287,179,309,147,134,28,270,157,113,9,9,90,49,41
2021,Oldham 002,E02001099,2651,951,401,550,1597,222,637,242,254,141,344,162,145,37,377,237,140,17,17,103,50,53
2021,Oldham 003,E02001100,2590,769,372,397,1709,329,762,295,296,171,302,128,146,28,307,186,121,9,9,112,57,55
2021,Oldham 004,E02001101,2452,681,369,312,1674,357,771,272,327,172,264,117,125,22,274,153,121,8,8,97,46,51
2021,Oldham 005,E02001102,2526,685,284,401,1727,238,818,294,349,175,379,153,187,39,287,182,105,5,5,114,52,62
2021,Oldham 006,E02001103,2424,723,441,282,1634,341,880,307,401,172,225,122,84,19,182,95,87,6,6,67,26,41
2021,Oldham 007,E02001104,2840,649,256,393,2022,213,946,299,431,216,441,173,234,34,412,285,127,10,10,169,90,79
2021,Oldham 008,E02001105,2674,870,472,398,1726,313,731,263,275,193,296,113,148,35,369,217,152,17,17,78,38,40
2021,Oldham 009,E02001106,2740,1023,436,587,1598,242,635,229,250,156,316,137,154,25,388,241,147,17,17,119,63,56
2021,Oldham 010,E02001107,2562,669,294,375,1753,245,908,190,553,165,236,100,119,17,338,220,118,26,26,140,86,54
2021,Oldham 011,E02001108,2357,658,219,439,1556,90,504,167,228,109,366,134,206,26,576,442,134,20,20,143,69,74
2021,Oldham 012,E02001109,3360,1197,454,743,1995,205,797,287,345,165,373,144,203,26,593,402,191,27,27,168,78,90
2021,Oldham 013,E02001110,2860,831,399,432,1922,395,979,372,454,153,327,190,116,21,212,116,96,9,9,107,55,52
2021,Oldham 014,E02001111,3436,1431,366,1065,1715,78,711,162,451,98,285,106,154,25,585,415,170,56,56,290,217,73
2021,Oldham 015,E02001112,2450,572,303,269,1761,347,934,316,387,231,267,126,113,28,202,111,91,11,11,117,52,65
2021,Oldham 016,E02001113,2513,498,145,353,1606,53,1043,131,778,134,112,37,69,6,361,217,144,37,37,409,325,84
2021,Oldham 017,E02001114,3493,1154,506,648,2171,291,1056,250,590,216,345,154,162,29,452,308,144,27,27,168,106,62
2021,Oldham 018,E02001115,2607,807,352,455,1703,236,687,238,303,146,362,165,173,24,405,239,166,13,13,97,44,53
2021,Oldham 019,E02001116,2388,527,169,358,1582,96,950,273,574,103,184,68,108,8,325,236,89,27,27,279,214,65
2021,Oldham 020,E02001117,2623,779,488,291,1757,377,922,316,411,195,237,105,114,18,213,121,92,8,8,87,37,50
2021,Oldham 021,E02001118,2630,739,417,322,1806,312,927,350,390,187,312,156,122,34,241,143,98,14,14,85,38,47
2021,Oldham 022,E02001119,2876,492,144,348,1778,52,1242,133,956,153,108,41,58,9,344,207,137,32,32,606,484,122
2021,Oldham 024,E02001121,2467,613,175,438,1524,44,939,155,674,110,135,44,84,7,379,269,110,27,27,330,251,79
2021,Oldham 026,E02001123,2786,843,347,496,1750,153,685,205,373,107,345,134,182,29,551,406,145,16,16,193,126,67
2021,Oldham 027,E02001124,2806,1010,338,672,1604,135,641,168,365,108,346,143,165,38,459,306,153,23,23,192,109,83
2021,Oldham 028,E02001125,3335,1055,458,597,2109,250,948,317,410,221,438,197,190,51,451,273,178,22,22,171,95,76
2021,Oldham 029,E02001126,3359,921,308,613,2203,145,885,229,504,152,386,133,226,27,734,524,210,53,53,235,143,92
2021,Oldham 030,E02001127,2944,780,329,451,1979,159,798,235,384,179,350,125,179,46,649,451,198,23,23,185,104,81
2021,Oldham 031,E02001128,3286,1078,459,619,2048,245,806,284,322,200,401,178,189,34,572,379,193,24,24,160,74,86
2021,Oldham 032,E02001129,3064,1118,410,708,1791,158,625,226,285,114,468,242,195,31,518,311,207,22,22,155,67,88
2021,Oldham 033,E02001130,2587,827,434,393,1650,298,753,267,258,228,270,126,127,17,316,181,135,13,13,110,58,52
2021,Oldham 034,E02001131,2308,639,367,272,1570,232,671,228,278,165,310,120,161,29,350,217,133,7,7,99,39,60
2021,Oldham 036,E02007000,2202,508,146,362,1395,45,811,120,593,98,113,41,67,5,382,276,106,44,44,299,231,68
2021,Oldham 037,E02007001,2224,372,155,217,1452,88,941,143,657,141,99,38,47,14,302,194,108,22,22,400,290,110
2021,Rochdale 001,E02001132,3057,1071,434,637,1867,260,757,284,322,151,429,230,172,27,405,271,134,16,16,119,55,64
2021,Rochdale 002,E02001133,2740,687,318,369,1950,333,915,330,417,168,418,185,201,32,275,171,104,9,9,103,58,45
2021,Rochdale 003,E02001134,2655,711,349,362,1831,316,963,410,383,170,322,168,127,27,224,124,100,6,6,113,65,48
2021,Rochdale 004,E02001135,3201,1111,410,701,1882,139,872,203,536,133,307,124,151,32,546,399,147,18,18,208,142,66
2021,Rochdale 005,E02001136,3740,1119,519,600,2403,401,1125,395,511,219,410,189,183,38,445,281,164,22,22,218,130,88
2021,Rochdale 006,E02001137,2613,664,308,356,1855,313,968,368,387,213,341,166,145,30,225,123,102,8,8,94,47,47
2021,Rochdale 007,E02001138,3645,1010,537,473,2481,516,1295,460,562,273,336,170,135,31,326,187,139,8,8,154,80,74
2021,Rochdale 008,E02001139,3245,849,272,577,1978,78,1144,192,765,187,222,105,103,14,483,311,172,51,51,418,308,110
2021,Rochdale 009,E02001140,3050,887,347,540,1919,197,845,224,472,149,336,133,181,22,518,369,149,23,23,244,155,89
2021,Rochdale 010,E02001141,4582,1781,480,1301,2414,121,1223,254,771,198,319,141,154,24,684,473,211,67,67,387,245,142
2021,Rochdale 011,E02001142,2430,656,404,252,1632,400,863,272,386,205,169,95,56,18,188,97,91,12,12,142,86,56
2021,Rochdale 012,E02001143,4047,1083,357,726,2607,178,1229,268,724,237,397,153,206,38,745,529,216,58,58,357,243,114
2021,Rochdale 013,E02001144,2862,961,387,574,1794,268,797,294,349,154,372,194,149,29,340,236,104,17,17,107,47,60
2021,Rochdale 014,E02001145,3079,898,443,455,2070,323,956,351,404,201,393,190,173,30,388,255,133,10,10,111,55,56
2021,Rochdale 015,E02001146,3080,729,271,458,1937,78,1151,162,769,220,164,62,85,17,482,288,194,62,62,414,294,120
2021,Rochdale 016,E02001147,4144,1213,445,768,2726,208,1167,325,624,218,557,216,304,37,752,521,231,42,42,205,121,84
2021,Rochdale 017,E02001148,4381,1392,642,750,2751,356,1194,409,533,252,527,254,238,35,635,423,212,39,39,238,115,123
2021,Rochdale 018,E02001149,4817,1880,743,1137,2735,266,999,383,402,214,638,276,293,69,798,590,208,34,34,202,93,109
2021,Rochdale 019,E02001150,3695,1041,402,639,2461,259,939,351,398,190,507,197,261,49,723,498,225,33,33,193,96,97
2021,Rochdale 020,E02001151,4191,1180,465,715,2831,376,1317,423,591,303,570,239,286,45,547,378,169,21,21,180,89,91
2021,Rochdale 021,E02001152,4128,1282,463,819,2655,279,1074,365,470,239,585,265,272,48,683,464,219,34,34,191,96,95
2021,Rochdale 022,E02001153,4933,1482,596,886,3135,231,1130,329,624,177,693,258,376,59,997,682,315,84,84,316,204,112
2021,Rochdale 023,E02001154,4383,1389,525,864,2772,260,1105,397,445,263,635,276,307,52,747,505,242,25,25,222,109,113
2021,Rochdale 024,E02001155,3449,1425,548,877,1870,206,744,293,315,136,418,220,168,30,481,334,147,21,21,154,68,86
2021,Rochdale 025,E02001156,4099,1140,619,521,2746,498,1400,423,639,338,423,178,207,38,412,246,166,13,13,213,123,90
2021,Salford 001,E02001157,3468,1094,404,690,2167,142,650,177,328,145,490,163,268,59,825,620,205,60,60,207,132,75
2021,Salford 002,E02001158,2725,1022,371,651,1563,158,557,211,222,124,351,140,180,31,476,336,140,21,21,140,65,75
2021,Salford 003,E02001159,3258,1044,341,703,2056,149,799,278,387,134,605,328,239,38,484,321,163,19,19,158,91,67
2021,Salford 004,E02001160,2859,741,286,455,1984,194,773,239,379,155,405,156,208,41,586,415,171,26,26,134,89,45
2021,Salford 005,E02001161,2665,912,381,531,1636,230,740,289,284,167,331,170,134,27,312,211,101,23,23,117,46,71
2021,Salford 006,E02001162,2685,981,409,572,1579,255,609,205,236,168,339,150,163,26,356,227,129,20,20,125,55,70
2021,Salford 007,E02001163,4423,1402,578,824,2839,442,1211,416,547,248,686,381,264,41,471,287,184,29,29,182,83,99
2021,Salford 008,E02001164,2844,814,228,586,1846,131,664,207,316,141,453,219,209,25,571,425,146,27,27,184,78,106
2021,Salford 009,E02001165,2663,812,344,468,1702,153,720,237,324,159,430,228,175,27,390,251,139,9,9,149,53,96
2021,Salford 010,E02001166,2383,741,304,437,1458,184,997,202,704,91,110,61,43,6,156,105,51,11,11,184,108,76
2021,Salford 011,E02001167,2810,946,300,646,1665,148,822,244,464,114,295,164,105,26,360,224,136,40,40,199,96,103
2021,Salford 012,E02001168,4218,1304,530,774,2681,259,1131,376,526,229,585,295,259,31,683,431,252,23,23,233,111,122
2021,Salford 013,E02001169,4454,1033,558,475,3257,559,1740,534,844,362,560,288,230,42,378,235,143,20,20,164,68,96
2021,Salford 014,E02001170,4145,1143,637,506,2874,524,1555,477,817,261,488,253,207,28,293,176,117,14,14,128,56,72
2021,Salford 015,E02001171,2549,678,340,338,1743,273,853,248,388,217,367,194,154,19,238,134,104,12,12,128,51,77
2021,Salford 017,E02001173,3574,1207,321,886,1863,86,587,200,288,99,423,226,162,35,711,504,207,56,56,504,112,392
2021,Salford 018,E02001174,2339,661,287,374,1407,164,622,215,256,151,366,202,142,22,228,128,100,27,27,271,68,203
2021,Salford 019,E02001175,3076,944,327,617,1914,171,764,257,353,154,508,277,192,39,448,282,166,23,23,218,105,113
2021,Salford 020,E02001176,5472,2248,833,1415,2858,329,1283,380,653,250,765,521,208,36,434,244,190,47,47,366,107,259
2021,Salford 021,E02001177,5822,2023,737,1286,3235,239,1261,415,612,234,889,598,246,45,773,493,280,73,73,564,152,412
2021,Salford 023,E02001179,3170,1181,368,813,1583,116,500,196,198,106,462,309,131,22,457,298,159,48,48,406,98,308
2021,Salford 024,E02001180,2543,1165,332,833,1177,61,390,106,229,55,269,158,86,25,413,284,129,44,44,201,72,129
2021,Salford 025,E02001181,2631,971,297,674,1479,107,533,172,247,114,336,141,160,35,473,314,159,30,30,181,97,84
2021,Salford 026,E02001182,3328,1255,307,948,1857,95,672,226,335,111,504,296,183,25,518,370,148,68,68,216,74,142
2021,Salford 027,E02001183,3189,1076,293,783,1860,105,662,227,311,124,525,275,215,35,537,368,169,31,31,253,78,175
2021,Salford 029,E02001185,4088,1208,596,612,2676,397,1089,359,439,291,547,219,285,43,624,415,209,19,19,204,91,113
2021,Salford 030,E02001186,4478,1400,541,859,2875,319,1202,380,578,244,664,294,316,54,669,439,230,21,21,203,101,102
2021,Salford 031,E02006957,2670,1055,244,811,1457,72,861,144,650,67,145,51,81,13,335,226,109,44,44,158,80,78
2021,Salford 032,E02006958,3070,1022,225,797,1582,70,668,172,422,74,376,234,115,27,399,267,132,69,69,466,121,345
2021,Salford 033,E02006959,4635,2080,130,1950,1708,13,404,242,132,30,922,874,42,6,173,113,60,196,196,847,20,827
2021,Salford 034,E02006960,3798,1507,153,1354,1651,21,505,201,238,66,746,636,91,19,300,213,87,79,79,640,47,593
2021,Salford 035,E02006961,3150,1252,209,1043,1484,70,407,141,201,65,528,374,138,16,416,301,115,63,63,414,76,338
2021,Salford 036,E02006962,2477,758,107,651,1010,29,277,103,108,66,460,410,45,5,167,112,55,77,77,709,36,673
2021,Salford 037,E02006963,3458,1458,62,1396,1450,35,469,274,178,17,786,753,32,1,64,27,37,96,96,550,16,534
2021,Stockport 001,E02001187,3083,982,388,594,1945,246,812,287,320,205,414,202,182,30,444,277,167,29,29,156,74,82
2021,Stockport 002,E02001188,3830,1306,341,965,2319,161,816,291,370,155,643,368,229,46,667,475,192,32,32,205,91,114
2021,Stockport 003,E02001189,3594,1056,435,621,2370,295,1114,386,488,240,504,273,200,31,436,250,186,21,21,168,64,104
2021,Stockport 004,E02001190,3484,1366,292,1074,1958,84,580,181,258,141,492,220,240,32,776,586,190,26,26,160,79,81
2021,Stockport 005,E02001191,2629,927,429,498,1610,333,798,281,342,175,284,144,118,22,186,94,92,9,9,92,32,60
2021,Stockport 006,E02001192,2854,1006,413,593,1688,199,952,313,496,143,366,227,116,23,153,72,81,18,18,160,53,107
2021,Stockport 007,E02001193,3013,1114,306,808,1755,148,650,237,286,127,489,304,152,33,416,267,149,52,52,144,67,77
2021,Stockport 008,E02001194,2653,815,372,443,1726,277,988,269,573,146,277,167,98,12,172,97,75,12,12,112,51,61
2021,Stockport 009,E02001195,3267,969,443,526,2169,291,968,333,404,231,508,246,227,35,386,226,160,16,16,129,52,77
2021,Stockport 010,E02001196,3418,1047,606,441,2244,447,1059,347,485,227,385,188,161,36,344,203,141,9,9,127,50,77
2021,Stockport 011,E02001197,2626,778,361,417,1739,202,961,283,520,158,279,142,118,19,275,157,118,22,22,109,57,52
2021,Stockport 012,E02001198,3347,1161,610,551,2071,366,813,270,354,189,392,184,172,36,489,336,153,11,11,115,51,64
2021,Stockport 013,E02001199,3399,1119,537,582,2130,288,1187,348,614,225,405,256,134,15,233,126,107,17,17,150,80,70
2021,Stockport 014,E02001200,4080,2007,450,1557,1863,105,576,270,239,67,482,301,161,20,665,478,187,35,35,210,62,148
2021,Stockport 015,E02001201,2457,689,287,402,1660,179,731,248,330,153,396,184,188,24,340,212,128,14,14,108,45,63
2021,Stockport 016,E02001202,3178,1236,325,911,1759,81,606,256,267,83,532,345,164,23,499,335,164,41,41,183,59,124
2021,Stockport 017,E02001203,2453,559,354,205,1819,470,1008,358,482,168,205,109,90,6,131,64,67,5,5,75,35,40
2021,Stockport 018,E02001204,3781,1113,395,718,2497,220,1188,401,561,226,620,332,256,32,445,293,152,24,24,171,74,97
2021,Stockport 019,E02001205,3971,1441,443,998,2351,232,956,346,415,195,545,310,207,28,594,428,166,24,24,179,74,105
2021,Stockport 020,E02001206,3101,899,544,355,2098,404,1017,304,493,220,336,177,143,16,328,212,116,13,13,104,41,63
2021,Stockport 021,E02001207,2938,847,446,401,1981,360,1023,367,430,226,346,164,150,32,243,144,99,9,9,110,53,57
2021,Stockport 022,E02001208,3444,1236,476,760,2072,203,960,316,454,190,506,303,180,23,381,238,143,22,22,136,54,82
2021,Stockport 023,E02001209,3441,1110,364,746,2196,171,944,298,482,164,558,328,205,25,494,341,153,29,29,135,43,92
2021,Stockport 024,E02001210,3041,902,430,472,1986,253,815,244,390,181,370,149,186,35,529,359,170,19,19,153,83,70
2021,Stockport 025,E02001211,2606,680,391,289,1785,260,1095,291,627,177,238,137,88,13,183,104,79,9,9,141,74,67
2021,Stockport 026,E02001212,2684,753,249,504,1760,108,716,212,363,141,361,149,182,30,550,376,174,25,25,171,93,78
2021,Stockport 027,E02001213,4278,1364,587,777,2749,292,1447,449,746,252,578,329,219,30,410,230,180,22,22,165,74,91
2021,Stockport 028,E02001214,3172,927,546,381,2025,389,1120,270,586,264,234,126,94,14,269,143,126,13,13,220,118,102
2021,Stockport 029,E02001215,2624,814,505,309,1713,387,825,291,370,164,280,144,122,14,213,126,87,8,8,97,49,48
2021,Stockport 030,E02001216,3322,1015,498,517,2166,427,1187,328,667,192,299,168,117,14,246,126,120,7,7,141,56,85
2021,Stockport 031,E02001217,3137,1159,533,626,1850,264,785,248,398,139,416,247,142,27,361,234,127,24,24,128,57,71
2021,Stockport 032,E02001218,2360,516,301,215,1751,380,974,269,525,180,194,89,90,15,193,113,80,10,10,93,50,43
2021,Stockport 033,E02001219,2219,563,387,176,1575,359,821,245,391,185,230,116,97,17,165,80,85,0,0,81,33,48
2021,Stockport 034,E02001220,2316,648,334,314,1570,249,866,223,469,174,228,110,108,10,219,118,101,8,8,98,44,54
2021,Stockport 035,E02001221,2385,550,384,166,1743,401,964,301,459,204,213,106,96,11,159,70,89,6,6,92,41,51
2021,Stockport 036,E02001222,2414,593,419,174,1633,347,919,223,479,217,181,91,78,12,178,73,105,8,8,188,114,74
2021,Stockport 037,E02001223,2797,768,474,294,1938,423,1100,344,548,208,218,98,105,15,191,101,90,6,6,91,36,55
2021,Stockport 038,E02001224,2550,704,464,240,1757,540,874,342,356,176,202,110,72,20,134,57,77,7,7,89,34,55
2021,Stockport 039,E02001225,3026,790,487,303,2136,384,1191,313,654,224,281,151,113,17,268,153,115,12,12,100,43,57
2021,Stockport 040,E02001226,2785,752,390,362,1851,289,1004,257,536,211,258,125,114,19,275,168,107,25,25,182,104,78
2021,Stockport 041,E02001227,2331,566,413,153,1695,422,975,289,518,168,141,59,70,12,156,73,83,1,1,70,38,32
2021,Stockport 042,E02001228,2519,589,393,196,1845,396,1104,335,586,183,213,120,83,10,129,69,60,3,3,85,38,47
2021,Tameside 001,E02001229,4671,1566,578,988,2950,356,1294,479,596,219,758,433,292,33,518,352,166,24,24,155,71,84
2021,Tameside 002,E02001230,2344,574,328,246,1626,340,863,275,335,253,199,80,103,16,215,120,95,9,9,144,66,78
2021,Tameside 003,E02001231,2862,706,297,409,2027,260,963,319,456,188,388,133,217,38,398,256,142,18,18,129,68,61
2021,Tameside 004,E02001232,3613,1075,385,690,2361,244,980,321,469,190,460,193,229,38,647,472,175,30,30,177,93,84
2021,Tameside 005,E02001233,3372,1149,566,583,2038,259,892,305,380,207,390,172,183,35,480,315,165,17,17,185,118,67
2021,Tameside 006,E02001234,3265,1042,400,642,2049,185,813,261,382,170,411,156,213,42,603,425,178,37,37,174,105,69
2021,Tameside 007,E02001235,3055,945,332,613,1921,201,831,287,392,152,452,229,198,25,416,273,143,21,21,189,94,95
2021,Tameside 008,E02001236,2623,898,347,551,1592,123,560,186,270,104,360,142,178,40,526,378,148,23,23,133,65,68
2021,Tameside 009,E02001237,3087,998,337,661,1970,188,868,307,398,163,462,203,222,37,424,289,135,28,28,119,54,65
2021,Tameside 010,E02001238,3539,1202,562,640,2178,285,967,333,376,258,456,210,212,34,449,285,164,21,21,159,73,86
2021,Tameside 011,E02001239,3987,1185,479,706,2580,244,1106,382,444,280,597,236,294,67,606,389,217,27,27,222,106,116
2021,Tameside 012,E02001240,2630,696,292,404,1750,211,765,271,306,188,376,176,165,35,377,217,160,21,21,184,88,96
2021,Tameside 013,E02001241,4711,2091,534,1557,2265,111,983,238,598,147,402,225,154,23,710,500,210,59,59,355,221,134
2021,Tameside 014,E02001242,2886,762,357,405,1965,261,978,315,460,203,407,189,187,31,308,188,120,11,11,159,79,80
2021,Tameside 015,E02001243,3828,1307,512,795,2385,436,1084,416,439,229,464,252,184,28,383,240,143,18,18,136,56,80
2021,Tameside 016,E02001244,2304,599,333,266,1604,296,752,275,276,201,304,136,138,30,245,142,103,7,7,101,48,53
2021,Tameside 017,E02001245,3622,1308,437,871,2158,205,903,356,383,164,523,246,239,38,505,348,157,22,22,156,77,79
2021,Tameside 018,E02001246,3186,1062,462,600,1989,247,795,273,344,178,462,194,217,51,466,313,153,19,19,135,69,66
2021,Tameside 019,E02001247,3272,1104,437,667,2021,195,828,316,349,163,500,223,231,46,480,311,169,18,18,147,83,64
2021,Tameside 020,E02001248,5221,1823,572,1251,3179,240,1283,404,662,217,836,412,375,49,783,528,255,37,37,219,121,98
2021,Tameside 021,E02001249,2920,1004,371,633,1788,212,695,253,287,155,404,194,189,21,450,272,178,27,27,128,59,69
2021,Tameside 022,E02001250,2738,704,326,378,1925,306,963,359,371,233,377,177,158,42,268,153,115,11,11,109,55,54
2021,Tameside 023,E02001251,2837,943,418,525,1786,325,753,338,262,153,383,217,144,22,317,210,107,8,8,108,43,65
2021,Tameside 024,E02001252,3277,987,528,459,2149,378,1045,356,441,248,407,195,181,31,304,156,148,15,15,141,71,70
2021,Tameside 025,E02001253,2259,767,290,477,1401,189,620,219,244,157,277,140,120,17,304,176,128,11,11,91,44,47
2021,Tameside 026,E02001254,2492,786,365,421,1608,256,603,210,235,158,351,143,170,38,376,224,152,22,22,98,44,54
2021,Tameside 027,E02001255,3232,1034,356,678,2030,140,671,228,305,138,497,215,245,37,698,490,208,24,24,168,93,75
2021,Tameside 028,E02001256,4172,1452,516,936,2441,197,1149,318,640,191,482,239,209,34,580,417,163,33,33,279,181,98
2021,Tameside 029,E02001257,4282,1650,803,847,2468,376,935,352,374,209,504,224,230,50,631,396,235,22,22,164,87,77
2021,Tameside 030,E02001258,3231,955,493,462,2149,380,1012,372,437,203,430,230,173,27,315,195,120,12,12,127,61,66
2021,Trafford 001,E02001259,4762,1801,387,1414,2407,73,1033,227,653,153,525,378,135,12,671,423,248,105,105,554,223,331
2021,Trafford 002,E02001260,3075,738,402,336,2200,331,1170,342,578,250,344,175,141,28,346,197,149,9,9,137,69,68
2021,Trafford 003,E02001261,3664,1123,286,837,2259,117,992,265,555,172,545,322,194,29,567,354,213,38,38,282,95,187
2021,Trafford 004,E02001262,3085,841,338,503,1823,151,952,194,535,223,284,160,106,18,404,211,193,32,32,421,217,204
2021,Trafford 005,E02001263,3410,883,515,368,2402,465,1318,379,647,292,343,161,155,27,270,140,130,6,6,125,60,65
2021,Trafford 006,E02001264,3300,772,318,454,2326,213,1230,335,656,239,406,209,163,34,462,242,220,15,15,202,118,84
2021,Trafford 007,E02001265,3387,949,487,462,2296,303,1154,345,546,263,408,175,203,30,419,247,172,12,12,142,75,67
2021,Trafford 008,E02001266,3093,1150,437,713,1803,207,831,258,408,165,293,151,112,30,441,291,150,31,31,140,66,74
2021,Trafford 009,E02001267,3390,1336,585,751,1927,242,950,308,476,166,424,267,141,16,302,169,133,9,9,127,43,84
2021,Trafford 010,E02001268,2957,808,477,331,2059,385,1108,338,541,229,309,153,130,26,243,127,116,14,14,90,45,45
2021,Trafford 011,E02001269,3578,1254,512,742,2074,180,993,281,548,164,439,258,161,20,433,262,171,29,29,250,98,152
2021,Trafford 012,E02001270,3651,1155,472,683,2377,243,1257,311,776,170,505,348,137,20,348,225,123,24,24,119,47,72
2021,Trafford 013,E02001271,2788,828,398,430,1842,223,899,249,475,175,319,141,150,28,381,236,145,20,20,118,61,57
2021,Trafford 014,E02001272,3368,987,463,524,2255,359,1256,318,757,181,358,200,138,20,273,154,119,9,9,126,59,67
2021,Trafford 015,E02001273,4349,1658,645,1013,2544,300,1438,404,901,133,497,345,140,12,286,189,97,23,23,147,48,99
2021,Trafford 016,E02001274,3145,777,490,287,2230,481,1382,370,759,253,176,85,80,11,180,87,93,11,11,138,64,74
2021,Trafford 017,E02001275,3345,1010,428,582,2160,188,787,293,323,171,430,142,248,40,732,505,227,23,23,175,83,92
2021,Trafford 018,E02001276,3245,885,471,414,2203,227,1080,273,606,201,386,164,184,38,492,314,178,18,18,157,87,70
2021,Trafford 019,E02001277,3802,1147,387,760,2456,150,1181,267,719,195,427,214,170,43,676,439,237,22,22,199,105,94
2021,Trafford 020,E02001278,3363,807,371,436,2428,340,1523,355,915,253,301,156,125,20,244,139,105,20,20,128,64,64
2021,Trafford 021,E02001279,3165,642,360,282,2407,382,1542,384,884,274,265,132,114,19,213,109,104,5,5,116,58,58
2021,Trafford 022,E02001280,3513,1159,605,554,2176,304,1033,273,575,185,307,130,146,31,509,326,183,23,23,178,92,86
2021,Trafford 023,E02001281,3075,751,501,250,2229,456,1341,330,761,250,236,110,108,18,189,102,87,7,7,95,48,47
2021,Trafford 024,E02001282,4225,1225,482,743,2818,258,1513,347,976,190,618,409,191,18,405,261,144,24,24,182,63,119
2021,Trafford 025,E02001283,4096,1290,575,715,2660,447,1450,409,848,193,458,333,101,24,278,170,108,27,27,146,60,86
2021,Trafford 026,E02001284,3122,689,359,330,2320,297,1498,361,933,204,272,153,108,11,242,142,100,11,11,113,43,70
2021,Trafford 027,E02001285,3255,978,518,460,2169,442,1183,328,669,186,289,194,82,13,245,160,85,10,10,108,51,57
2021,Trafford 028,E02001286,3060,730,497,233,2151,440,1350,325,790,235,145,55,77,13,211,122,89,5,5,179,105,74
2021,Wigan 001,E02001287,2801,697,341,356,2022,286,1040,361,476,203,459,247,186,26,229,144,85,8,8,82,35,47
2021,Wigan 002,E02001288,3617,1010,509,501,2502,454,1283,452,580,251,451,253,170,28,301,159,142,13,13,105,45,60
2021,Wigan 003,E02001289,4451,1230,690,540,3069,650,1555,582,658,315,473,226,213,34,380,208,172,11,11,152,65,87
2021,Wigan 004,E02001290,2692,812,424,388,1788,306,914,335,390,189,297,140,133,24,263,157,106,8,8,92,39,53
2021,Wigan 005,E02001291,3329,956,455,501,2261,294,993,359,396,238,471,199,235,37,478,290,188,25,25,112,53,59
2021,Wigan 006,E02001292,3687,1255,511,744,2298,423,1130,406,496,228,428,248,163,17,294,166,128,23,23,134,41,93
2021,Wigan 007,E02001293,2674,713,337,376,1856,321,906,349,345,212,352,159,169,24,271,157,114,6,6,105,48,57
2021,Wigan 008,E02001294,3681,1353,430,923,2171,223,955,345,422,188,561,319,215,27,402,237,165,30,30,157,61,96
2021,Wigan 009,E02001295,3537,1632,543,1089,1762,167,672,264,262,146,414,199,180,35,481,294,187,28,28,143,69,74
2021,Wigan 010,E02001296,3602,1087,413,674,2302,138,742,237,343,162,590,187,349,54,793,557,236,39,39,213,123,90
2021,Wigan 011,E02001297,2925,982,428,554,1832,222,836,287,362,187,416,210,174,32,346,210,136,12,12,111,53,58
2021,Wigan 012,E02001298,3363,1032,373,659,2135,185,834,268,375,191,503,189,265,49,582,366,216,31,31,196,116,80
2021,Wigan 013,E02001299,3875,1270,497,773,2454,307,1152,432,464,256,521,274,220,27,454,280,174,20,20,151,67,84
2021,Wigan 014,E02001300,3505,1156,502,654,2201,296,886,343,332,211,552,244,264,44,444,269,175,23,23,148,76,72
2021,Wigan 015,E02001301,4078,1498,494,1004,2372,207,911,347,397,167,660,330,285,45,566,380,186,28,28,208,101,107
2021,Wigan 016,E02001302,3359,1039,529,510,2166,313,935,300,406,229,458,171,236,51,442,281,161,18,18,154,92,62
2021,Wigan 017,E02001303,3877,1291,421,870,2388,223,900,288,434,178,581,276,266,39,647,442,205,37,37,198,106,92
2021,Wigan 018,E02001304,5611,1632,901,731,3841,705,1942,651,904,387,658,322,291,45,518,317,201,18,18,138,59,79
2021,Wigan 019,E02001305,3640,916,480,436,2570,484,1230,505,465,260,491,233,231,27,345,194,151,20,20,154,77,77
2021,Wigan 020,E02001306,3028,741,391,350,2183,431,1055,387,366,302,366,145,188,33,320,174,146,11,11,104,51,53
2021,Wigan 021,E02001307,4617,941,511,430,3523,636,1961,573,923,465,570,263,256,51,351,190,161,5,5,153,79,74
2021,Wigan 022,E02001308,2720,889,406,483,1728,310,746,295,291,160,347,166,152,29,313,190,123,12,12,103,52,51
2021,Wigan 023,E02001309,3828,1318,526,792,2383,324,976,361,441,174,610,319,250,41,452,283,169,21,21,127,59,68
2021,Wigan 024,E02001310,3911,1218,423,795,2500,257,1064,354,500,210,590,253,290,47,563,387,176,26,26,193,93,100
2021,Wigan 025,E02001311,3721,1245,517,728,2334,342,987,372,404,211,510,241,236,33,477,285,192,18,18,142,55,87
2021,Wigan 026,E02001312,3425,930,323,607,2337,286,1020,361,459,200,570,264,261,45,449,283,166,12,12,158,89,69
2021,Wigan 027,E02001313,3513,1146,419,727,2220,253,939,355,415,169,490,211,247,32,505,318,187,33,33,147,79,68
2021,Wigan 028,E02001314,3226,782,332,450,2325,307,1263,418,599,246,387,148,215,24,361,209,152,7,7,119,67,52
2021,Wigan 029,E02001315,4008,1009,468,541,2850,425,1337,480,630,227,684,348,298,38,398,230,168,6,6,149,60,89
2021,Wigan 030,E02001316,3493,1443,359,1084,1883,137,682,269,302,111,558,279,256,23,467,317,150,39,39,167,75,92
2021,Wigan 031,E02001317,3905,1208,397,811,2573,349,1126,426,456,244,612,275,308,29,463,300,163,23,23,124,67,57
2021,Wigan 032,E02001318,3403,1050,563,487,2234,406,987,337,379,271,419,164,213,42,408,250,158,14,14,119,55,64
2021,Wigan 033,E02001319,3669,1217,471,746,2276,219,879,346,345,188,611,292,283,36,542,335,207,25,25,176,75,101
2021,Wigan 034,E02001320,3397,1184,448,736,2079,317,834,331,306,197,456,182,230,44,456,274,182,16,16,134,61,73
2021,Wigan 035,E02001321,3340,851,428,423,2370,401,1163,421,490,252,400,172,188,40,391,236,155,15,15,119,54,65
2021,Wigan 036,E02001322,3186,958,464,494,2130,426,961,362,379,220,384,195,151,38,340,186,154,19,19,98,38,60
2021,Wigan 037,E02001323,3433,1107,517,590,2215,370,1031,328,488,215,422,196,180,46,377,221,156,15,15,111,49,62
2021,Wigan 038,E02001324,3601,1148,489,659,2302,301,966,368,405,193,533,242,253,38,485,313,172,17,17,151,79,72
2021,Wigan 039,E02001325,3841,998,459,539,2711,467,1329,498,570,261,559,306,229,24,346,196,150,10,10,132,59,73
2021,Wigan 040,E02001326,3545,1007,501,506,2416,425,1143,416,500,227,488,259,202,27,352,219,133,8,8,122,64,58
2021,Birmingham 001,E02001827,2633,736,455,281,1783,348,977,246,539,192,190,95,74,21,255,158,97,13,13,114,65,49
2021,Birmingham 002,E02001828,3130,1049,621,428,1970,447,1021,279,551,191,238,123,97,18,254,163,91,10,10,111,50,61
2021,Birmingham 003,E02001829,3573,825,478,347,2613,470,1534,375,910,249,293,148,124,21,310,184,126,6,6,135,77,58
2021,Birmingham 004,E02001830,3991,1032,562,470,2767,669,1543,479,733,331,313,196,98,19,225,123,102,17,17,192,98,94
2021,Birmingham 005,E02001831,4491,1419,641,778,2867,323,1288,343,681,264,455,209,208,38,768,469,299,33,33,205,98,107
2021,Birmingham 006,E02001832,3435,1035,530,505,2261,456,1205,347,581,277,317,182,113,22,272,167,105,11,11,139,67,72
2021,Birmingham 007,E02001833,2289,503,291,212,1645,280,881,265,396,220,204,72,107,25,265,151,114,15,15,141,78,63
2021,Birmingham 008,E02001834,2408,663,278,385,1599,135,645,184,312,149,293,106,150,37,502,318,184,24,24,146,78,68
2021,Birmingham 009,E02001835,3657,1259,514,745,2245,316,1193,340,628,225,434,266,133,35,286,175,111,16,16,153,54,99
2021,Birmingham 010,E02001836,3701,958,532,426,2538,507,1384,417,671,296,343,182,131,30,281,158,123,23,23,205,99,106
2021,Birmingham 011,E02001837,4039,1194,445,749,2493,142,959,244,481,234,434,141,232,61,895,584,311,63,63,352,190,162
2021,Birmingham 012,E02001838,3166,840,466,374,2197,432,1212,400,549,263,317,183,121,13,228,117,111,8,8,129,55,74
2021,Birmingham 013,E02001839,2825,972,447,525,1694,197,737,219,337,181,314,149,150,15,422,269,153,24,24,159,82,77
2021,Birmingham 014,E02001840,3808,1292,494,798,2238,158,854,217,446,191,359,141,190,28,830,551,279,37,37,278,163,115
2021,Birmingham 015,E02001841,2375,568,362,206,1674,440,932,282,429,221,150,79,60,11,141,67,74,11,11,133,71,62
2021,Birmingham 016,E02001842,3179,849,371,478,2084,244,1028,295,502,231,288,138,126,24,492,278,214,32,32,246,126,120
2021,Birmingham 017,E02001843,2837,903,428,475,1758,222,746,247,332,167,330,140,169,21,437,283,154,23,23,176,72,104
2021,Birmingham 018,E02001844,4431,1787,790,997,2418,364,1209,425,539,245,426,259,135,32,396,231,165,23,23,226,89,137
2021,Birmingham 019,E02001845,2723,789,312,477,1784,177,807,196,421,190,331,134,175,22,444,284,160,25,25,150,83,67
2021,Birmingham 020,E02001846,3294,1104,397,707,1916,149,797,216,414,167,349,156,156,37,595,392,203,26,26,274,147,127
2021,Birmingham 021,E02001847,2355,658,354,304,1592,311,795,252,369,174,240,122,93,25,235,137,98,11,11,105,54,51
2021,Birmingham 022,E02001848,2597,664,216,448,1721,125,693,157,396,140,233,75,133,25,623,449,174,47,47,212,129,83
2021,Birmingham 023,E02001849,3721,1307,339,968,2156,110,739,220,422,97,463,220,218,25,794,608,186,50,50,258,90,168
2021,Birmingham 024,E02001850,3029,790,361,429,1881,198,996,209,575,212,202,75,106,21,437,245,192,48,48,358,219,139
2021,Birmingham 025,E02001851,3851,1298,528,770,2318,221,1014,347,461,206,450,210,202,38,599,384,215,34,34,235,131,104
2021,Birmingham 026,E02001852,2854,1023,377,646,1518,142,679,179,363,137,247,120,99,28,408,263,145,42,42,313,148,165
2021,Birmingham 029,E02001855,4213,1482,589,893,2476,217,755,223,309,223,430,148,221,61,1031,679,352,43,43,255,150,105
2021,Birmingham 030,E02001856,3607,1115,271,844,2023,105,959,240,551,168,302,136,153,13,596,370,226,61,61,469,198,271
2021,Birmingham 031,E02001857,5575,2208,484,1724,2754,160,1091,304,581,206,509,283,189,37,900,562,338,94,94,613,254,359
2021,Birmingham 032,E02001858,3231,1335,313,1022,1510,88,770,190,413,167,155,83,64,8,456,312,144,41,41,386,219,167
2021,Birmingham 033,E02001859,2933,630,236,394,1750,81,1061,134,714,213,113,53,54,6,427,232,195,68,68,553,374,179
2021,Birmingham 034,E02001860,2734,698,215,483,1578,93,807,90,538,179,129,37,78,14,497,289,208,52,52,458,287,171
2021,Birmingham 035,E02001861,3480,1044,227,817,1894,77,965,133,641,191,135,54,70,11,657,447,210,60,60,542,361,181
2021,Birmingham 036,E02001862,3231,808,283,525,1956,93,996,123,635,238,167,66,79,22,641,388,253,59,59,467,273,194
2021,Birmingham 037,E02001863,2445,685,213,472,1341,50,765,75,559,131,75,28,35,12,403,218,185,48,48,419,304,115
2021,Birmingham 039,E02001865,3374,773,213,560,1926,80,1003,131,659,213,125,38,72,15,623,382,241,95,95,675,429,246
2021,Birmingham 040,E02001866,2803,816,184,632,1473,40,822,105,575,142,90,40,45,5,463,275,188,58,58,514,310,204
2021,Birmingham 041,E02001867,2590,787,242,545,1421,34,774,77,588,109,79,16,60,3,483,261,222,51,51,382,272,110
2021,Birmingham 042,E02001868,2630,463,248,215,1700,166,1080,141,737,202,122,43,58,21,300,194,106,32,32,467,336,131
2021,Birmingham 043,E02001869,2488,856,246,610,1413,46,530,68,406,56,114,29,69,16,668,494,174,55,55,219,127,92
2021,Birmingham 044,E02001870,3593,649,270,379,2434,108,1482,217,1021,244,146,44,80,22,649,415,234,49,49,510,360,150
2021,Birmingham 045,E02001871,3558,1301,540,761,2056,189,754,215,380,159,377,147,189,41,700,489,211,36,36,201,109,92
2021,Birmingham 046,E02001872,3080,1011,418,593,1872,152,642,195,318,129,394,155,201,38,669,458,211,15,15,197,104,93
2021,Birmingham 047,E02001873,3983,1214,315,899,2259,90,929,151,614,164,210,89,97,24,919,646,273,111,111,510,259,251
2021,Birmingham 048,E02001874,2681,559,182,377,1684,44,986,115,727,144,110,34,65,11,488,314,174,56,56,438,309,129
2021,Birmingham 049,E02001875,3291,1168,234,934,1742,27,746,119,535,92,314,224,78,12,588,417,171,67,67,381,187,194
2021,Birmingham 050,E02001876,3669,1565,261,1304,1712,27,669,152,467,50,289,201,81,7,622,445,177,105,105,392,140,252
2021,Birmingham 051,E02001877,3157,592,187,405,1985,57,1212,129,867,216,84,20,55,9,585,376,209,47,47,580,424,156
2021,Birmingham 052,E02001878,2708,655,138,517,1545,30,844,103,605,136,100,28,61,11,531,327,204,40,40,508,322,186
2021,Birmingham 053,E02001879,3049,924,202,722,1610,57,790,106,534,150,168,79,80,9,537,339,198,58,58,515,260,255
2021,Birmingham 054,E02001880,3430,855,292,563,2277,108,922,198,569,155,346,110,198,38,862,567,295,39,39,298,182,116
2021,Birmingham 055,E02001881,2895,618,197,421,1855,76,1125,140,833,152,125,46,60,19,487,303,184,42,42,422,303,119
2021,Birmingham 056,E02001882,3166,1070,410,660,1736,148,855,191,490,174,192,83,87,22,500,360,140,41,41,360,240,120
2021,Birmingham 057,E02001883,3624,1314,464,850,2104,145,758,220,365,173,373,146,179,48,803,532,271,25,25,206,113,93
2021,Birmingham 058,E02001884,2484,392,147,245,1666,36,1101,98,871,132,75,22,44,9,421,280,141,33,33,426,313,113
2021,Birmingham 060,E02001886,3469,1103,242,861,1819,151,990,230,574,186,252,165,76,11,371,222,149,55,55,547,243,304
2021,Birmingham 062,E02001888,2546,677,316,361,1653,114,724,173,405,146,228,83,107,38,555,346,209,32,32,216,136,80
2021,Birmingham 063,E02001889,2238,353,123,230,1493,70,960,106,688,166,50,11,29,10,380,225,155,33,33,392,283,109
2021,Birmingham 064,E02001890,4402,1970,511,1459,1926,182,991,336,513,142,377,313,56,8,285,171,114,91,91,506,117,389
2021,Birmingham 066,E02001892,3467,788,268,520,2258,88,1253,189,890,174,174,68,78,28,698,463,235,45,45,421,315,106
2021,Birmingham 067,E02001893,3162,901,432,469,1952,214,1068,260,575,233,233,106,95,32,397,198,199,40,40,309,201,108
2021,Birmingham 069,E02001895,3535,1102,466,636,2183,195,846,247,421,178,367,148,180,39,739,492,247,36,36,250,133,117
2021,Birmingham 070,E02001896,2569,484,155,329,1523,44,965,83,703,179,65,19,37,9,403,231,172,46,46,562,401,161
2021,Birmingham 071,E02001897,2888,1062,269,793,1513,42,768,103,552,113,115,58,52,5,536,327,209,52,52,313,219,94
2021,Birmingham 072,E02001898,2633,751,385,366,1728,262,869,258,389,222,290,127,135,28,291,155,136,16,16,154,92,62
2021,Birmingham 073,E02001899,3550,1159,651,508,2089,388,1179,324,666,189,264,186,70,8,245,152,93,13,13,302,148,154
2021,Birmingham 074,E02001900,2743,1108,357,751,1357,116,652,196,370,86,162,106,51,5,388,225,163,39,39,278,100,178
2021,Birmingham 075,E02001901,3750,1365,459,906,2080,205,1095,336,628,131,502,404,86,12,244,154,90,34,34,305,40,265
2021,Birmingham 076,E02001902,2461,688,311,377,1612,148,809,217,402,190,291,134,140,17,337,208,129,27,27,161,86,75
2021,Birmingham 077,E02001903,2121,443,144,299,1249,39,749,79,550,120,39,12,17,10,389,206,183,33,33,429,315,114
2021,Birmingham 078,E02001904,2622,750,298,452,1575,88,817,153,557,107,183,81,78,24,446,296,150,41,41,297,182,115
2021,Birmingham 079,E02001905,2648,904,293,611,1429,188,783,258,411,114,241,186,48,7,169,98,71,48,48,315,91,224
2021,Birmingham 080,E02001906,3878,1102,455,647,2526,310,1220,365,586,269,396,204,170,22,563,338,225,37,37,250,138,112
2021,Birmingham 081,E02001907,4396,1410,570,840,2706,355,1223,383,544,296,519,272,208,39,563,329,234,46,46,280,148,132
2021,Birmingham 082,E02001908,2208,372,134,238,1349,29,891,91,634,166,50,16,29,5,345,188,157,34,34,487,349,138
2021,Birmingham 083,E02001909,2369,616,138,478,1378,46,778,86,529,163,89,32,48,9,419,244,175,46,46,375,282,93
2021,Birmingham 084,E02001910,2338,814,192,622,1172,48,590,78,402,110,116,54,53,9,386,210,176,32,32,352,243,109
2021,Birmingham 085,E02001911,3533,1219,453,766,2120,159,864,201,501,162,290,128,141,21,764,562,202,43,43,194,97,97
2021,Birmingham 087,E02001913,3172,1243,477,766,1453,147,651,196,369,86,294,212,68,14,313,182,131,48,48,476,66,410
2021,Birmingham 088,E02001914,2313,658,185,473,1276,125,699,158,408,133,209,121,81,7,227,128,99,16,16,379,202,177
2021,Birmingham 089,E02001915,4920,1845,592,1253,2653,219,1282,354,674,254,461,252,184,25,637,387,250,54,54,422,201,221
2021,Birmingham 090,E02001916,3380,921,306,615,2133,128,1149,217,755,177,237,110,100,27,569,371,198,50,50,326,190,136
2021,Birmingham 092,E02001918,3975,1918,504,1414,1710,164,817,297,413,107,396,288,94,14,298,196,102,35,35,347,118,229
2021,Birmingham 093,E02001919,2619,1140,273,867,1105,123,586,133,328,125,180,148,29,3,196,106,90,20,20,374,210,164
2021,Birmingham 094,E02001920,3236,1102,408,694,1935,217,749,226,354,169,276,109,145,22,667,445,222,26,26,199,100,99
2021,Birmingham 095,E02001921,3179,974,357,617,1966,205,874,222,493,159,353,181,141,31,496,319,177,38,38,239,89,150
2021,Birmingham 096,E02001922,3501,621,125,496,728,32,264,62,173,29,159,113,40,6,221,158,63,52,52,2152,83,2069
2021,Birmingham 097,E02001923,3368,831,410,421,2015,197,1188,188,740,260,146,68,57,21,448,229,219,36,36,522,369,153
2021,Birmingham 098,E02001924,2502,700,285,415,1561,122,905,197,503,205,169,81,66,22,338,200,138,27,27,241,164,77
2021,Birmingham 099,E02001925,2836,991,470,521,1569,217,790,241,431,118,271,149,112,10,272,155,117,19,19,276,64,212
2021,Birmingham 100,E02001926,3091,981,333,648,1681,169,812,270,431,111,352,244,101,7,317,186,131,31,31,429,100,329
2021,Birmingham 101,E02001927,3010,941,400,541,1852,136,789,240,388,161,300,112,161,27,598,392,206,29,29,217,118,99
2021,Birmingham 102,E02001928,3000,1075,421,654,1791,232,701,236,286,179,274,103,144,27,564,361,203,20,20,134,78,56
2021,Birmingham 103,E02001929,3727,973,329,644,2445,117,1080,216,662,202,331,114,170,47,878,595,283,39,39,309,196,113
2021,Birmingham 104,E02001930,3213,1011,392,619,1919,166,962,286,524,152,453,316,123,14,308,181,127,30,30,283,94,189
2021,Birmingham 105,E02001931,3166,945,431,514,1928,281,1084,273,567,244,206,119,72,15,340,177,163,17,17,293,176,117
2021,Birmingham 106,E02001932,3075,1063,409,654,1852,138,717,212,378,127,335,157,149,29,638,451,187,24,24,160,80,80
2021,Birmingham 107,E02001933,3152,1035,379,656,1892,157,831,228,461,142,382,219,136,27,480,293,187,42,42,225,114,111
2021,Birmingham 108,E02001934,2289,492,245,247,1504,173,890,158,496,236,145,59,69,17,276,150,126,20,20,293,191,102
2021,Birmingham 109,E02001935,3279,980,525,455,2141,326,997,271,494,232,284,116,137,31,517,333,184,17,17,158,85,73
2021,Birmingham 110,E02001936,2557,712,386,326,1676,280,931,248,508,175,190,94,80,16,262,142,120,13,13,169,85,84
2021,Birmingham 111,E02001937,3259,1084,396,688,1921,158,904,204,540,160,254,113,109,32,574,365,209,31,31,254,136,118
2021,Birmingham 112,E02001938,3513,1181,352,829,2072,176,904,321,450,133,570,388,159,23,386,234,152,36,36,260,67,193
2021,Birmingham 113,E02001939,3102,1377,589,788,1622,309,695,227,324,144,211,107,91,13,394,255,139,13,13,103,40,63
2021,Birmingham 115,E02001941,2522,772,300,472,1558,124,619,159,340,120,253,112,121,20,531,346,185,31,31,192,108,84
2021,Birmingham 116,E02001942,3008,1107,447,660,1756,195,765,240,364,161,316,170,128,18,462,324,138,18,18,145,62,83
2021,Birmingham 117,E02001943,2638,831,328,503,1633,170,723,194,369,160,308,134,136,38,409,255,154,23,23,174,81,93
2021,Birmingham 118,E02001944,3409,1118,398,720,2101,210,931,245,505,181,432,239,161,32,513,308,205,15,15,190,93,97
2021,Birmingham 119,E02001945,3052,852,291,561,1956,128,717,211,350,156,357,135,178,44,721,483,238,33,33,244,128,116
2021,Birmingham 120,E02001946,3208,967,469,498,2085,337,1039,346,460,233,343,174,145,24,350,199,151,16,16,156,76,80
2021,Birmingham 121,E02001947,2664,1016,369,647,1495,119,480,141,248,91,230,96,105,29,637,414,223,29,29,153,81,72
2021,Birmingham 122,E02001948,3051,932,396,536,1972,219,871,289,377,205,429,191,195,43,436,259,177,17,17,147,80,67
2021,Birmingham 123,E02001949,2650,871,294,577,1653,160,603,208,288,107,367,182,167,18,503,362,141,20,20,126,64,62
2021,Birmingham 124,E02001950,3707,1139,490,649,2393,330,1072,381,458,233,455,229,185,41,506,322,184,30,30,175,77,98
2021,Birmingham 125,E02001951,3915,1285,489,796,2382,204,791,260,362,169,471,186,240,45,883,607,276,33,33,248,131,117
2021,Birmingham 126,E02001952,4104,1637,579,1058,2260,179,719,240,345,134,417,183,197,37,898,612,286,47,47,207,113,94
2021,Birmingham 127,E02001953,2924,840,442,398,1926,346,880,281,408,191,314,155,141,18,361,203,158,25,25,158,72,86
2021,Birmingham 128,E02001954,3261,1213,472,741,1838,167,600,196,275,129,357,155,170,32,689,513,176,25,25,210,127,83
2021,Birmingham 129,E02001955,3536,1236,509,727,2104,212,759,253,350,156,503,247,223,33,612,430,182,18,18,196,104,92
2021,Birmingham 130,E02001956,2849,878,337,541,1818,194,790,257,370,163,393,186,174,33,428,285,143,13,13,153,82,71
2021,Birmingham 131,E02001957,3348,965,435,530,2232,288,967,353,382,232,480,235,218,27,471,317,154,26,26,151,57,94
2021,Birmingham 132,E02006807,3029,742,371,371,2086,271,1206,327,652,227,256,132,100,24,341,198,143,12,12,201,112,89
2021,Birmingham 133,E02006809,3142,629,287,342,1967,216,1233,210,620,403,118,45,54,19,367,145,222,33,33,546,361,185
2021,Birmingham 134,E02006895,4161,1855,245,1610,1865,31,692,267,386,39,477,400,70,7,556,399,157,109,109,441,76,365
2021,Birmingham 135,E02006896,3158,1593,142,1451,1228,23,421,191,195,35,443,394,49,0,240,177,63,101,101,337,34,303
2021,Birmingham 136,E02006897,4161,2257,205,2052,1574,26,569,230,304,35,451,381,65,5,418,295,123,110,110,330,59,271
2021,Birmingham 137,E02006898,4245,1917,184,1733,1828,32,565,278,247,40,791,724,60,7,332,201,131,108,108,500,58,442
2021,Birmingham 138,E02006899,4066,2387,91,2296,1329,12,411,283,113,15,698,669,26,3,96,68,28,112,112,350,12,338
2021,Birmingham 139,E02006900,4055,748,236,512,2613,71,1618,189,1161,268,116,37,64,15,739,445,294,69,69,694,499,195
2021,Birmingham 141,E02007038,5265,1633,608,1025,3223,257,1430,375,775,280,456,185,230,41,1012,643,369,68,68,409,225,184
2021,Birmingham 142,E02007039,2171,380,148,232,1356,78,840,91,604,145,70,19,48,3,331,198,133,37,37,435,280,155
2021,Birmingham 143,E02007040,2077,382,88,294,1382,46,865,103,665,97,90,31,47,12,357,239,118,24,24,313,199,114
2021,Coventry 001,E02001958,3399,1175,401,774,1964,191,853,273,405,175,438,200,216,22,439,284,155,43,43,260,128,132
2021,Coventry 002,E02001959,2583,592,305,287,1776,207,889,221,451,217,289,119,145,25,369,201,168,22,22,215,122,93
2021,Coventry 004,E02001961,3268,1058,375,683,1963,152,792,219,395,178,325,137,160,28,663,442,221,31,31,247,122,125
2021,Coventry 005,E02001962,2497,593,202,391,1593,86,805,168,477,160,274,116,133,25,397,236,161,31,31,311,176,135
2021,Coventry 006,E02001963,2539,755,398,357,1645,225,792,246,339,207,313,159,134,20,305,169,136,10,10,139,70,69
2021,Coventry 007,E02001964,4132,1102,400,702,2691,128,1069,276,636,157,535,197,295,43,914,690,224,45,45,339,204,135
2021,Coventry 008,E02001965,3388,1027,460,567,2147,296,1086,367,469,250,324,149,148,27,418,269,149,23,23,214,95,119
2021,Coventry 009,E02001966,2243,525,141,384,1339,51,758,107,517,134,138,57,76,5,356,243,113,36,36,379,212,167
2021,Coventry 010,E02001967,2868,791,463,328,1937,420,974,290,481,203,297,142,133,22,239,122,117,7,7,140,70,70
2021,Coventry 011,E02001968,2898,735,241,494,1912,149,949,207,536,206,298,124,153,21,479,303,176,37,37,251,133,118
2021,Coventry 012,E02001969,2681,859,336,523,1576,139,700,186,367,147,283,129,123,31,431,245,186,23,23,246,146,100
2021,Coventry 013,E02001970,2537,877,435,442,1515,261,665,207,325,133,275,144,113,18,297,155,142,17,17,145,66,79
2021,Coventry 014,E02001971,2482,643,314,329,1701,217,853,266,407,180,305,127,148,30,309,176,133,17,17,138,71,67
2021,Coventry 015,E02001972,4066,1193,282,911,2389,77,1247,208,868,171,356,155,186,15,637,440,197,72,72,484,263,221
2021,Coventry 016,E02001973,3491,1111,328,783,2050,153,904,242,474,188,361,192,145,24,573,369,204,59,59,330,172,158
2021,Coventry 017,E02001974,3943,1130,549,581,2585,347,1321,409,640,272,455,236,183,36,433,255,178,29,29,228,78,150
2021,Coventry 018,E02001975,2905,708,339,369,1969,188,1013,269,520,224,351,154,172,25,402,234,168,15,15,228,124,104
2021,Coventry 019,E02001976,3132,1039,464,575,1888,274,936,272,481,183,260,121,123,16,393,253,140,25,25,205,115,90
2021,Coventry 020,E02001977,4190,1614,377,1237,1996,78,780,231,404,145,406,270,119,17,642,370,272,90,90,580,209,371
2021,Coventry 021,E02001978,2584,672,256,416,1684,185,870,210,482,178,276,136,115,25,322,188,134,31,31,228,103,125
2021,Coventry 022,E02001979,2416,719,390,329,1591,286,770,249,364,157,301,156,133,12,221,130,91,13,13,106,33,73
2021,Coventry 023,E02001980,2566,750,446,304,1724,454,837,301,356,180,254,130,100,24,176,89,87,3,3,92,44,48
2021,Coventry 024,E02001981,4359,1412,285,1127,2227,57,1009,194,670,145,374,170,189,15,679,506,173,108,108,720,244,476
2021,Coventry 025,E02001982,3583,1069,410,659,2355,349,1125,360,577,188,453,255,173,25,412,273,139,16,16,159,57,102
2021,Coventry 026,E02001983,3248,1010,394,616,2027,244,962,318,451,193,407,210,171,26,382,213,169,32,32,211,82,129
2021,Coventry 027,E02001984,3959,999,337,662,2484,237,1266,381,635,250,454,212,202,40,473,289,184,54,54,476,210,266
2021,Coventry 028,E02001985,3089,885,169,716,1180,46,380,110,200,70,225,124,89,12,348,229,119,181,181,1024,94,930
2021,Coventry 029,E02001986,3655,1480,439,1041,1955,209,787,271,365,151,396,192,177,27,532,361,171,31,31,220,104,116
2021,Coventry 030,E02001987,2781,1117,368,749,1191,131,374,157,174,43,376,272,96,8,267,170,97,43,43,473,44,429
2021,Coventry 031,E02001988,3436,1828,353,1475,1208,77,433,171,206,56,307,238,60,9,295,195,100,96,96,400,58,342
2021,Coventry 032,E02001989,2532,684,274,410,1618,175,760,239,371,150,334,170,144,20,328,207,121,21,21,230,58,172
2021,Coventry 033,E02001990,3705,929,485,444,2565,465,1336,428,619,289,380,175,170,35,362,189,173,22,22,211,105,106
2021,Coventry 034,E02001991,3625,1123,573,550,2170,412,1175,404,547,224,326,199,106,21,234,131,103,23,23,332,65,267
2021,Coventry 035,E02001992,4182,1174,479,695,2691,222,1170,355,620,195,440,174,209,57,820,558,262,39,39,317,173,144
2021,Coventry 036,E02001993,3313,955,365,590,1832,204,846,277,381,188,276,127,120,29,478,340,138,28,28,526,129,397
2021,Coventry 037,E02001994,3253,960,459,501,2027,285,1104,308,574,222,258,146,100,12,352,181,171,28,28,266,108,158
2021,Coventry 038,E02001995,4004,1328,414,914,2233,170,1133,344,669,120,457,287,146,24,378,233,145,95,95,443,115,328
2021,Coventry 039,E02001996,3329,1287,358,929,1847,122,692,178,385,129,341,144,167,30,657,486,171,35,35,195,95,100
2021,Coventry 040,E02001997,3410,875,521,354,2332,478,1374,384,699,291,200,109,74,17,264,130,134,16,16,203,91,112
2021,Coventry 041,E02001998,2372,597,382,215,1641,303,945,237,506,202,188,75,100,13,192,89,103,13,13,134,66,68
2021,Coventry 042,E02001999,2190,531,294,237,1281,255,746,239,336,171,106,47,43,16,156,82,74,18,18,378,89,289
2021,Coventry 043,E02006805,3323,864,338,526,2146,149,1020,225,569,226,373,133,198,42,574,381,193,30,30,313,162,151
2021,Dudley 001,E02002000,3630,1103,437,666,2394,301,949,304,407,238,499,188,273,38,635,395,240,10,10,133,80,53
2021,Dudley 002,E02002001,2594,806,405,401,1663,236,772,252,311,209,308,123,153,32,334,191,143,13,13,125,65,60
2021,Dudley 003,E02002002,3025,849,551,298,2074,624,1032,328,432,272,232,122,90,20,181,86,95,5,5,102,46,56
2021,Dudley 004,E02002003,3817,1139,563,576,2508,440,1195,396,479,320,448,198,212,38,401,224,177,24,24,170,82,88
2021,Dudley 005,E02002004,3123,898,401,497,2090,261,924,315,375,234,414,156,214,44,471,290,181,20,20,135,83,52
2021,Dudley 006,E02002005,3625,821,356,465,2572,220,1079,316,543,220,486,161,273,52,758,537,221,29,29,232,147,85
2021,Dudley 007,E02002006,2892,960,373,587,1819,206,786,276,316,194,358,157,178,23,456,320,136,13,13,113,56,57
2021,Dudley 008,E02002007,3966,1220,722,498,2626,551,1206,403,488,315,491,200,261,30,368,203,165,10,10,120,53,67
2021,Dudley 009,E02002008,3196,670,237,433,2377,269,1370,453,580,337,382,192,154,36,341,196,145,15,15,149,83,66
2021,Dudley 010,E02002009,2636,743,241,502,1695,135,772,202,407,163,292,108,163,21,465,312,153,31,31,198,131,67
2021,Dudley 011,E02002010,3626,1496,407,1089,1875,139,752,231,373,148,340,178,146,16,595,389,206,49,49,255,149,106
2021,Dudley 012,E02002011,2603,760,434,326,1760,379,867,313,378,176,298,167,111,20,208,123,85,8,8,83,39,44
2021,Dudley 013,E02002012,3615,1294,582,712,2152,243,905,296,412,197,417,188,197,32,559,351,208,28,28,169,104,65
2021,Dudley 014,E02002013,2819,776,499,277,1962,474,1019,342,432,245,250,117,116,17,214,126,88,5,5,81,30,51
2021,Dudley 015,E02002014,3171,973,253,720,1907,166,865,249,448,168,372,164,188,20,474,332,142,30,30,291,174,117
2021,Dudley 016,E02002015,2950,794,377,417,2037,292,985,339,410,236,431,206,196,29,319,209,110,10,10,119,60,59
2021,Dudley 017,E02002016,3317,1014,391,623,2157,216,819,276,337,206,442,161,242,39,639,428,211,41,41,146,84,62
2021,Dudley 018,E02002017,3419,1162,457,705,2082,266,904,296,387,221,442,214,200,28,452,282,170,18,18,175,108,67
2021,Dudley 019,E02002018,3707,914,622,292,2688,622,1394,430,603,361,364,154,176,34,299,158,141,9,9,105,55,50
2021,Dudley 020,E02002019,3093,800,365,435,2138,254,920,292,388,240,408,176,200,32,539,362,177,17,17,155,87,68
2021,Dudley 021,E02002020,4231,1304,654,650,2782,577,1299,488,548,263,533,286,216,31,359,221,138,14,14,145,63,82
2021,Dudley 022,E02002021,3737,1703,423,1280,1881,157,675,265,296,114,494,287,186,21,520,371,149,35,35,153,79,74
2021,Dudley 023,E02002022,3723,1069,398,671,2535,244,1049,373,474,202,629,282,301,46,597,398,199,16,16,119,64,55
2021,Dudley 024,E02002023,2328,604,320,284,1662,327,716,253,293,170,337,169,145,23,275,126,149,7,7,62,31,31
2021,Dudley 025,E02002024,3647,1025,421,604,2445,350,1142,428,494,220,518,219,263,36,420,252,168,15,15,177,86,91
2021,Dudley 026,E02002025,3673,1127,451,676,2328,261,1094,366,507,221,459,229,195,35,488,326,162,26,26,218,123,95
2021,Dudley 027,E02002026,2865,745,426,319,2009,390,997,393,371,233,324,131,159,34,289,163,126,9,9,111,73,38
2021,Dudley 028,E02002027,2246,524,202,322,1655,290,979,373,370,236,252,136,103,13,129,64,65,5,5,67,33,34
2021,Dudley 029,E02002028,2627,842,445,397,1699,361,780,310,306,164,305,167,118,20,239,138,101,14,14,86,44,42
2021,Dudley 030,E02002029,2593,691,399,292,1804,350,859,274,385,200,260,120,123,17,326,192,134,9,9,98,48,50
2021,Dudley 031,E02002030,3026,1046,411,635,1835,252,783,279,340,164,390,205,165,20,394,250,144,16,16,145,59,86
2021,Dudley 032,E02002031,2562,841,333,508,1548,221,783,252,350,181,312,176,114,22,214,129,85,18,18,173,82,91
2021,Dudley 033,E02002032,4269,1261,542,719,2788,323,1163,412,509,242,625,309,282,34,651,419,232,26,26,220,101,119
2021,Dudley 034,E02002033,3304,987,530,457,2189,379,1056,312,475,269,386,192,173,21,352,210,142,16,16,128,58,70
2021,Dudley 035,E02002034,3897,1543,600,943,2239,291,975,340,449,186,577,362,190,25,380,231,149,16,16,115,50,65
2021,Dudley 036,E02002035,2515,663,405,258,1737,405,941,297,405,239,205,85,102,18,182,99,83,4,4,115,67,48
2021,Dudley 037,E02002036,2880,1098,412,686,1583,180,662,202,304,156,335,143,159,33,390,248,142,16,16,199,110,89
2021,Dudley 038,E02002037,2538,709,400,309,1746,337,838,259,378,201,307,138,137,32,255,139,116,9,9,83,39,44
2021,Dudley 039,E02002038,4413,1615,726,889,2617,422,1114,388,502,224,494,271,197,26,558,331,227,29,29,181,73,108
2021,Dudley 040,E02002039,2655,882,433,449,1688,331,821,272,375,174,301,187,101,13,219,124,95,16,16,85,48,37
2021,Dudley 041,E02002040,2555,699,457,242,1747,507,923,306,430,187,178,100,61,17,134,74,60,5,5,109,48,61
2021,Dudley 042,E02002041,2633,684,488,196,1834,461,889,315,373,201,205,105,79,21,269,169,100,10,10,115,71,44
2021,Dudley 043,E02002042,3340,856,529,327,2364,512,1246,384,590,272,317,150,139,28,278,138,140,11,11,120,68,52
2021,Sandwell 001,E02002043,3224,803,345,458,2206,232,1050,328,478,244,464,159,262,43,432,263,169,28,28,215,126,89
2021,Sandwell 002,E02002044,2941,700,276,424,1977,151,977,239,511,227,328,126,169,33,498,333,165,23,23,264,184,80
2021,Sandwell 003,E02002045,3184,951,408,543,2063,236,952,301,432,219,425,151,223,51,430,281,149,20,20,170,117,53
2021,Sandwell 004,E02002046,2051,461,221,240,1461,114,625,176,282,167,268,53,182,33,434,298,136,20,20,129,73,56
2021,Sandwell 005,E02002047,3090,1036,448,588,1858,284,821,317,325,179,356,153,175,28,383,254,129,14,14,196,132,64
2021,Sandwell 006,E02002048,2720,737,408,329,1758,339,910,250,400,260,232,109,103,20,263,123,140,14,14,225,124,101
2021,Sandwell 007,E02002049,2508,655,259,396,1712,206,786,282,285,219,331,118,182,31,376,263,113,13,13,141,90,51
2021,Sandwell 009,E02002051,2241,520,247,273,1575,139,624,197,275,152,333,88,223,22,463,330,133,16,16,146,92,54
2021,Sandwell 010,E02002052,4236,1121,431,690,2760,264,1260,337,602,321,449,134,278,37,757,512,245,30,30,355,223,132
2021,Sandwell 011,E02002053,2537,744,334,410,1622,220,796,213,384,199,202,75,107,20,389,217,172,15,15,171,117,54
2021,Sandwell 012,E02002054,2314,667,333,334,1489,235,679,163,316,200,197,87,88,22,354,189,165,24,24,158,94,64
2021,Sandwell 013,E02002055,4180,1193,453,740,2574,252,1295,308,696,291,400,154,215,31,601,356,245,26,26,413,270,143
2021,Sandwell 014,E02002056,3858,1161,395,766,2475,198,1035,283,511,241,527,187,290,50,680,444,236,35,35,222,147,75
2021,Sandwell 015,E02002057,4275,1488,576,912,2454,215,1201,361,591,249,453,196,225,32,548,361,187,37,37,333,233,100
2021,Sandwell 016,E02002058,4974,1436,446,990,3034,213,1527,387,801,339,505,231,246,28,724,446,278,65,65,504,347,157
2021,Sandwell 017,E02002059,4572,1583,553,1030,2550,238,1298,318,669,311,360,178,153,29,619,349,270,35,35,439,284,155
2021,Sandwell 018,E02002060,2632,740,283,457,1659,139,825,184,459,182,229,74,121,34,427,270,157,39,39,233,156,77
2021,Sandwell 019,E02002061,2421,762,315,447,1299,122,729,179,387,163,153,64,83,6,270,174,96,25,25,360,239,121
2021,Sandwell 020,E02002062,3492,1223,403,820,1884,123,893,219,486,188,293,135,133,25,543,328,215,32,32,385,236,149
2021,Sandwell 021,E02002063,3936,1198,309,889,2408,174,1198,321,680,197,420,178,212,30,581,351,230,35,35,330,191,139
2021,Sandwell 022,E02002064,4815,1221,453,768,3307,323,1592,459,752,381,605,231,325,49,750,531,219,37,37,287,178,109
2021,Sandwell 023,E02002065,4144,812,293,519,2538,138,1538,203,1011,324,225,70,136,19,561,319,242,76,76,794,533,261
2021,Sandwell 024,E02002066,2923,880,308,572,1725,126,880,171,537,172,200,86,100,14,460,278,182,59,59,318,188,130
2021,Sandwell 025,E02002067,2501,618,333,285,1761,249,836,261,392,183,355,157,171,27,311,190,121,10,10,122,72,50
2021,Sandwell 027,E02002069,3167,1141,417,724,1863,213,755,235,348,172,355,149,173,33,516,367,149,24,24,163,99,64
2021,Sandwell 028,E02002070,3596,1157,411,746,1969,128,958,169,615,174,233,107,110,16,594,379,215,56,56,470,316,154
2021,Sandwell 029,E02002071,2734,768,390,378,1818,235,736,231,317,188,369,136,195,38,459,321,138,19,19,148,82,66
2021,Sandwell 030,E02002072,3610,1178,435,743,2148,233,1033,288,501,244,371,182,161,28,476,295,181,35,35,284,155,129
2021,Sandwell 031,E02002073,2934,726,357,369,1927,166,961,211,512,238,262,93,128,41,510,300,210,28,28,281,177,104
2021,Sandwell 032,E02002074,3162,876,420,456,2080,241,1011,264,492,255,316,114,157,45,486,265,221,26,26,206,126,80
2021,Sandwell 033,E02002075,3683,1167,526,641,2281,275,1000,341,434,225,437,210,195,32,543,315,228,26,26,235,134,101
2021,Sandwell 034,E02002076,4530,1421,459,962,2724,210,1212,380,635,197,632,379,226,27,605,373,232,65,65,385,147,238
2021,Sandwell 035,E02002077,4514,1545,610,935,2690,290,1177,391,522,264,532,253,242,37,666,416,250,25,25,279,168,111
2021,Sandwell 036,E02002078,2592,705,379,326,1716,267,900,240,450,210,227,98,112,17,304,149,155,18,18,171,108,63
2021,Sandwell 037,E02002079,3533,1088,552,536,2237,263,1045,319,484,242,383,150,200,33,516,319,197,30,30,208,126,82
2021,Sandwell 038,E02002080,3086,983,404,579,1975,230,869,307,392,170,398,178,191,29,464,319,145,14,14,128,71,57
2021,Sandwell 039,E02006810,4315,1203,514,689,2797,465,1299,379,560,360,418,198,185,35,568,338,230,47,47,315,173,142
2021,Sandwell 040,E02006943,2645,901,240,661,1442,46,727,112,508,107,184,87,85,12,443,290,153,42,42,302,197,105
2021,Sandwell 041,E02006944,2356,466,79,387,1504,32,823,101,599,123,164,66,90,8,448,322,126,37,37,386,236,150
2021,Solihull 001,E02002081,2365,746,406,340,1502,330,713,257,278,178,235,107,99,29,215,117,98,9,9,117,61,56
2021,Solihull 002,E02002082,2316,673,270,403,1480,142,496,155,219,122,250,84,137,29,576,393,183,16,16,163,93,70
2021,Solihull 003,E02002083,2416,574,389,185,1724,318,941,304,366,271,268,95,139,34,189,98,91,8,8,118,58,60
2021,Solihull 004,E02002084,2757,830,305,525,1777,198,619,178,287,154,340,109,187,44,600,400,200,20,20,150,71,79
2021,Solihull 005,E02002085,2653,735,355,380,1758,179,679,193,325,161,349,119,187,43,540,364,176,11,11,160,83,77
2021,Solihull 006,E02002086,2652,1030,376,654,1503,150,487,153,191,143,295,102,166,27,561,415,146,10,10,119,55,64
2021,Solihull 007,E02002087,2684,900,346,554,1664,139,543,162,229,152,306,88,174,44,659,473,186,17,17,120,62,58
2021,Solihull 008,E02002088,4140,1394,501,893,2528,240,794,250,353,191,475,173,257,45,979,678,301,40,40,218,109,109
2021,Solihull 009,E02002089,3254,895,439,456,2170,348,1004,314,419,271,440,209,177,54,369,232,137,9,9,189,93,96
2021,Solihull 010,E02002090,2323,552,262,290,1651,194,902,257,433,212,277,135,125,17,262,127,135,16,16,120,67,53
2021,Solihull 011,E02002091,3127,876,499,377,2073,316,1064,321,494,249,362,180,152,30,319,170,149,12,12,178,86,92
2021,Solihull 012,E02002092,3038,969,484,485,1912,285,935,262,456,217,316,151,142,23,359,198,161,17,17,157,89,68
2021,Solihull 013,E02002093,2949,1054,436,618,1742,281,873,272,412,189,277,171,92,14,291,178,113,20,20,153,63,90
2021,Solihull 014,E02002094,2397,667,448,219,1605,353,950,277,464,209,152,77,64,11,140,75,65,10,10,125,66,59
2021,Solihull 015,E02002095,3631,1082,518,564,2366,428,1215,373,599,243,327,167,135,25,378,223,155,18,18,183,87,96
2021,Solihull 016,E02002096,4274,1258,737,521,2785,596,1500,398,807,295,323,198,106,19,349,189,160,17,17,231,128,103
2021,Solihull 017,E02002097,3115,883,459,424,2090,405,1166,418,516,232,276,179,80,17,229,131,98,14,14,142,70,72
2021,Solihull 018,E02002098,3904,1103,608,495,2596,431,1465,360,807,298,277,119,135,23,407,226,181,16,16,205,114,91
2021,Solihull 019,E02002099,2808,752,443,309,1930,453,1198,353,608,237,139,85,37,17,132,68,64,8,8,126,59,67
2021,Solihull 021,E02002101,2863,1028,509,519,1733,297,824,265,367,192,279,146,115,18,326,201,125,7,7,102,44,58
2021,Solihull 022,E02002102,3529,1012,537,475,2333,367,1265,297,701,267,298,157,128,13,383,225,158,20,20,184,101,83
2021,Solihull 023,E02002103,2545,690,449,241,1742,385,956,284,452,220,204,114,77,13,188,79,109,9,9,113,55,58
2021,Solihull 024,E02002104,2377,570,315,255,1729,346,1052,336,487,229,142,78,54,10,183,93,90,6,6,78,37,41
2021,Solihull 025,E02002105,3341,804,482,322,2396,540,1346,405,671,270,271,142,108,21,235,131,104,4,4,141,69,72
2021,Solihull 026,E02002106,4083,1139,737,402,2831,738,1558,459,815,284,231,116,99,16,294,173,121,10,10,113,53,60
2021,Solihull 027,E02002107,2255,548,260,288,1623,334,935,300,435,200,160,104,49,7,190,105,85,4,4,84,35,49
2021,Solihull 028,E02002108,3978,1009,685,324,2864,624,1702,473,944,285,238,127,98,13,291,182,109,9,9,105,50,55
2021,Solihull 029,E02002109,5048,1344,415,929,3515,458,1863,528,1012,323,670,443,213,14,503,365,138,21,21,189,79,110
2021,Solihull 030,E02006808,2672,735,355,380,1799,240,1016,255,552,209,288,148,128,12,241,136,105,14,14,138,72,66
2021,Walsall 001,E02002110,2830,735,306,429,1958,250,943,328,400,215,420,203,187,30,334,206,128,11,11,137,81,56
2021,Walsall 002,E02002111,2765,920,445,475,1730,265,687,248,259,180,380,154,185,41,382,267,115,16,16,115,69,46
2021,Walsall 003,E02002112,2211,570,332,238,1563,280,778,279,312,187,269,119,121,29,223,128,95,13,13,78,38,40
2021,Walsall 004,E02002113,2692,770,337,433,1789,265,773,279,318,176,353,152,180,21,378,255,123,20,20,133,62,71
2021,Walsall 005,E02002114,2678,833,503,330,1732,359,779,282,313,184,304,141,130,33,279,148,131,11,11,113,54,59
2021,Walsall 006,E02002115,2840,854,482,372,1860,271,798,256,325,217,363,128,189,46,416,262,154,12,12,126,60,66
2021,Walsall 007,E02002116,2910,793,453,340,2027,431,989,357,411,221,336,159,146,31,258,121,137,13,13,90,38,52
2021,Walsall 008,E02002117,2781,950,408,542,1729,267,829,314,316,199,360,183,144,33,251,146,105,22,22,102,41,61
2021,Walsall 009,E02002118,3031,885,457,428,1990,223,751,243,308,200,457,156,253,48,529,338,191,30,30,156,88,68
2021,Walsall 010,E02002119,2441,621,333,288,1676,257,809,261,328,220,282,115,140,27,313,168,145,15,15,144,78,66
2021,Walsall 011,E02002120,2356,493,251,242,1754,285,913,309,358,246,291,98,164,29,260,166,94,5,5,109,67,42
2021,Walsall 012,E02002121,2559,736,327,409,1680,150,685,208,324,153,368,140,193,35,450,307,143,27,27,143,88,55
2021,Walsall 013,E02002122,2494,548,213,335,1784,96,736,193,418,125,416,133,250,33,518,395,123,18,18,162,106,56
2021,Walsall 014,E02002123,2694,740,336,404,1817,257,742,228,327,187,393,142,217,34,407,266,141,18,18,137,70,67
2021,Walsall 015,E02002124,3194,1166,673,493,1916,344,802,285,329,188,363,174,163,26,385,246,139,22,22,112,48,64
2021,Walsall 016,E02002125,2745,839,350,489,1780,219,742,258,312,172,360,164,171,25,399,252,147,60,60,126,74,52
2021,Walsall 017,E02002126,2731,854,339,515,1726,130,614,211,253,150,405,128,234,43,565,399,166,12,12,151,91,60
2021,Walsall 018,E02002127,3440,872,300,572,2252,136,1059,281,604,174,400,150,207,43,620,450,170,37,37,316,222,94
2021,Walsall 019,E02002128,2424,755,376,379,1549,310,658,220,263,175,287,108,157,22,289,165,124,5,5,120,61,59
2021,Walsall 020,E02002129,2570,735,375,360,1741,314,791,286,295,210,321,136,160,25,300,154,146,15,15,94,58,36
2021,Walsall 021,E02002130,2583,683,310,373,1722,155,762,216,388,158,319,113,182,24,462,302,160,24,24,178,109,69
2021,Walsall 022,E02002131,3179,810,545,265,2245,493,1226,367,545,314,273,124,120,29,239,99,140,14,14,124,69,55
2021,Walsall 023,E02002132,2576,715,347,368,1722,205,715,227,337,151,308,103,182,23,476,311,165,18,18,139,85,54
2021,Walsall 024,E02002133,3059,1219,399,820,1628,254,763,266,340,157,268,138,104,26,318,182,136,25,25,212,112,100
2021,Walsall 025,E02002134,3619,997,328,669,2369,191,969,296,449,224,506,196,281,29,672,411,261,31,31,253,161,92
2021,Walsall 026,E02002135,2924,905,244,661,1729,111,806,204,471,131,292,136,134,22,454,289,165,66,66,290,177,113
2021,Walsall 027,E02002136,3262,1015,317,698,2006,188,884,260,428,196,416,171,224,21,461,293,168,57,57,241,136,105
2021,Walsall 028,E02002137,2567,726,491,235,1733,413,965,288,470,207,179,94,68,17,166,78,88,10,10,108,59,49
2021,Walsall 029,E02002138,2261,638,283,355,1373,182,794,184,422,188,149,75,59,15,234,140,94,14,14,250,174,76
2021,Walsall 030,E02002139,4315,1745,407,1338,2202,127,975,248,556,171,394,235,140,19,649,465,184,57,57,368,231,137
2021,Walsall 031,E02002140,2959,783,331,452,1886,132,1046,220,645,181,206,92,97,17,466,312,154,36,36,290,181,109
2021,Walsall 032,E02002141,2601,627,362,265,1843,372,993,284,474,235,256,111,123,22,211,102,109,11,11,131,70,61
2021,Walsall 033,E02002142,2714,708,233,475,1795,114,796,184,432,180,317,132,171,14,547,391,156,21,21,211,147,64
2021,Walsall 034,E02002143,3129,695,266,429,2049,119,1236,181,848,207,164,66,89,9,495,319,176,35,35,385,265,120
2021,Walsall 035,E02002144,2476,585,411,174,1594,372,954,233,462,259,88,47,30,11,164,83,81,16,16,297,187,110
2021,Walsall 036,E02002145,3269,949,308,641,2119,145,922,238,496,188,376,131,221,24,646,456,190,30,30,201,120,81
2021,Walsall 037,E02002146,2180,521,270,251,1424,156,757,157,423,177,179,72,84,23,311,199,112,21,21,235,167,68
2021,Walsall 038,E02002147,3482,884,356,528,2377,199,987,277,491,219,511,174,290,47,648,457,191,32,32,221,129,92
2021,Walsall 039,E02002148,4695,1260,719,541,3216,515,1592,466,745,381,565,258,264,43,526,301,225,18,18,219,137,82
2021,Wolverhampton 001,E02002149,4268,1261,661,600,2790,385,1256,485,493,278,513,192,264,57,615,341,274,21,21,217,109,108
2021,Wolverhampton 002,E02002150,2261,590,283,307,1512,159,730,233,326,171,250,101,117,32,356,221,135,17,17,159,95,64
2021,Wolverhampton 003,E02002151,2455,897,325,572,1449,124,615,234,242,139,295,132,145,18,398,247,151,17,17,109,65,44
2021,Wolverhampton 004,E02002152,2302,576,261,315,1560,124,621,175,294,152,253,73,150,30,536,361,175,26,26,166,97,69
2021,Wolverhampton 005,E02002153,3350,1123,524,599,2108,302,856,312,322,222,453,197,220,36,478,301,177,19,19,119,58,61
2021,Wolverhampton 006,E02002154,2939,838,293,545,1916,127,907,273,458,176,432,213,198,21,430,273,157,20,20,185,110,75
2021,Wolverhampton 007,E02002155,2348,560,270,290,1627,100,525,124,285,116,291,65,200,26,691,510,181,20,20,161,103,58
2021,Wolverhampton 008,E02002156,3333,981,497,484,2141,253,1085,312,469,304,371,144,180,47,422,250,172,10,10,211,112,99
2021,Wolverhampton 009,E02002157,3182,878,400,478,2121,328,1056,325,505,226,356,177,155,24,366,187,179,15,15,183,104,79
2021,Wolverhampton 010,E02002158,3282,1095,548,547,2006,340,832,278,319,235,366,139,198,29,457,280,177,11,11,181,106,75
2021,Wolverhampton 011,E02002159,2233,552,198,354,1482,93,620,135,348,137,279,84,173,22,461,317,144,29,29,199,125,74
2021,Wolverhampton 012,E02002160,2930,773,364,409,1945,266,1005,287,482,236,312,129,155,28,343,211,132,19,19,212,119,93
2021,Wolverhampton 013,E02002161,2550,699,186,513,1582,66,778,145,478,155,266,93,157,16,407,244,163,65,65,269,142,127
2021,Wolverhampton 014,E02002162,3363,1120,697,423,2070,483,980,317,430,233,278,135,125,18,314,176,138,15,15,173,101,72
2021,Wolverhampton 015,E02002163,5017,1902,504,1398,2735,153,1119,280,662,177,445,189,224,32,930,643,287,88,88,380,217,163
2021,Wolverhampton 016,E02002164,2361,898,180,718,1117,43,505,92,330,83,163,76,71,16,338,220,118,68,68,346,141,205
2021,Wolverhampton 017,E02002165,3655,1705,326,1379,1651,100,722,217,347,158,359,216,135,8,436,283,153,34,34,299,138,161
2021,Wolverhampton 018,E02002166,3808,1265,487,778,2318,230,910,250,437,223,421,144,229,48,725,474,251,32,32,225,138,87
2021,Wolverhampton 019,E02002167,2963,974,477,497,1831,347,849,295,367,187,307,167,121,19,317,184,133,11,11,158,79,79
2021,Wolverhampton 020,E02002168,4635,1945,420,1525,2239,105,932,225,547,160,464,280,166,18,666,434,232,72,72,451,193,258
2021,Wolverhampton 021,E02002169,3560,1011,571,440,2313,479,1261,396,571,294,272,108,141,23,287,149,138,14,14,236,139,97
2021,Wolverhampton 022,E02002170,2415,639,312,327,1577,193,764,210,347,207,264,72,161,31,347,212,135,9,9,199,122,77
2021,Wolverhampton 023,E02002171,3100,934,409,525,1932,238,797,235,366,196,354,128,199,27,514,293,221,29,29,234,130,104
2021,Wolverhampton 026,E02002174,3011,877,404,473,1860,241,1005,289,435,281,272,122,125,25,322,152,170,20,20,274,149,125
2021,Wolverhampton 027,E02002175,3070,980,377,603,1844,190,824,241,379,204,326,131,165,30,482,311,171,22,22,246,161,85
2021,Wolverhampton 028,E02002176,3313,1058,459,599,2105,299,940,303,420,217,360,148,182,30,488,312,176,18,18,150,73,77
2021,Wolverhampton 029,E02002177,4531,1359,405,954,2793,167,1208,317,661,230,550,264,250,36,788,524,264,80,80,379,236,143
2021,Wolverhampton 030,E02002178,2742,601,303,298,1777,283,1062,234,477,351,145,65,70,10,260,101,159,27,27,364,238,126
2021,Wolverhampton 031,E02002179,2609,705,382,323,1756,301,979,295,468,216,232,108,107,17,230,126,104,14,14,148,92,56
2021,Wolverhampton 032,E02002180,2595,739,392,347,1696,257,812,234,371,207,241,83,130,28,372,213,159,14,14,160,104,56
2021,Wolverhampton 033,E02002181,3368,965,378,587,2191,204,948,279,481,188,466,182,249,35,550,360,190,23,23,212,117,95
2021,Wolverhampton 034,E02002182,2481,649,279,370,1628,198,760,211,314,235,270,93,153,24,389,234,155,11,11,204,119,85
2021,Wolverhampton 035,E02006894,5104,1329,488,841,3184,200,1551,291,911,349,419,180,204,35,912,578,334,102,102,591,357,234
