date,geography,geography code,Household composition: Total; measures: Value,Household composition: One person household; measures: Value,Household composition: One person household: Aged 66 years and over; measures: Value,Household composition: One person household: Other; measures: Value,Household composition: Single family household; measures: Value,Household composition: Single family household: All aged 66 years and over; measures: Value,Household composition: Single family household: Married or civil partnership couple; measures: Value,Household composition: Single family household: Married or civil partnership couple: No children; measures: Value,Household composition: Single family household: Married or civil partnership couple: Dependent children; measures: Value,Household composition: Single family household: Married or civil partnership couple: All children non-dependent; measures: Value,Household composition: Single family household: Cohabiting couple family; measures: Value,Household composition: Single family household: Cohabiting couple family: No children; measures: Value,Household composition: Single family household: Cohabiting couple family: With dependent children; measures: Value,Household composition: Single family household: Cohabiting couple family: All children non-dependent; measures: Value,Household composition: Single family household: Lone parent family; measures: Value,Household composition: Single family household: Lone parent family: With dependent children; measures: Value,Household composition: Single family household: Lone parent family: All children non-dependent; measures: Value,Household composition: Single family household: Other single family household; measures: Value,Household composition: Single family household: Other single family household: Other family composition; measures: Value,Household composition: Other household types; measures: Value,Household composition: Other household types: With dependent children; measures: Value,"Household composition: Other household types: Other, including all full-time students and all aged 66 years and over; measures: Value"
2021,Bolton 001A,E01004768,613,101,58,43,487,95,290,104,127,59,61,26,30,5,41,27,14,0,0,25,15,10
2021,Bolton 001B,E01004803,713,202,104,98,494,123,232,64,114,54,85,44,38,3,49,28,21,5,5,17,9,8
2021,Bolton 001C,E01004804,608,142,92,50,443,110,243,82,120,41,55,24,28,3,33,20,13,2,2,23,8,15
2021,Bolton 001D,E01004807,580,150,41,109,416,50,240,81,113,46,75,36,35,4,49,31,18,2,2,14,7,7
2021,Bolton 001E,E01004808,690,182,102,80,492,97,263,86,128,49,74,45,25,4,54,33,21,4,4,16,7,9
2021,Bolton 002A,E01004788,606,170,127,43,422,126,220,79,88,53,44,17,20,7,32,16,16,0,0,14,3,11
2021,Bolton 002B,E01004790,644,194,100,94,426,91,171,61,76,34,78,45,32,1,85,54,31,1,1,24,11,13
2021,Bolton 002C,E01004805,664,149,91,58,500,132,250,94,110,46,69,36,28,5,49,25,24,0,0,15,8,7
2021,Bolton 002D,E01004806,658,193,122,71,438,105,213,65,103,45,73,33,36,4,47,31,16,0,0,27,13,14
2021,Bolton 002E,E01004810,634,154,80,74,457,69,280,98,127,55,55,23,29,3,51,31,20,2,2,23,9,14
2021,Bolton 003A,E01004769,685,230,121,109,435,70,226,82,97,47,94,58,32,4,43,22,21,2,2,20,11,9
2021,Bolton 003B,E01004770,611,159,107,52,430,103,224,67,116,41,62,33,26,3,38,17,21,3,3,22,18,4
2021,Bolton 003C,E01004771,628,120,76,44,485,85,287,76,154,57,63,24,36,3,50,31,19,0,0,23,11,12
2021,Bolton 003D,E01004773,856,310,108,202,507,63,245,88,103,54,109,66,36,7,88,61,27,2,2,39,19,20
2021,Bolton 003E,E01004809,870,365,161,204,484,48,203,98,69,36,113,64,40,9,117,62,55,3,3,21,12,9
2021,Bolton 004A,E01004777,789,295,107,188,471,52,192,85,73,34,117,52,56,9,106,64,42,4,4,23,9,14
2021,Bolton 004B,E01004881,781,384,181,203,381,52,123,57,50,16,100,62,33,5,100,65,35,6,6,16,6,10
2021,Bolton 004C,E01004888,571,157,64,93,398,54,197,87,59,51,69,37,26,6,75,41,34,3,3,16,10,6
2021,Bolton 004D,E01004889,633,209,105,104,403,53,171,56,76,39,83,43,34,6,96,62,34,0,0,21,10,11
2021,Bolton 004E,E01004890,681,268,92,176,394,57,164,60,64,40,98,57,35,6,70,37,33,5,5,19,6,13
2021,Bolton 005A,E01004766,805,367,186,181,404,64,177,56,88,33,74,35,35,4,88,56,32,1,1,34,14,20
2021,Bolton 005B,E01004767,850,347,118,229,462,67,224,72,110,42,92,51,35,6,72,42,30,7,7,41,22,19
2021,Bolton 005C,E01004772,749,213,83,130,504,36,199,59,97,43,99,21,72,6,167,123,44,3,3,32,14,18
2021,Bolton 005D,E01004774,739,258,91,167,443,27,209,69,101,39,86,38,40,8,118,73,45,3,3,38,20,18
2021,Bolton 005E,E01004824,495,64,21,43,339,29,242,45,144,53,14,5,7,2,52,33,19,2,2,92,71,21
2021,Bolton 006A,E01004784,508,107,84,23,388,113,196,78,76,42,44,21,19,4,30,17,13,5,5,13,7,6
2021,Bolton 006B,E01004785,651,196,105,91,431,76,190,55,89,46,80,30,40,10,83,48,35,2,2,24,14,10
2021,Bolton 006C,E01004786,686,229,151,78,437,101,200,78,72,50,86,47,34,5,50,21,29,0,0,20,10,10
2021,Bolton 006D,E01004789,607,139,91,48,449,99,253,96,103,54,60,24,31,5,36,16,20,1,1,19,9,10
2021,Bolton 006E,E01004791,652,250,163,87,387,89,153,59,62,32,89,50,35,4,56,28,28,0,0,15,3,12
2021,Bolton 006F,E01004792,640,178,131,47,448,149,221,87,88,46,44,21,18,5,34,16,18,0,0,14,4,10
2021,Bolton 007A,E01004779,621,118,49,69,477,47,227,73,101,53,100,37,52,11,98,64,34,5,5,26,16,10
2021,Bolton 007B,E01004781,952,306,89,217,606,72,306,97,158,51,146,91,48,7,81,60,21,1,1,40,17,23
2021,Bolton 007C,E01004882,626,227,104,123,364,55,167,60,63,44,72,42,24,6,68,34,34,2,2,35,18,17
2021,Bolton 007D,E01004883,795,232,78,154,541,68,250,105,104,41,131,78,44,9,89,65,24,3,3,22,12,10
2021,Bolton 007E,E01004884,697,201,118,83,473,130,252,122,79,51,56,38,14,4,33,14,19,2,2,23,10,13
2021,Bolton 008A,E01004864,680,240,84,156,418,45,195,75,82,38,94,55,34,5,80,42,38,4,4,22,13,9
2021,Bolton 008B,E01004867,594,176,59,117,382,27,199,43,122,34,59,30,25,4,94,69,25,3,3,36,20,16
2021,Bolton 008C,E01004921,716,229,106,123,459,60,206,79,89,38,91,33,54,4,97,61,36,5,5,28,20,8
2021,Bolton 008D,E01004924,622,128,80,48,468,82,275,106,115,54,77,29,42,6,30,15,15,4,4,26,13,13
2021,Bolton 008E,E01004925,643,166,87,79,443,68,230,78,103,49,81,36,40,5,56,28,28,8,8,34,26,8
2021,Bolton 009A,E01004778,543,167,101,66,353,93,154,66,54,34,57,27,23,7,47,24,23,2,2,23,6,17
2021,Bolton 009B,E01004780,978,267,103,164,675,104,321,110,165,46,155,73,64,18,88,59,29,7,7,36,15,21
2021,Bolton 009C,E01004782,583,183,102,81,372,58,154,54,72,28,91,42,45,4,66,42,24,3,3,28,18,10
2021,Bolton 009D,E01004783,660,192,96,96,435,86,215,85,91,39,73,37,28,8,56,32,24,5,5,33,12,21
2021,Bolton 010A,E01004802,756,210,90,120,493,31,185,47,91,47,85,25,54,6,187,136,51,5,5,53,32,21
2021,Bolton 010B,E01004926,520,128,52,76,355,16,140,39,62,39,61,16,35,10,136,93,43,2,2,37,27,10
2021,Bolton 010C,E01004927,1049,439,128,311,561,37,189,54,100,35,135,61,67,7,192,142,50,8,8,49,30,19
2021,Bolton 010D,E01004929,1122,348,116,232,719,40,294,68,174,52,194,88,92,14,186,129,57,5,5,55,24,31
2021,Bolton 011A,E01004820,621,206,57,149,365,10,199,38,133,28,52,18,30,4,100,75,25,4,4,50,30,20
2021,Bolton 011B,E01004825,602,180,52,128,343,20,253,40,178,35,20,7,10,3,47,31,16,3,3,79,67,12
2021,Bolton 011C,E01004826,598,204,70,134,345,13,180,35,119,26,43,17,24,2,105,78,27,4,4,49,35,14
2021,Bolton 011D,E01004865,738,322,106,216,379,38,166,48,85,33,75,36,36,3,97,55,42,3,3,37,20,17
2021,Bolton 011E,E01004866,756,276,107,169,412,23,222,48,148,26,58,23,34,1,107,69,38,2,2,68,31,37
2021,Bolton 012A,E01004840,724,212,107,105,476,93,239,87,103,49,68,36,31,1,70,39,31,6,6,36,16,20
2021,Bolton 012B,E01004841,656,200,59,141,418,19,139,37,74,28,85,22,48,15,169,127,42,6,6,38,20,18
2021,Bolton 012C,E01004842,732,230,150,80,485,108,273,62,150,61,62,28,29,5,41,20,21,1,1,17,11,6
2021,Bolton 012D,E01004919,648,188,97,91,433,88,222,75,110,37,60,29,27,4,60,33,27,3,3,27,15,12
2021,Bolton 012E,E01004920,662,187,85,102,439,72,190,63,104,23,76,29,37,10,97,63,34,4,4,36,20,16
2021,Bolton 013A,E01004787,755,272,83,189,460,25,129,44,55,30,115,38,64,13,186,133,53,5,5,23,10,13
2021,Bolton 013B,E01004793,698,230,81,149,436,41,155,57,63,35,85,24,52,9,150,116,34,5,5,32,14,18
2021,Bolton 013C,E01004794,721,159,68,91,519,46,183,42,111,30,110,24,78,8,166,122,44,14,14,43,28,15
2021,Bolton 013D,E01004795,694,283,107,176,387,61,137,55,52,30,83,26,53,4,99,65,34,7,7,24,16,8
2021,Bolton 013E,E01004797,519,116,54,62,369,28,154,28,70,56,78,21,46,11,104,71,33,5,5,34,19,15
2021,Bolton 014A,E01004775,929,243,97,146,635,91,338,99,190,49,126,73,49,4,70,42,28,10,10,51,26,25
2021,Bolton 014B,E01004885,566,120,75,45,425,94,251,81,121,49,49,27,19,3,31,14,17,0,0,21,10,11
2021,Bolton 014C,E01004886,619,215,79,136,375,52,147,43,62,42,80,42,31,7,89,55,34,7,7,29,15,14
2021,Bolton 014D,E01004887,609,194,90,104,387,70,169,65,56,48,67,29,30,8,76,50,26,5,5,28,15,13
2021,Bolton 015A,E01004868,725,198,47,151,461,24,270,55,154,61,56,22,32,2,89,57,32,22,22,66,41,25
2021,Bolton 015B,E01004869,827,288,104,184,491,42,224,43,153,28,76,32,41,3,131,99,32,18,18,48,28,20
2021,Bolton 015C,E01004870,754,336,70,266,318,40,188,47,106,35,31,19,9,3,51,33,18,8,8,100,49,51
2021,Bolton 015D,E01004871,509,120,34,86,295,14,183,28,126,29,30,16,10,4,61,47,14,7,7,94,70,24
2021,Bolton 015E,E01004922,883,266,99,167,545,42,260,55,154,51,95,47,39,9,137,98,39,11,11,72,39,33
2021,Bolton 016B,E01004822,610,206,79,127,340,15,232,36,154,42,25,9,13,3,65,36,29,3,3,64,42,22
2021,Bolton 016C,E01004823,861,368,111,257,442,25,219,61,130,28,56,28,23,5,136,88,48,6,6,51,29,22
2021,Bolton 016D,E01004848,778,401,123,278,328,10,140,36,87,17,47,24,19,4,122,54,68,9,9,49,31,18
2021,Bolton 016E,E01033217,645,356,94,262,252,11,105,31,62,12,62,43,14,5,60,30,30,14,14,37,11,26
2021,Bolton 016F,E01033220,741,444,76,368,261,14,116,34,70,12,49,40,7,2,68,38,30,14,14,36,15,21
2021,Bolton 017A,E01004818,687,295,61,234,324,20,130,34,71,25,62,36,22,4,108,81,27,4,4,68,41,27
2021,Bolton 017B,E01004819,600,196,92,104,363,50,171,56,69,46,70,43,23,4,70,42,28,2,2,41,20,21
2021,Bolton 017C,E01004928,681,275,85,190,365,33,118,44,50,24,89,52,33,4,117,89,28,8,8,41,14,27
2021,Bolton 017D,E01004930,630,148,77,71,452,84,196,83,73,40,98,33,56,9,73,40,33,1,1,30,16,14
2021,Bolton 017E,E01004931,744,309,176,133,404,59,146,57,59,30,84,40,37,7,112,72,40,3,3,31,15,16
2021,Bolton 017F,E01004932,723,290,73,217,397,35,146,58,60,28,107,62,36,9,102,65,37,7,7,36,16,20
2021,Bolton 018A,E01004834,580,154,62,92,384,22,218,42,147,29,49,21,23,5,88,66,22,7,7,42,26,16
2021,Bolton 018B,E01004838,653,181,51,130,409,30,201,40,127,34,59,22,33,4,114,87,27,5,5,63,49,14
2021,Bolton 018C,E01004843,625,162,81,81,431,73,246,77,121,48,61,33,23,5,50,31,19,1,1,32,17,15
2021,Bolton 018D,E01004845,714,199,83,116,473,72,282,70,150,62,49,22,23,4,67,41,26,3,3,42,25,17
2021,Bolton 018E,E01004923,634,191,58,133,383,29,194,48,100,46,74,43,29,2,79,51,28,7,7,60,39,21
2021,Bolton 019A,E01004796,669,208,83,125,431,59,208,65,84,59,93,42,45,6,67,42,25,4,4,30,16,14
2021,Bolton 019B,E01004798,665,209,94,115,428,46,160,53,55,52,102,32,65,5,111,93,18,9,9,28,14,14
2021,Bolton 019C,E01004799,581,169,108,61,390,116,182,89,55,38,46,18,22,6,42,23,19,4,4,22,17,5
2021,Bolton 019D,E01004800,534,117,63,54,389,75,201,81,75,45,59,18,31,10,52,22,30,2,2,28,14,14
2021,Bolton 019E,E01004801,662,197,52,145,424,22,128,39,53,36,90,23,58,9,178,124,54,6,6,41,28,13
2021,Bolton 019F,E01004917,954,264,103,161,646,80,257,83,127,47,131,60,67,4,177,119,58,1,1,44,23,21
2021,Bolton 020A,E01004835,558,151,89,62,358,91,203,56,96,51,18,10,7,1,41,20,21,5,5,49,34,15
2021,Bolton 020B,E01004836,604,144,94,50,413,95,218,54,121,43,42,29,11,2,52,29,23,6,6,47,32,15
2021,Bolton 020C,E01004837,595,116,84,32,449,100,279,98,114,67,31,10,15,6,36,15,21,3,3,30,17,13
2021,Bolton 020D,E01004844,617,118,73,45,467,131,273,83,136,54,30,17,12,1,32,16,16,1,1,32,23,9
2021,Bolton 020E,E01004897,456,144,61,83,291,62,132,51,52,29,56,31,21,4,40,25,15,1,1,21,10,11
2021,Bolton 021A,E01004827,673,190,66,124,434,22,232,46,157,29,54,22,30,2,115,81,34,11,11,49,32,17
2021,Bolton 021B,E01004849,498,92,31,61,350,24,211,32,137,42,29,5,24,0,75,38,37,11,11,56,42,14
2021,Bolton 021C,E01004850,773,271,54,217,425,29,223,51,145,27,48,20,24,4,95,50,45,30,30,77,54,23
2021,Bolton 021D,E01004851,625,228,99,129,327,28,199,51,108,40,19,10,8,1,69,38,31,12,12,70,39,31
2021,Bolton 021E,E01004853,496,116,46,70,332,12,222,44,135,43,31,16,11,4,63,35,28,4,4,48,33,15
2021,Bolton 022A,E01004811,651,230,97,133,358,22,174,43,108,23,60,37,22,1,94,65,29,8,8,63,51,12
2021,Bolton 022B,E01004812,683,151,30,121,421,16,228,36,164,28,63,34,27,2,97,53,44,17,17,111,83,28
2021,Bolton 022C,E01004813,522,108,43,65,355,31,177,29,113,35,46,23,22,1,93,71,22,8,8,59,44,15
2021,Bolton 022D,E01004815,567,139,62,77,373,29,234,48,156,30,38,18,16,4,69,40,29,3,3,55,42,13
2021,Bolton 022E,E01004817,971,479,116,363,428,61,202,80,81,41,93,64,26,3,59,33,26,13,13,64,20,44
2021,Bolton 023A,E01004828,630,144,48,96,413,18,264,50,182,32,27,11,15,1,97,62,35,7,7,73,39,34
2021,Bolton 023B,E01004829,480,120,29,91,311,12,208,41,119,48,28,12,14,2,56,32,24,7,7,49,34,15
2021,Bolton 023C,E01004832,637,173,68,105,425,36,211,66,116,29,61,21,34,6,110,70,40,7,7,39,27,12
2021,Bolton 023D,E01004854,467,74,24,50,333,19,238,30,150,58,15,1,11,3,57,30,27,4,4,60,39,21
2021,Bolton 023E,E01004878,548,120,57,63,367,34,219,40,134,45,41,15,23,3,69,38,31,4,4,61,44,17
2021,Bolton 024A,E01004911,722,283,102,181,400,64,147,56,61,30,77,30,39,8,112,87,25,0,0,39,14,25
2021,Bolton 024B,E01004912,650,183,115,68,451,132,200,73,83,44,62,33,26,3,54,22,32,3,3,16,11,5
2021,Bolton 024C,E01004913,781,219,81,138,518,38,246,70,132,44,106,34,63,9,122,67,55,6,6,44,17,27
2021,Bolton 024D,E01004914,518,140,105,35,360,116,159,53,60,46,48,16,30,2,36,14,22,1,1,18,9,9
2021,Bolton 024E,E01004915,530,117,85,32,386,95,185,78,60,47,61,23,29,9,41,19,22,4,4,27,14,13
2021,Bolton 024F,E01004916,672,244,125,119,393,64,146,50,56,40,69,24,39,6,110,64,46,4,4,35,12,23
2021,Bolton 024G,E01004918,514,118,79,39,370,83,187,67,71,49,55,22,31,2,43,20,23,2,2,26,7,19
2021,Bolton 025A,E01004846,491,155,56,99,294,19,161,28,113,20,37,16,19,2,74,52,22,3,3,42,28,14
2021,Bolton 025B,E01004847,654,114,34,80,479,16,284,43,208,33,49,12,30,7,126,88,38,4,4,61,46,15
2021,Bolton 025C,E01004852,489,78,31,47,339,19,234,35,150,49,16,6,9,1,65,36,29,5,5,72,42,30
2021,Bolton 025D,E01004877,667,208,113,95,412,23,241,39,177,25,35,8,20,7,111,60,51,2,2,47,37,10
2021,Bolton 025E,E01004879,534,143,55,88,344,19,189,38,126,25,46,17,25,4,86,56,30,4,4,47,30,17
2021,Bolton 026A,E01004830,729,266,107,159,417,46,191,46,114,31,66,28,31,7,104,71,33,10,10,46,31,15
2021,Bolton 026B,E01004831,645,149,62,87,452,49,270,69,147,54,57,23,30,4,74,46,28,2,2,44,28,16
2021,Bolton 026C,E01004833,644,181,83,98,434,82,237,80,94,63,64,28,28,8,48,20,28,3,3,29,18,11
2021,Bolton 026D,E01004839,961,378,162,216,533,38,246,58,150,38,87,34,45,8,153,109,44,9,9,50,34,16
2021,Bolton 027A,E01004814,561,160,41,119,341,33,163,34,97,32,66,34,26,6,75,43,32,4,4,60,37,23
2021,Bolton 027B,E01004855,623,190,52,138,395,37,156,57,72,27,93,48,39,6,104,74,30,5,5,38,26,12
2021,Bolton 027C,E01004856,636,221,74,147,373,28,160,42,96,22,76,35,36,5,105,71,34,4,4,42,20,22
2021,Bolton 027D,E01004857,662,184,50,134,416,26,159,45,88,26,101,39,59,3,126,80,46,4,4,62,41,21
2021,Bolton 028A,E01004891,740,271,143,128,442,109,210,83,75,52,70,35,31,4,50,18,32,3,3,27,17,10
2021,Bolton 028B,E01004893,639,160,123,37,444,95,257,99,100,58,56,23,31,2,35,12,23,1,1,35,17,18
2021,Bolton 028C,E01004894,850,266,131,135,556,74,238,81,112,45,129,59,62,8,108,63,45,7,7,28,15,13
2021,Bolton 028E,E01004901,772,213,98,115,542,101,317,123,109,85,72,32,32,8,48,22,26,4,4,17,5,12
2021,Bolton 028F,E01033218,630,151,34,117,458,41,213,63,119,31,115,55,54,6,88,67,21,1,1,21,8,13
2021,Bolton 028G,E01033219,597,130,65,65,446,94,242,87,111,44,72,41,27,4,37,24,13,1,1,21,7,14
2021,Bolton 029A,E01004816,597,92,58,34,346,24,230,37,155,38,29,5,20,4,59,29,30,4,4,159,142,17
2021,Bolton 029B,E01004872,611,139,48,91,412,30,186,48,105,33,81,26,46,9,110,68,42,5,5,60,31,29
2021,Bolton 029C,E01004873,622,145,62,83,419,19,242,44,156,42,53,11,38,4,100,59,41,5,5,58,37,21
2021,Bolton 029D,E01004875,655,160,98,62,460,70,197,62,89,46,90,34,46,10,98,67,31,5,5,35,23,12
2021,Bolton 029E,E01004880,502,95,46,49,354,54,222,54,126,42,37,15,18,4,40,23,17,1,1,53,31,22
2021,Bolton 030A,E01004892,711,217,142,75,467,126,225,74,99,52,61,34,22,5,52,22,30,3,3,27,14,13
2021,Bolton 030B,E01004896,546,122,100,22,410,128,211,80,79,52,43,16,20,7,27,8,19,1,1,14,8,6
2021,Bolton 030C,E01004899,619,156,78,78,427,53,225,66,117,42,68,32,28,8,78,47,31,3,3,36,13,23
2021,Bolton 030D,E01004900,624,154,42,112,432,38,248,63,140,45,76,37,32,7,68,48,20,2,2,38,22,16
2021,Bolton 031A,E01004776,825,276,91,185,519,52,222,79,92,51,118,65,48,5,121,81,40,6,6,30,11,19
2021,Bolton 031B,E01004895,603,198,124,74,379,52,170,72,58,40,76,30,40,6,78,43,35,3,3,26,14,12
2021,Bolton 031C,E01004936,1012,362,133,229,612,82,277,108,122,47,153,96,53,4,95,56,39,5,5,38,13,25
2021,Bolton 031D,E01004938,628,203,107,96,391,36,156,45,75,36,72,19,43,10,125,79,46,2,2,34,19,15
2021,Bolton 031E,E01004939,708,212,69,143,471,80,204,89,72,43,90,36,45,9,93,66,27,4,4,25,16,9
2021,Bolton 032A,E01004858,712,268,91,177,411,42,153,55,61,37,101,41,53,7,108,57,51,7,7,33,18,15
2021,Bolton 032B,E01004859,698,349,124,225,316,24,106,42,42,22,78,34,40,4,104,67,37,4,4,33,23,10
2021,Bolton 032C,E01004860,683,240,102,138,405,57,143,55,52,36,92,37,44,11,109,68,41,4,4,38,12,26
2021,Bolton 032D,E01004902,880,358,116,242,485,71,170,59,79,32,131,76,51,4,108,74,34,5,5,37,16,21
2021,Bolton 032E,E01004906,888,416,196,220,437,50,160,61,65,34,109,54,46,9,113,66,47,5,5,35,16,19
2021,Bolton 033A,E01004861,664,128,25,103,471,15,182,55,107,20,117,44,61,12,156,116,40,1,1,65,46,19
2021,Bolton 033B,E01004862,588,195,71,124,362,37,116,40,49,27,89,22,50,17,119,86,33,1,1,31,17,14
2021,Bolton 033C,E01004863,642,212,72,140,387,23,143,40,67,36,75,28,41,6,142,93,49,4,4,43,27,16
2021,Bolton 033D,E01004874,660,136,64,72,475,54,200,55,101,44,95,34,52,9,121,77,44,5,5,49,28,21
2021,Bolton 033E,E01004876,785,226,107,119,514,39,227,56,127,44,98,37,53,8,142,94,48,8,8,45,23,22
2021,Bolton 034A,E01004903,580,138,59,79,424,51,231,71,102,58,91,35,47,9,49,30,19,2,2,18,9,9
2021,Bolton 034B,E01004904,738,231,100,131,469,47,229,83,93,53,111,54,52,5,79,52,27,3,3,38,21,17
2021,Bolton 034C,E01004905,673,220,86,134,413,37,152,56,53,43,113,43,60,10,108,72,36,3,3,40,22,18
2021,Bolton 034D,E01004907,546,175,69,106,341,17,113,39,51,23,87,22,56,9,116,81,35,8,8,30,14,16
2021,Bolton 034E,E01004908,559,160,100,60,382,82,163,59,60,44,72,24,41,7,60,35,25,5,5,17,8,9
2021,Bolton 034F,E01004909,641,254,151,103,361,57,150,51,67,32,76,29,39,8,76,47,29,2,2,26,13,13
2021,Bolton 034G,E01004910,928,337,93,244,546,71,220,77,99,44,148,56,86,6,104,68,36,3,3,45,21,24
2021,Bolton 035A,E01004933,575,161,69,92,390,51,195,74,67,54,94,49,40,5,50,30,20,0,0,24,16,8
2021,Bolton 035B,E01004934,552,107,32,75,422,42,237,85,101,51,70,18,44,8,69,46,23,4,4,23,9,14
2021,Bolton 035C,E01004935,749,197,81,116,521,42,286,84,148,54,105,53,46,6,86,51,35,2,2,31,19,12
2021,Bolton 035D,E01004937,623,108,52,56,486,58,299,94,141,64,79,39,33,7,49,24,25,1,1,29,16,13
2021,Bolton 035E,E01004940,606,134,80,54,448,88,223,98,74,51,68,29,33,6,69,40,29,0,0,24,17,7
2021,Bury 001A,E01005014,758,311,137,174,429,101,173,78,76,19,94,64,26,4,60,37,23,1,1,18,8,10
2021,Bury 001B,E01005015,687,240,111,129,412,56,162,67,68,27,99,54,37,8,93,60,33,2,2,35,13,22
2021,Bury 001C,E01005016,711,243,76,167,446,49,217,92,100,25,118,74,37,7,60,40,20,2,2,22,8,14
2021,Bury 001D,E01005017,777,210,115,95,542,78,272,75,148,49,103,52,43,8,86,51,35,3,3,25,14,11
2021,Bury 001E,E01005018,723,253,85,168,450,52,170,54,86,30,104,56,43,5,120,85,35,4,4,20,11,9
2021,Bury 001F,E01005021,420,101,62,39,301,63,169,54,84,31,41,20,18,3,28,12,16,0,0,18,9,9
2021,Bury 002A,E01005019,628,142,87,55,460,104,230,83,102,45,60,32,25,3,66,38,28,0,0,26,10,16
2021,Bury 002B,E01005023,546,157,100,57,381,99,187,55,82,50,48,19,21,8,46,21,25,1,1,8,1,7
2021,Bury 002C,E01005046,679,215,175,40,443,158,211,62,116,33,39,18,17,4,30,12,18,5,5,21,6,15
2021,Bury 002D,E01005048,663,104,72,32,537,166,296,102,137,57,42,15,26,1,30,20,10,3,3,22,10,12
2021,Bury 003A,E01005020,506,62,28,34,432,55,296,103,128,65,48,20,23,5,32,17,15,1,1,12,3,9
2021,Bury 003B,E01005022,633,169,62,107,443,77,245,82,115,48,66,31,30,5,55,35,20,0,0,21,11,10
2021,Bury 003C,E01005047,592,130,89,41,447,103,254,110,99,45,54,28,19,7,32,18,14,4,4,15,5,10
2021,Bury 003D,E01005049,752,242,134,108,487,95,230,84,98,48,88,45,35,8,71,47,24,3,3,23,7,16
2021,Bury 003E,E01005051,695,246,107,139,434,55,238,103,93,42,78,40,32,6,60,33,27,3,3,15,4,11
2021,Bury 004A,E01004976,641,196,83,113,410,52,165,66,71,28,77,35,36,6,109,57,52,7,7,35,20,15
2021,Bury 004B,E01004977,789,311,163,148,452,73,200,78,84,38,100,54,42,4,76,48,28,3,3,26,10,16
2021,Bury 004C,E01004978,661,163,68,95,430,39,233,72,122,39,69,36,30,3,84,55,29,5,5,68,33,35
2021,Bury 004D,E01004981,623,183,87,96,408,73,197,75,81,41,81,41,33,7,56,32,24,1,1,32,12,20
2021,Bury 004E,E01004982,655,181,110,71,452,105,229,89,82,58,66,39,26,1,48,22,26,4,4,22,14,8
2021,Bury 005A,E01004961,629,202,87,115,405,59,171,55,78,38,78,30,45,3,93,60,33,4,4,22,12,10
2021,Bury 005B,E01004965,506,111,77,34,376,101,208,74,93,41,37,12,24,1,29,14,15,1,1,19,8,11
2021,Bury 005C,E01004966,722,187,88,99,493,53,203,55,106,42,82,29,44,9,148,101,47,7,7,42,19,23
2021,Bury 005D,E01004967,465,92,68,24,342,95,181,65,77,39,35,11,23,1,31,12,19,0,0,31,18,13
2021,Bury 006A,E01004963,694,227,118,109,453,92,205,74,80,51,82,45,29,8,71,46,25,3,3,14,5,9
2021,Bury 006B,E01004968,614,150,85,65,445,81,252,86,112,54,72,36,33,3,38,16,22,2,2,19,11,8
2021,Bury 006C,E01005050,853,212,96,116,609,57,313,97,169,47,125,51,64,10,114,74,40,0,0,32,13,19
2021,Bury 006D,E01005052,581,125,74,51,443,104,230,64,103,63,63,19,43,1,46,20,26,0,0,13,9,4
2021,Bury 006E,E01005053,634,159,67,92,450,65,197,73,87,37,90,40,41,9,93,53,40,5,5,25,8,17
2021,Bury 007A,E01004954,646,201,110,91,410,87,187,73,72,42,71,38,22,11,63,32,31,2,2,35,17,18
2021,Bury 007B,E01004955,550,159,55,104,358,34,161,58,68,35,77,28,38,11,76,42,34,10,10,33,14,19
2021,Bury 007C,E01004956,783,301,117,184,434,41,191,56,98,37,73,31,38,4,117,81,36,12,12,48,24,24
2021,Bury 007D,E01004957,792,276,78,198,481,26,188,50,106,32,93,40,41,12,165,113,52,9,9,35,21,14
2021,Bury 007E,E01004960,654,204,46,158,418,13,145,39,86,20,80,20,51,9,172,138,34,8,8,32,17,15
2021,Bury 008A,E01004958,689,270,82,188,382,19,141,47,70,24,89,44,33,12,125,83,42,8,8,37,22,15
2021,Bury 008B,E01004959,728,246,78,168,439,36,195,60,102,33,94,44,37,13,106,71,35,8,8,43,19,24
2021,Bury 008C,E01004979,672,219,44,175,382,24,173,40,95,38,62,29,29,4,113,78,35,10,10,71,47,24
2021,Bury 008D,E01004980,642,258,69,189,343,14,135,47,64,24,78,53,22,3,108,71,37,8,8,41,23,18
2021,Bury 008E,E01005024,995,365,61,304,517,12,268,75,168,25,126,93,33,0,97,52,45,14,14,113,65,48
2021,Bury 008F,E01005026,648,133,32,101,417,20,257,52,181,24,46,23,20,3,86,57,29,8,8,98,74,24
2021,Bury 009A,E01004947,660,229,41,188,396,34,142,44,77,21,91,45,40,6,127,90,37,2,2,35,17,18
2021,Bury 009B,E01004948,837,350,132,218,447,43,210,65,105,40,78,39,35,4,112,75,37,4,4,40,12,28
2021,Bury 009C,E01004962,834,240,78,162,556,46,254,65,147,42,136,73,51,12,117,88,29,3,3,38,18,20
2021,Bury 009D,E01004964,839,315,98,217,492,52,177,63,78,36,140,73,56,11,119,86,33,4,4,32,15,17
2021,Bury 010A,E01004949,582,133,86,47,436,118,241,65,126,50,40,17,18,5,37,17,20,0,0,13,6,7
2021,Bury 010B,E01004950,617,143,102,41,456,136,244,72,111,61,44,21,19,4,32,22,10,0,0,18,10,8
2021,Bury 010C,E01004951,646,158,117,41,459,118,245,97,101,47,54,24,28,2,39,18,21,3,3,29,15,14
2021,Bury 010D,E01004952,616,174,141,33,427,158,206,82,79,45,33,15,15,3,29,10,19,1,1,15,9,6
2021,Bury 010E,E01004953,631,167,116,51,444,87,249,69,127,53,54,30,21,3,53,24,29,1,1,20,8,12
2021,Bury 011A,E01005025,716,228,90,138,445,51,227,83,101,43,97,56,34,7,66,37,29,4,4,43,30,13
2021,Bury 011B,E01005027,687,241,80,161,373,31,191,45,107,39,71,36,30,5,71,35,36,9,9,73,39,34
2021,Bury 011C,E01005028,830,259,91,168,503,29,237,54,142,41,91,44,41,6,141,98,43,5,5,68,50,18
2021,Bury 011D,E01005029,635,159,74,85,396,36,240,45,148,47,42,21,20,1,69,46,23,9,9,80,52,28
2021,Bury 012A,E01005000,588,126,51,75,442,65,264,101,94,69,62,32,23,7,50,25,25,1,1,20,11,9
2021,Bury 012B,E01005001,497,91,31,60,384,58,233,82,96,55,61,22,36,3,29,15,14,3,3,22,10,12
2021,Bury 012C,E01005005,623,181,95,86,421,75,203,80,76,47,82,35,39,8,59,35,24,2,2,21,8,13
2021,Bury 012D,E01005006,810,174,83,91,603,84,288,93,139,56,126,55,63,8,97,55,42,8,8,33,13,20
2021,Bury 013A,E01005030,789,333,117,216,422,31,177,57,90,30,77,40,34,3,129,92,37,8,8,34,24,10
2021,Bury 013B,E01005054,705,233,119,114,447,67,205,72,90,43,87,49,32,6,87,49,38,1,1,25,14,11
2021,Bury 013C,E01005059,723,230,85,145,447,53,234,77,124,33,69,29,33,7,84,54,30,7,7,46,24,22
2021,Bury 013D,E01005060,731,240,112,128,438,77,211,71,106,34,80,40,35,5,69,39,30,1,1,53,26,27
2021,Bury 014A,E01004997,619,174,59,115,408,41,171,64,68,39,81,32,43,6,108,61,47,7,7,37,17,20
2021,Bury 014B,E01004998,738,224,123,101,491,92,211,84,93,34,110,56,49,5,72,51,21,6,6,23,9,14
2021,Bury 014C,E01004999,597,147,78,69,418,55,201,67,72,62,85,38,43,4,72,40,32,5,5,32,15,17
2021,Bury 014D,E01005002,644,172,97,75,443,83,204,84,71,49,79,34,37,8,73,46,27,4,4,29,19,10
2021,Bury 014E,E01005003,680,257,118,139,402,44,144,42,66,36,96,39,54,3,116,85,31,2,2,21,8,13
2021,Bury 015A,E01004991,598,192,74,118,367,40,144,46,66,32,82,38,36,8,100,72,28,1,1,39,17,22
2021,Bury 015B,E01004992,634,214,83,131,396,37,152,51,70,31,101,44,49,8,103,80,23,3,3,24,12,12
2021,Bury 015C,E01004993,783,202,83,119,552,34,280,79,143,58,132,51,69,12,102,62,40,4,4,29,13,16
2021,Bury 015D,E01004994,678,274,77,197,389,35,133,57,53,23,100,50,44,6,118,94,24,3,3,15,7,8
2021,Bury 016A,E01004990,667,215,101,114,422,50,156,50,69,37,108,43,57,8,104,68,36,4,4,30,16,14
2021,Bury 016B,E01004996,753,363,91,272,365,36,114,38,59,17,81,47,31,3,123,87,36,11,11,25,13,12
2021,Bury 016C,E01005004,858,462,146,316,368,45,124,58,43,23,76,26,44,6,113,84,29,10,10,28,11,17
2021,Bury 016D,E01005008,949,357,101,256,540,22,204,71,100,33,124,53,59,12,181,139,42,9,9,52,21,31
2021,Bury 016E,E01005009,859,379,60,319,437,36,134,47,66,21,101,53,40,8,153,112,41,13,13,43,12,31
2021,Bury 017A,E01004945,645,195,128,67,414,86,214,63,96,55,59,30,26,3,54,23,31,1,1,36,20,16
2021,Bury 017B,E01005055,589,138,84,54,415,78,236,67,112,57,49,28,21,0,51,25,26,1,1,36,16,20
2021,Bury 017C,E01005056,602,216,121,95,364,97,162,50,69,43,54,33,17,4,47,25,22,4,4,22,14,8
2021,Bury 017D,E01005057,667,160,71,89,482,62,238,81,105,52,71,39,28,4,105,64,41,6,6,25,15,10
2021,Bury 017E,E01005058,494,92,60,32,380,75,225,61,112,52,43,14,26,3,36,15,21,1,1,22,14,8
2021,Bury 018A,E01004995,648,180,111,69,435,125,204,82,73,49,66,26,34,6,34,17,17,6,6,33,17,16
2021,Bury 018B,E01005010,652,158,64,94,460,61,219,74,90,55,105,49,41,15,74,42,32,1,1,34,18,16
2021,Bury 018C,E01005012,778,267,69,198,474,43,179,60,89,30,100,45,48,7,144,97,47,8,8,37,18,19
2021,Bury 018D,E01005013,1017,257,69,188,709,31,276,77,158,41,185,82,83,20,211,163,48,6,6,51,24,27
2021,Bury 019A,E01004984,573,163,109,54,384,85,228,67,123,38,32,22,8,2,38,18,20,1,1,26,10,16
2021,Bury 019B,E01004985,592,136,82,54,433,132,249,72,127,50,14,6,8,0,38,18,20,0,0,23,10,13
2021,Bury 019C,E01004989,568,147,76,71,398,83,221,66,113,42,57,28,25,4,34,20,14,3,3,23,7,16
2021,Bury 019D,E01005007,700,244,131,113,432,88,195,92,66,37,98,55,35,8,48,27,21,3,3,24,8,16
2021,Bury 019E,E01005011,598,150,73,77,427,61,210,60,110,40,103,67,32,4,50,25,25,3,3,21,9,12
2021,Bury 020A,E01004983,569,167,58,109,373,27,201,66,97,38,80,51,21,8,54,35,19,11,11,29,13,16
2021,Bury 020B,E01004986,819,321,125,196,459,66,181,66,85,30,114,79,32,3,95,61,34,3,3,39,13,26
2021,Bury 020C,E01004987,660,348,147,201,278,27,119,39,61,19,46,16,26,4,81,50,31,5,5,34,12,22
2021,Bury 020D,E01004988,629,206,90,116,393,45,180,64,82,34,88,57,27,4,73,40,33,7,7,30,14,16
2021,Bury 021A,E01004941,757,233,114,119,483,37,213,56,105,52,108,45,58,5,123,90,33,2,2,41,21,20
2021,Bury 021B,E01004942,636,188,77,111,404,12,139,33,85,21,74,28,37,9,179,136,43,0,0,44,25,19
2021,Bury 021C,E01004943,709,157,47,110,509,42,235,67,131,37,115,60,48,7,111,80,31,6,6,43,23,20
2021,Bury 021D,E01004944,629,145,73,72,448,62,241,87,107,47,78,50,24,4,63,33,30,4,4,36,18,18
2021,Bury 021E,E01004946,778,304,119,185,435,22,110,38,46,26,87,27,53,7,207,130,77,9,9,39,17,22
2021,Bury 022A,E01004969,707,296,113,183,371,45,196,75,80,41,68,41,24,3,55,30,25,7,7,40,19,21
2021,Bury 022B,E01004970,607,117,63,54,452,76,235,62,121,52,84,33,45,6,53,29,24,4,4,38,20,18
2021,Bury 022C,E01004971,604,153,89,64,424,81,225,56,122,47,71,35,29,7,42,18,24,5,5,27,12,15
2021,Bury 022D,E01005034,714,227,103,124,446,45,221,71,117,33,121,78,42,1,54,32,22,5,5,41,16,25
2021,Bury 023A,E01004972,570,146,61,85,377,26,145,34,82,29,79,37,31,11,125,73,52,2,2,47,22,25
2021,Bury 023B,E01004973,652,179,79,100,449,42,232,80,114,38,110,66,35,9,60,30,30,5,5,24,10,14
2021,Bury 023C,E01004975,769,321,120,201,411,23,146,57,67,22,149,109,36,4,86,59,27,7,7,37,12,25
2021,Bury 023D,E01005039,686,253,113,140,403,47,143,48,69,26,101,59,34,8,108,67,41,4,4,30,15,15
2021,Bury 023E,E01005045,725,246,134,112,440,43,221,77,103,41,106,70,31,5,62,28,34,8,8,39,16,23
2021,Bury 024A,E01004974,601,164,78,86,399,64,209,73,103,33,68,44,21,3,57,29,28,1,1,38,14,24
2021,Bury 024B,E01005033,593,170,69,101,394,60,261,67,163,31,38,21,15,2,34,15,19,1,1,29,14,15
2021,Bury 024C,E01005036,1067,542,190,352,475,55,222,92,99,31,110,80,26,4,84,37,47,4,4,50,13,37
2021,Bury 024D,E01005037,630,188,89,99,400,56,216,76,101,39,80,46,30,4,46,29,17,2,2,42,20,22
2021,Bury 025A,E01005031,637,195,67,128,409,34,181,56,88,37,88,30,45,13,106,68,38,0,0,33,22,11
2021,Bury 025B,E01005032,558,230,78,152,298,24,118,27,76,15,61,33,26,2,90,60,30,5,5,30,11,19
2021,Bury 025C,E01005035,656,205,72,133,417,39,201,66,108,27,118,75,35,8,57,32,25,2,2,34,10,24
2021,Bury 025D,E01005038,527,110,64,46,392,63,218,62,112,44,61,29,25,7,48,24,24,2,2,25,11,14
2021,Bury 026A,E01005040,691,186,64,122,448,50,274,67,157,50,66,40,18,8,57,32,25,1,1,57,31,26
2021,Bury 026B,E01005041,523,60,34,26,410,53,274,55,166,53,25,6,15,4,54,32,22,4,4,53,28,25
2021,Bury 026C,E01005042,611,132,72,60,436,56,292,60,190,42,31,19,9,3,56,28,28,1,1,43,22,21
2021,Bury 026D,E01005043,490,75,38,37,381,48,284,31,219,34,16,8,6,2,29,15,14,4,4,34,26,8
2021,Bury 026E,E01005044,473,106,38,68,322,23,238,18,203,17,18,11,5,2,37,19,18,6,6,45,27,18
2021,Manchester 001A,E01005098,765,329,108,221,399,40,109,41,52,16,87,34,38,15,151,86,65,12,12,37,18,19
2021,Manchester 001B,E01005099,692,182,72,110,458,17,172,39,107,26,63,13,45,5,202,146,56,4,4,52,28,24
2021,Manchester 001C,E01005100,656,181,85,96,435,46,175,61,73,41,80,26,43,11,128,85,43,6,6,40,22,18
2021,Manchester 001D,E01005102,623,202,68,134,379,45,142,48,55,39,74,28,42,4,116,73,43,2,2,42,13,29
2021,Manchester 001E,E01005103,862,383,188,195,435,37,145,42,69,34,68,22,37,9,179,116,63,6,6,44,26,18
2021,Manchester 002A,E01005101,724,212,87,125,452,36,155,39,80,36,90,30,41,19,163,105,58,8,8,60,34,26
2021,Manchester 002B,E01005135,658,166,66,100,428,20,173,45,82,46,73,13,49,11,151,99,52,11,11,64,44,20
2021,Manchester 002C,E01005136,613,198,68,130,362,39,176,59,70,47,67,30,29,8,75,46,29,5,5,53,23,30
2021,Manchester 002D,E01005138,994,320,84,236,610,19,244,69,143,32,130,57,66,7,206,157,49,11,11,64,45,19
2021,Manchester 002F,E01034107,595,200,39,161,344,16,139,47,78,14,81,42,34,5,96,73,23,12,12,51,23,28
2021,Manchester 002G,E01034108,789,204,51,153,519,32,260,70,156,34,90,45,38,7,132,100,32,5,5,66,37,29
2021,Manchester 003B,E01005139,769,188,86,102,525,37,221,61,107,53,105,42,52,11,153,99,54,9,9,56,32,24
2021,Manchester 003C,E01005141,793,320,110,210,429,21,168,31,104,33,74,17,48,9,162,115,47,4,4,44,28,16
2021,Manchester 003D,E01005251,645,159,53,106,444,23,151,45,73,33,87,25,51,11,172,113,59,11,11,42,19,23
2021,Manchester 003E,E01005252,764,236,107,129,462,44,181,47,90,44,74,28,38,8,151,81,70,12,12,66,36,30
2021,Manchester 003F,E01033685,630,199,63,136,382,23,190,59,106,25,63,29,31,3,100,66,34,6,6,49,26,23
2021,Manchester 003G,E01033687,763,458,182,276,279,45,108,50,37,21,44,19,21,4,75,46,29,7,7,26,10,16
2021,Manchester 004A,E01005104,821,289,53,236,467,30,174,41,111,22,89,49,35,5,150,106,44,24,24,65,38,27
2021,Manchester 004B,E01005160,705,226,76,150,395,33,215,44,128,43,44,23,17,4,99,55,44,4,4,84,57,27
2021,Manchester 004C,E01005161,660,150,53,97,458,57,230,60,140,30,58,22,32,4,108,77,31,5,5,52,38,14
2021,Manchester 004D,E01005162,655,225,103,122,373,30,256,50,153,53,26,13,10,3,56,25,31,5,5,57,34,23
2021,Manchester 004E,E01005163,652,234,90,144,358,43,215,44,133,38,40,19,21,0,57,39,18,3,3,60,43,17
2021,Manchester 005A,E01005247,621,199,91,108,382,57,156,47,65,44,62,36,21,5,102,53,49,5,5,40,19,21
2021,Manchester 005B,E01005248,586,172,86,86,376,77,171,62,56,53,60,28,28,4,62,27,35,6,6,38,19,19
2021,Manchester 005C,E01005249,905,283,111,172,554,36,257,89,126,42,114,51,54,9,130,94,36,17,17,68,27,41
2021,Manchester 005D,E01005250,761,194,84,110,518,35,197,38,110,49,84,21,52,11,193,149,44,9,9,49,29,20
2021,Manchester 005E,E01005253,624,141,67,74,422,27,139,39,69,31,75,29,36,10,169,107,62,12,12,61,25,36
2021,Manchester 005F,E01005254,705,219,76,143,449,44,194,63,80,51,103,41,53,9,104,63,41,4,4,37,11,26
2021,Manchester 006A,E01005164,785,255,48,207,446,9,259,46,188,25,49,24,21,4,115,75,40,14,14,84,54,30
2021,Manchester 006B,E01005205,877,328,121,207,477,18,147,38,97,12,88,39,38,11,214,157,57,10,10,72,42,30
2021,Manchester 006C,E01005206,725,235,69,166,423,31,188,64,90,34,59,28,26,5,130,103,27,15,15,67,43,24
2021,Manchester 006D,E01005207,780,229,65,164,486,27,183,45,107,31,73,24,44,5,182,147,35,21,21,65,31,34
2021,Manchester 007A,E01005223,606,171,39,132,374,28,168,37,91,40,57,25,27,5,109,76,33,12,12,61,36,25
2021,Manchester 007B,E01005224,758,183,50,133,487,11,194,42,116,36,64,24,32,8,202,166,36,16,16,88,47,41
2021,Manchester 007C,E01005225,856,270,107,163,521,40,176,53,80,43,70,33,32,5,224,166,58,11,11,65,39,26
2021,Manchester 007D,E01005226,697,194,56,138,440,14,172,32,106,34,67,20,43,4,179,145,34,8,8,63,39,24
2021,Manchester 007E,E01005229,606,157,75,82,411,60,194,73,64,57,78,23,47,8,71,45,26,8,8,38,23,15
2021,Manchester 008A,E01005145,777,137,34,103,514,15,366,41,280,45,27,15,12,0,90,53,37,16,16,126,88,38
2021,Manchester 008C,E01005149,504,64,29,35,328,14,237,11,187,39,12,5,7,0,59,24,35,6,6,112,92,20
2021,Manchester 008D,E01005165,885,406,147,259,402,12,244,59,158,27,53,33,17,3,73,43,30,20,20,77,45,32
2021,Manchester 008E,E01005166,706,258,82,176,362,14,224,33,157,34,30,17,12,1,80,38,42,14,14,86,56,30
2021,Manchester 008F,E01005167,632,115,28,87,411,6,261,38,187,36,38,19,18,1,97,50,47,9,9,106,81,25
2021,Manchester 008G,E01034109,426,104,43,61,244,16,154,19,111,24,19,7,11,1,45,25,20,10,10,78,61,17
2021,Manchester 008H,E01034110,483,113,25,88,308,6,163,25,115,23,49,21,26,2,81,61,20,9,9,62,39,23
2021,Manchester 009A,E01005202,857,268,84,184,492,20,153,34,97,22,66,27,32,7,242,165,77,11,11,97,71,26
2021,Manchester 009B,E01005203,861,343,68,275,450,21,144,31,90,23,71,23,39,9,200,136,64,14,14,68,32,36
2021,Manchester 009D,E01005227,741,213,56,157,459,19,184,38,121,25,63,14,42,7,185,135,50,8,8,69,38,31
2021,Manchester 009E,E01005228,892,288,106,182,549,15,185,42,120,23,86,32,44,10,247,179,68,16,16,55,33,22
2021,Manchester 009F,E01033678,652,232,44,188,368,15,156,30,107,19,50,12,32,6,134,95,39,13,13,52,29,23
2021,Manchester 009G,E01033679,578,235,67,168,297,12,115,31,60,24,40,13,22,5,120,72,48,10,10,46,34,12
2021,Manchester 011A,E01005256,1049,364,104,260,601,27,219,64,117,38,108,40,54,14,218,150,68,29,29,84,41,43
2021,Manchester 011B,E01005257,805,275,77,198,478,20,150,52,70,28,100,35,57,8,199,152,47,9,9,52,24,28
2021,Manchester 011C,E01005258,779,322,109,213,419,24,140,47,63,30,79,34,32,13,168,126,42,8,8,38,18,20
2021,Manchester 011D,E01005259,755,302,95,207,397,20,113,36,55,22,62,18,42,2,195,146,49,7,7,56,34,22
2021,Manchester 011E,E01005260,593,194,73,121,362,47,161,55,65,41,67,23,36,8,80,55,25,7,7,37,19,18
2021,Manchester 012A,E01005093,679,216,91,125,422,27,154,34,90,30,72,21,49,2,157,104,53,12,12,41,20,21
2021,Manchester 012B,E01005094,664,221,65,156,390,22,134,31,79,24,44,12,26,6,176,125,51,14,14,53,32,21
2021,Manchester 012C,E01005097,650,129,42,87,463,23,151,19,106,26,67,22,37,8,213,142,71,9,9,58,30,28
2021,Manchester 012D,E01005255,778,383,116,267,343,25,108,33,60,15,61,29,22,10,140,95,45,9,9,52,29,23
2021,Manchester 012E,E01005261,674,204,62,142,414,14,140,27,84,29,76,34,34,8,178,122,56,6,6,56,36,20
2021,Manchester 015A,E01005092,781,253,82,171,479,20,157,29,113,15,89,50,37,2,200,146,54,13,13,49,27,22
2021,Manchester 015C,E01005105,1130,305,52,253,686,19,361,95,235,31,113,62,45,6,169,121,48,24,24,139,46,93
2021,Manchester 015D,E01005106,902,264,68,196,517,29,183,35,115,33,96,42,48,6,186,136,50,23,23,121,59,62
2021,Manchester 015E,E01005107,744,240,69,171,429,16,162,39,95,28,66,23,40,3,179,130,49,6,6,75,37,38
2021,Manchester 015F,E01033668,597,259,21,238,274,9,102,43,52,7,97,83,11,3,55,34,21,11,11,64,10,54
2021,Manchester 015G,E01033669,649,270,77,193,323,26,94,33,40,21,65,33,25,7,125,82,43,13,13,56,29,27
2021,Manchester 017D,E01005189,802,357,134,223,397,26,134,44,76,14,56,27,25,4,167,108,59,14,14,48,24,24
2021,Manchester 017E,E01005190,938,287,91,196,577,25,232,53,138,41,96,31,52,13,202,165,37,22,22,74,36,38
2021,Manchester 017G,E01034111,559,140,44,96,381,23,137,23,98,16,63,19,38,6,146,95,51,12,12,38,23,15
2021,Manchester 017H,E01034112,734,233,66,167,432,21,171,50,90,31,71,31,39,1,142,107,35,27,27,69,35,34
2021,Manchester 017I,E01034113,565,158,49,109,347,12,123,29,71,23,60,23,34,3,135,100,35,17,17,60,23,37
2021,Manchester 017J,E01034114,728,231,69,162,415,16,196,59,106,31,88,49,31,8,106,71,35,9,9,82,42,40
2021,Manchester 018A,E01005061,656,210,54,156,387,10,158,22,115,21,49,25,20,4,157,101,56,13,13,59,26,33
2021,Manchester 018C,E01005063,762,246,52,194,441,10,235,30,180,25,48,22,20,6,136,75,61,12,12,75,29,46
2021,Manchester 018D,E01005065,798,258,48,210,445,8,189,45,123,21,54,31,17,6,172,109,63,22,22,95,34,61
2021,Manchester 018E,E01005066,509,260,24,236,186,3,75,19,46,10,45,28,14,3,44,28,16,19,19,63,13,50
2021,Manchester 018F,E01034115,421,130,32,98,207,8,98,20,63,15,22,9,10,3,58,35,23,21,21,84,13,71
2021,Manchester 018G,E01034116,416,108,34,74,189,6,103,16,77,10,34,26,7,1,37,23,14,9,9,119,18,101
2021,Manchester 019A,E01005208,1100,379,49,330,505,2,194,62,117,15,149,115,31,3,131,84,47,29,29,216,19,197
2021,Manchester 019C,E01005210,447,221,39,182,178,3,65,15,42,8,24,17,6,1,69,42,27,17,17,48,12,36
2021,Manchester 019D,E01005214,986,296,23,273,426,5,179,61,109,9,104,90,12,2,105,62,43,33,33,264,37,227
2021,Manchester 019E,E01034117,473,188,15,173,175,1,86,37,47,2,39,35,4,0,21,13,8,28,28,110,7,103
2021,Manchester 019F,E01034118,457,228,44,184,183,3,64,15,41,8,19,8,7,4,75,45,30,22,22,46,20,26
2021,Manchester 020A,E01005067,807,287,55,232,448,10,217,44,147,26,62,34,25,3,142,101,41,17,17,72,40,32
2021,Manchester 020B,E01005186,1051,308,77,231,654,22,308,71,174,63,120,45,64,11,188,126,62,16,16,89,47,42
2021,Manchester 020C,E01005232,707,247,76,171,394,18,230,35,170,25,36,23,13,0,85,49,36,25,25,66,41,25
2021,Manchester 020D,E01005235,716,211,65,146,437,14,231,45,163,23,37,12,20,5,141,89,52,14,14,68,47,21
2021,Manchester 020E,E01005239,630,213,52,161,354,6,153,17,115,21,30,9,13,8,154,93,61,11,11,63,33,30
2021,Manchester 021A,E01005187,835,214,54,160,552,23,178,31,111,36,98,32,60,6,233,195,38,20,20,69,28,41
2021,Manchester 021B,E01005188,727,184,68,116,487,44,213,57,105,51,90,25,56,9,128,84,44,12,12,56,23,33
2021,Manchester 021C,E01005191,796,280,93,187,473,23,159,35,101,23,71,29,35,7,209,166,43,11,11,43,18,25
2021,Manchester 021D,E01005192,681,221,57,164,394,31,191,62,83,46,72,31,31,10,87,62,25,13,13,66,37,29
2021,Manchester 021E,E01005193,803,310,84,226,447,31,156,50,80,26,102,52,42,8,140,109,31,18,18,46,17,29
2021,Manchester 022B,E01005230,766,296,41,255,290,10,148,37,94,17,45,36,5,4,66,38,28,21,21,180,50,130
2021,Manchester 022C,E01005231,695,268,30,238,191,7,84,28,47,9,60,53,6,1,22,11,11,18,18,236,15,221
2021,Manchester 022D,E01005236,696,197,41,156,319,6,208,23,162,23,28,13,13,2,62,39,23,15,15,180,57,123
2021,Manchester 022E,E01005237,526,110,20,90,290,6,206,28,136,42,13,4,9,0,50,24,26,15,15,126,87,39
2021,Manchester 022H,E01034119,766,270,39,231,327,6,166,31,112,23,44,32,10,2,87,46,41,24,24,169,27,142
2021,Manchester 023A,E01005195,879,239,81,158,575,22,233,44,158,31,94,27,56,11,215,150,65,11,11,65,44,21
2021,Manchester 023C,E01005197,700,282,98,184,346,18,130,32,74,24,67,31,27,9,116,80,36,15,15,72,33,39
2021,Manchester 023D,E01005198,710,226,76,150,415,19,210,30,145,35,58,17,32,9,120,72,48,8,8,69,46,23
2021,Manchester 023E,E01005201,786,211,58,153,485,9,177,33,133,11,63,24,34,5,215,174,41,21,21,90,38,52
2021,Manchester 023F,E01034120,596,175,61,114,366,17,145,14,113,18,52,12,31,9,142,105,37,10,10,55,36,19
2021,Manchester 023G,E01034121,449,83,13,70,321,3,164,25,126,13,55,18,34,3,86,65,21,13,13,45,33,12
2021,Manchester 024B,E01005243,1146,417,108,309,579,9,231,47,163,21,80,56,22,2,236,118,118,23,23,150,66,84
2021,Manchester 024C,E01005245,962,305,127,178,543,15,208,27,160,21,50,25,22,3,238,150,88,32,32,114,58,56
2021,Manchester 024D,E01005246,754,199,57,142,452,4,198,23,161,14,23,10,10,3,189,136,53,38,38,103,62,41
2021,Manchester 024E,E01034122,628,156,22,134,362,4,169,22,129,18,46,33,12,1,123,94,29,20,20,110,34,76
2021,Manchester 024F,E01034123,634,240,69,171,323,10,136,20,105,11,54,26,26,2,109,78,31,14,14,71,34,37
2021,Manchester 025C,E01005244,812,226,58,168,311,11,128,22,89,17,40,29,11,0,106,75,31,26,26,275,26,249
2021,Manchester 025D,E01005285,511,176,42,134,237,5,125,14,98,13,14,6,6,2,64,38,26,29,29,98,30,68
2021,Manchester 025E,E01005288,676,205,33,172,255,4,117,24,83,10,34,23,8,3,77,50,27,23,23,216,19,197
2021,Manchester 025F,E01034124,557,153,37,116,318,5,131,26,96,9,18,7,11,0,155,116,39,9,9,86,29,57
2021,Manchester 025G,E01034125,550,126,20,106,320,3,159,22,129,8,39,26,11,2,111,89,22,8,8,104,21,83
2021,Manchester 025H,E01034126,608,142,23,119,390,7,188,27,150,11,76,44,30,2,102,74,28,17,17,76,21,55
2021,Manchester 025I,E01034127,583,194,38,156,292,13,106,15,82,9,81,59,20,2,74,53,21,18,18,97,15,82
2021,Manchester 026A,E01005280,535,89,44,45,311,15,198,18,134,46,15,5,10,0,74,40,34,9,9,135,96,39
2021,Manchester 026B,E01005281,532,284,68,216,164,7,67,39,22,6,64,62,2,0,16,8,8,10,10,84,4,80
2021,Manchester 026C,E01005284,657,269,30,239,227,3,111,48,52,11,51,44,7,0,43,19,24,19,19,161,14,147
2021,Manchester 026D,E01005286,763,233,30,203,259,17,142,41,81,20,56,48,8,0,32,15,17,12,12,271,16,255
2021,Manchester 026E,E01005287,655,164,48,116,346,14,217,30,149,38,19,9,10,0,84,44,40,12,12,145,98,47
2021,Manchester 028A,E01005297,949,344,46,298,463,20,217,53,130,34,126,96,27,3,85,44,41,15,15,142,46,96
2021,Manchester 028B,E01005298,627,158,37,121,372,18,200,46,131,23,89,52,35,2,59,35,24,6,6,97,42,55
2021,Manchester 028C,E01005302,1000,456,66,390,435,12,182,54,109,19,132,104,28,0,95,72,23,14,14,109,22,87
2021,Manchester 028E,E01033680,672,346,40,306,251,3,112,46,61,5,83,65,17,1,40,24,16,13,13,75,12,63
2021,Manchester 028F,E01033686,649,332,61,271,255,14,113,33,67,13,71,39,26,6,51,34,17,6,6,62,17,45
2021,Manchester 029A,E01005150,843,390,71,319,323,8,101,34,62,5,173,148,21,4,28,16,12,13,13,130,6,124
2021,Manchester 029B,E01005151,700,340,94,246,312,23,146,52,78,16,101,78,22,1,38,22,16,4,4,48,13,35
2021,Manchester 029C,E01005152,585,149,58,91,400,22,228,62,141,25,111,64,44,3,34,15,19,5,5,36,3,33
2021,Manchester 029D,E01005159,682,198,71,127,382,36,178,60,99,19,109,77,26,6,48,29,19,11,11,102,11,91
2021,Manchester 029E,E01005296,626,197,74,123,343,38,176,56,88,32,84,62,19,3,39,23,16,6,6,86,34,52
2021,Manchester 029F,E01005299,545,124,53,71,326,17,178,43,96,39,66,47,18,1,58,27,31,7,7,95,44,51
2021,Manchester 030A,E01005178,741,193,68,125,422,13,190,39,122,29,72,49,17,6,137,75,62,10,10,126,38,88
2021,Manchester 030B,E01005179,920,402,52,350,412,23,211,64,115,32,95,68,23,4,74,49,25,9,9,106,44,62
2021,Manchester 030C,E01005180,763,264,89,175,419,18,194,33,126,35,47,27,14,6,147,89,58,13,13,80,37,43
2021,Manchester 030D,E01005181,687,199,38,161,367,28,213,38,143,32,49,35,11,3,71,47,24,6,6,121,67,54
2021,Manchester 030E,E01005182,470,98,43,55,303,13,146,20,89,37,26,9,16,1,112,59,53,6,6,69,40,29
2021,Manchester 030F,E01005183,647,190,67,123,387,20,173,27,97,49,43,18,15,10,137,67,70,14,14,70,38,32
2021,Manchester 031A,E01005219,924,363,79,284,423,6,208,58,121,29,126,85,38,3,70,44,26,13,13,138,39,99
2021,Manchester 031B,E01005220,743,205,47,158,456,14,241,53,167,21,112,75,35,2,83,48,35,6,6,82,39,43
2021,Manchester 031C,E01005221,871,229,47,182,497,10,264,58,176,30,112,73,33,6,92,58,34,19,19,145,61,84
2021,Manchester 031D,E01005222,912,349,85,264,492,15,203,39,139,25,135,93,38,4,122,73,49,17,17,71,27,44
2021,Manchester 032A,E01005184,778,209,31,178,296,10,157,39,103,15,61,40,19,2,48,20,28,20,20,273,27,246
2021,Manchester 032B,E01005185,515,112,11,101,89,0,24,11,11,2,21,14,5,2,22,12,10,22,22,314,7,307
2021,Manchester 032C,E01005271,619,207,35,172,158,14,61,30,27,4,48,40,8,0,22,12,10,13,13,254,7,247
2021,Manchester 032F,E01034128,891,137,44,93,379,11,217,47,128,42,58,37,12,9,74,40,34,19,19,375,56,319
2021,Manchester 033A,E01005154,656,229,47,182,333,12,153,58,78,17,128,101,23,4,33,20,13,7,7,94,15,79
2021,Manchester 033B,E01005156,627,163,52,111,388,21,173,49,102,22,143,95,45,3,46,22,24,5,5,76,13,63
2021,Manchester 033C,E01005158,697,283,107,176,347,35,146,46,83,17,104,68,32,4,55,33,22,7,7,67,22,45
2021,Manchester 033D,E01005300,485,83,45,38,319,24,195,31,104,60,41,18,21,2,55,27,28,4,4,83,45,38
2021,Manchester 033E,E01005301,590,199,45,154,314,35,164,35,92,37,79,55,21,3,30,14,16,6,6,77,25,52
2021,Manchester 034A,E01005118,477,98,59,39,328,45,199,40,95,64,31,18,12,1,50,26,24,3,3,51,35,16
2021,Manchester 034B,E01005120,668,163,65,98,431,31,223,43,134,46,76,45,24,7,95,58,37,6,6,74,38,36
2021,Manchester 034C,E01005215,731,182,55,127,479,31,245,48,161,36,89,41,40,8,102,53,49,12,12,70,37,33
2021,Manchester 034D,E01005216,610,155,50,105,388,28,190,67,93,30,96,62,34,0,68,39,29,6,6,67,23,44
2021,Manchester 034E,E01005217,700,176,108,68,446,52,257,45,168,44,72,41,23,8,60,33,27,5,5,78,40,38
2021,Manchester 034F,E01005218,629,215,110,105,280,21,158,35,95,28,45,33,11,1,52,26,26,4,4,134,33,101
2021,Manchester 035A,E01005270,685,192,60,132,417,21,159,39,83,37,75,48,21,6,149,95,54,13,13,76,27,49
2021,Manchester 035B,E01005272,809,283,113,170,474,18,147,37,86,24,85,37,34,14,202,107,95,22,22,52,25,27
2021,Manchester 035C,E01005273,593,181,35,146,188,5,57,21,28,8,59,47,11,1,60,33,27,7,7,224,7,217
2021,Manchester 035D,E01005278,537,85,39,46,269,10,152,24,86,42,34,19,12,3,65,27,38,8,8,183,30,153
2021,Manchester 035E,E01005279,816,214,60,154,508,24,224,45,131,48,70,43,23,4,168,105,63,22,22,94,39,55
2021,Manchester 036A,E01005305,586,108,48,60,355,37,189,47,105,37,79,55,22,2,45,21,24,5,5,123,22,101
2021,Manchester 036B,E01005309,950,389,92,297,255,16,70,25,37,8,107,101,6,0,27,15,12,35,35,306,9,297
2021,Manchester 036C,E01005310,585,99,36,63,214,9,67,19,39,9,38,19,14,5,84,59,25,16,16,272,20,252
2021,Manchester 036D,E01005311,659,179,46,133,309,21,129,29,81,19,95,71,22,2,50,23,27,14,14,171,18,153
2021,Manchester 036E,E01005312,646,240,71,169,129,11,32,12,16,4,43,40,2,1,21,9,12,22,22,277,4,273
2021,Manchester 037A,E01005082,751,245,99,146,446,20,172,53,95,24,117,79,34,4,128,59,69,9,9,60,32,28
2021,Manchester 037B,E01005153,782,309,100,209,418,17,177,85,75,17,159,133,22,4,63,39,24,2,2,55,6,49
2021,Manchester 037C,E01005155,667,223,78,145,397,22,199,79,103,17,145,106,38,1,27,20,7,4,4,47,5,42
2021,Manchester 037D,E01005157,597,130,65,65,430,46,258,80,130,48,87,42,42,3,39,25,14,0,0,37,17,20
2021,Manchester 038A,E01005274,695,199,62,137,362,28,138,35,82,21,85,70,11,4,100,50,50,11,11,134,22,112
2021,Manchester 038B,E01005275,801,338,37,301,305,16,113,43,60,10,148,131,17,0,20,15,5,8,8,158,7,151
2021,Manchester 038C,E01005276,616,214,35,179,268,14,114,39,65,10,108,97,8,3,25,16,9,7,7,134,7,127
2021,Manchester 038D,E01005277,782,279,45,234,408,35,216,78,120,18,124,107,14,3,27,18,9,6,6,95,13,82
2021,Manchester 039A,E01005076,740,349,45,304,306,12,82,30,45,7,180,162,16,2,22,14,8,10,10,85,2,83
2021,Manchester 039C,E01005081,775,301,75,226,420,9,154,37,88,29,78,41,34,3,170,102,68,9,9,54,27,27
2021,Manchester 039D,E01005083,955,445,49,396,398,13,164,74,86,4,189,170,18,1,23,15,8,9,9,112,8,104
2021,Manchester 039E,E01033670,784,318,18,300,387,2,124,49,68,7,233,219,14,0,16,12,4,12,12,79,6,73
2021,Manchester 039F,E01033671,828,269,40,229,441,15,181,82,93,6,219,188,28,3,24,15,9,2,2,118,6,112
2021,Manchester 040A,E01005125,612,183,65,118,360,23,153,29,94,30,64,32,27,5,112,65,47,8,8,69,30,39
2021,Manchester 040B,E01005304,665,214,53,161,260,10,134,39,78,17,74,53,19,2,29,14,15,13,13,191,9,182
2021,Manchester 040C,E01005306,723,246,81,165,411,59,241,89,124,28,73,57,13,3,31,15,16,7,7,66,9,57
2021,Manchester 040D,E01005307,716,199,71,128,330,36,153,39,83,31,102,80,16,6,30,16,14,9,9,187,14,173
2021,Manchester 040E,E01005308,619,143,58,85,400,24,175,59,93,23,76,39,31,6,119,70,49,6,6,76,19,57
2021,Manchester 041A,E01005119,670,203,78,125,417,25,159,35,100,24,70,32,26,12,160,93,67,3,3,50,32,18
2021,Manchester 041B,E01005121,604,156,59,97,383,13,152,28,86,38,64,27,26,11,145,85,60,9,9,65,43,22
2021,Manchester 041C,E01005122,642,162,78,84,406,13,188,34,124,30,53,21,25,7,148,89,59,4,4,74,50,24
2021,Manchester 041D,E01005123,614,126,39,87,434,15,178,22,124,32,60,22,25,13,174,95,79,7,7,54,29,25
2021,Manchester 041E,E01005124,670,156,54,102,453,19,183,44,104,35,76,27,42,7,171,103,68,4,4,61,38,23
2021,Manchester 042A,E01005077,630,191,47,144,395,12,142,37,84,21,72,30,33,9,167,110,57,2,2,44,21,23
2021,Manchester 042B,E01005078,832,426,105,321,347,17,126,68,52,6,170,160,7,3,27,16,11,7,7,59,5,54
2021,Manchester 042C,E01005079,638,176,72,104,404,29,180,54,104,22,97,60,33,4,92,44,48,6,6,58,26,32
2021,Manchester 042D,E01005084,859,249,76,173,535,35,191,49,113,29,151,98,43,10,136,82,54,22,22,75,24,51
2021,Manchester 043A,E01005172,796,371,121,250,366,50,173,61,93,19,124,106,13,5,16,7,9,3,3,59,9,50
2021,Manchester 043B,E01005173,720,231,89,142,424,57,238,82,130,26,96,70,24,2,29,18,11,4,4,65,8,57
2021,Manchester 043C,E01005174,617,175,64,111,408,53,268,67,174,27,58,29,28,1,28,12,16,1,1,34,7,27
2021,Manchester 043D,E01005175,688,211,77,134,424,40,208,60,127,21,110,75,30,5,57,27,30,9,9,53,9,44
2021,Manchester 043E,E01005176,894,337,81,256,466,36,148,64,70,14,229,205,23,1,45,32,13,8,8,91,4,87
2021,Manchester 043F,E01005177,619,227,112,115,359,47,184,61,100,23,91,63,25,3,31,14,17,6,6,33,3,30
2021,Manchester 044A,E01005115,785,246,102,144,484,49,214,59,115,40,100,42,51,7,115,69,46,6,6,55,19,36
2021,Manchester 044B,E01005262,851,340,96,244,474,25,186,74,89,23,113,70,42,1,141,93,48,9,9,37,13,24
2021,Manchester 044C,E01005264,616,176,61,115,387,19,168,42,86,40,58,21,27,10,135,82,53,7,7,53,22,31
2021,Manchester 044D,E01005265,700,195,72,123,455,38,158,48,83,27,81,32,43,6,168,119,49,10,10,50,27,23
2021,Manchester 044E,E01005266,831,232,96,136,538,27,191,53,106,32,121,60,56,5,198,135,63,1,1,61,23,38
2021,Manchester 045A,E01005126,803,242,105,137,494,44,243,64,132,47,126,89,33,4,72,38,34,9,9,67,34,33
2021,Manchester 045B,E01005168,521,119,57,62,366,50,222,44,136,42,52,22,24,6,38,16,22,4,4,36,14,22
2021,Manchester 045C,E01005169,598,172,68,104,400,53,221,76,105,40,78,56,18,4,43,22,21,5,5,26,9,17
2021,Manchester 045D,E01005170,579,117,60,57,420,51,225,58,129,38,92,57,31,4,46,26,20,6,6,42,15,27
2021,Manchester 045E,E01005171,701,187,63,124,445,35,225,76,123,26,115,82,29,4,60,24,36,10,10,69,23,46
2021,Manchester 046A,E01005263,802,356,132,224,386,27,179,61,88,30,94,43,47,4,79,45,34,7,7,60,18,42
2021,Manchester 046B,E01005267,649,179,86,93,410,57,181,51,91,39,87,49,33,5,82,42,40,3,3,60,18,42
2021,Manchester 046C,E01005268,1071,428,154,274,577,62,256,92,127,37,175,127,44,4,70,41,29,14,14,66,16,50
2021,Manchester 046D,E01005269,615,170,98,72,388,59,217,75,92,50,57,23,23,11,51,21,30,4,4,57,25,32
2021,Manchester 047A,E01005069,654,219,74,145,420,62,196,76,81,39,81,36,40,5,77,45,32,4,4,15,7,8
2021,Manchester 047B,E01005111,607,175,61,114,405,27,136,37,71,28,98,40,48,10,137,82,55,7,7,27,13,14
2021,Manchester 047C,E01005113,810,354,92,262,429,18,128,46,53,29,90,32,47,11,184,132,52,9,9,27,16,11
2021,Manchester 047D,E01005114,819,303,171,132,460,114,210,71,100,39,68,41,21,6,64,29,35,4,4,56,24,32
2021,Manchester 047E,E01005116,993,372,130,242,574,54,224,78,112,34,151,89,53,9,135,90,45,10,10,47,16,31
2021,Manchester 048A,E01005071,736,249,65,184,432,28,181,58,83,40,75,22,45,8,136,95,41,12,12,55,25,30
2021,Manchester 048B,E01005072,859,375,108,267,436,11,170,50,92,28,113,67,44,2,134,88,46,8,8,48,15,33
2021,Manchester 048C,E01005073,612,149,57,92,422,63,215,64,84,67,78,31,42,5,63,36,27,3,3,41,19,22
2021,Manchester 048D,E01005112,674,181,75,106,449,35,189,58,88,43,84,37,41,6,136,96,40,5,5,44,30,14
2021,Manchester 048E,E01005117,973,388,80,308,522,20,198,41,128,29,99,34,57,8,187,131,56,18,18,63,40,23
2021,Manchester 049A,E01005085,601,138,38,100,404,9,136,33,79,24,76,29,43,4,178,133,45,5,5,59,37,22
2021,Manchester 049B,E01005086,702,171,61,110,478,35,149,29,85,35,99,27,65,7,182,137,45,13,13,53,35,18
2021,Manchester 049C,E01005089,696,174,54,120,452,22,143,26,88,29,99,23,66,10,176,133,43,12,12,70,34,36
2021,Manchester 049D,E01005289,782,337,163,174,389,49,112,39,55,18,74,22,42,10,151,103,48,3,3,56,35,21
2021,Manchester 049E,E01005295,1139,382,76,306,673,34,287,98,147,42,180,117,59,4,157,105,52,15,15,84,33,51
2021,Manchester 050A,E01005087,801,156,44,112,559,19,173,35,103,35,125,56,62,7,231,182,49,11,11,86,56,30
2021,Manchester 050B,E01005088,728,181,63,118,482,22,145,38,73,34,84,25,52,7,214,156,58,17,17,65,38,27
2021,Manchester 050C,E01005090,861,354,114,240,469,26,129,36,76,17,112,57,50,5,187,149,38,15,15,38,18,20
2021,Manchester 050D,E01005091,875,206,70,136,596,19,216,38,148,30,116,39,63,14,239,179,60,6,6,73,38,35
2021,Manchester 050E,E01005291,680,293,111,182,337,22,110,30,53,27,59,22,31,6,139,94,45,7,7,50,24,26
2021,Manchester 051A,E01005068,721,237,92,145,435,23,145,43,70,32,98,38,52,8,156,99,57,13,13,49,16,33
2021,Manchester 051B,E01005070,802,311,101,210,419,21,159,55,74,30,87,34,39,14,141,101,40,11,11,72,28,44
2021,Manchester 051C,E01005074,642,184,73,111,415,25,156,47,66,43,77,25,37,15,151,99,52,6,6,43,23,20
2021,Manchester 051D,E01005075,675,239,95,144,395,33,140,45,62,33,84,32,40,12,127,80,47,11,11,41,22,19
2021,Manchester 051E,E01005319,898,223,88,135,579,34,186,47,99,40,132,55,70,7,213,135,78,14,14,96,46,50
2021,Manchester 052A,E01005290,686,221,73,148,406,27,139,40,65,34,81,19,55,7,153,92,61,6,6,59,24,35
2021,Manchester 052B,E01005292,667,238,87,151,390,23,109,34,56,19,84,26,48,10,165,106,59,9,9,39,18,21
2021,Manchester 052C,E01005293,512,144,59,85,351,43,170,72,61,37,80,37,35,8,55,34,21,3,3,17,7,10
2021,Manchester 052D,E01005294,639,170,79,91,408,57,211,64,85,62,69,35,26,8,62,34,28,9,9,61,32,29
2021,Manchester 052E,E01005317,920,326,97,229,530,41,177,60,82,35,106,58,41,7,181,117,64,25,25,64,29,35
2021,Manchester 053A,E01005313,601,159,62,97,396,21,118,39,55,24,96,30,52,14,152,95,57,9,9,46,24,22
2021,Manchester 053B,E01005314,638,157,67,90,416,20,134,36,58,40,80,22,49,9,171,114,57,11,11,65,41,24
2021,Manchester 053C,E01005315,815,321,122,199,438,44,130,50,57,23,87,29,46,12,161,113,48,16,16,56,21,35
2021,Manchester 053D,E01005316,690,220,52,168,403,26,168,53,88,27,86,36,43,7,114,75,39,9,9,67,34,33
2021,Manchester 053E,E01005318,786,214,81,133,497,20,171,49,82,40,128,50,66,12,168,120,48,10,10,75,27,48
2021,Manchester 054A,E01005130,733,342,62,280,329,12,102,35,54,13,79,59,17,3,118,75,43,18,18,62,16,46
2021,Manchester 054B,E01033651,957,363,8,355,358,0,89,48,30,11,222,215,7,0,13,5,8,34,34,236,4,232
2021,Manchester 054C,E01033658,711,363,9,354,252,6,75,60,15,0,135,130,4,1,12,7,5,24,24,96,3,93
2021,Manchester 054D,E01033664,1079,500,4,496,357,0,96,41,54,1,213,200,13,0,24,7,17,24,24,222,1,221
2021,Manchester 054E,E01033667,880,389,18,371,310,3,97,82,15,0,179,176,3,0,7,4,3,24,24,181,2,179
2021,Manchester 055A,E01005128,697,365,5,360,216,3,39,34,3,2,123,121,2,0,7,1,6,44,44,116,0,116
2021,Manchester 055B,E01033653,1150,597,108,489,370,24,86,66,18,2,203,199,4,0,19,6,13,38,38,183,3,180
2021,Manchester 055C,E01033654,562,263,8,255,200,1,71,58,12,1,111,111,0,0,2,0,2,15,15,99,1,98
2021,Manchester 055E,E01033661,1200,532,113,419,408,10,74,61,12,1,288,276,10,2,17,5,12,19,19,260,2,258
2021,Manchester 055F,E01034129,638,255,7,248,273,4,54,40,12,2,179,177,1,1,8,3,5,28,28,110,1,109
2021,Manchester 055G,E01034130,782,248,3,245,298,1,56,45,10,1,206,197,9,0,11,6,5,24,24,236,0,236
2021,Manchester 056A,E01005143,791,162,39,123,467,10,310,22,234,54,19,7,11,1,111,59,52,17,17,162,113,49
2021,Manchester 056B,E01033655,745,288,1,287,275,0,65,39,25,1,183,179,4,0,2,0,2,25,25,182,3,179
2021,Manchester 056C,E01033665,916,437,41,396,367,8,115,73,34,8,208,198,10,0,18,10,8,18,18,112,3,109
2021,Manchester 056D,E01033676,733,258,80,178,404,18,176,36,113,27,54,24,23,7,148,114,34,8,8,71,42,29
2021,Manchester 057A,E01005212,761,322,41,281,285,1,97,32,59,6,94,76,18,0,70,46,24,23,23,154,13,141
2021,Manchester 057B,E01033656,484,163,0,163,156,0,36,26,8,2,98,95,3,0,2,0,2,20,20,165,0,165
2021,Manchester 057C,E01033662,967,498,6,492,307,3,61,43,16,2,191,187,4,0,14,10,4,38,38,162,1,161
2021,Manchester 058A,E01005142,703,199,46,153,436,5,234,26,176,32,47,14,29,4,131,78,53,19,19,68,54,14
2021,Manchester 058B,E01005147,898,240,58,182,560,10,293,39,202,52,46,14,24,8,193,130,63,18,18,98,63,35
2021,Manchester 058C,E01033674,668,243,16,227,322,21,133,47,73,13,114,101,11,2,37,28,9,17,17,103,15,88
2021,Manchester 058D,E01033675,772,184,33,151,513,12,249,32,187,30,63,28,30,5,178,115,63,11,11,75,36,39
2021,Manchester 059A,E01005213,1163,501,98,403,472,9,148,40,98,10,111,79,29,3,169,101,68,35,35,190,26,164
2021,Manchester 059B,E01033660,860,329,6,323,357,2,56,48,7,1,278,273,5,0,9,4,5,12,12,174,2,172
2021,Manchester 059C,E01033672,921,420,44,376,381,3,91,44,38,9,145,125,18,2,107,71,36,35,35,120,9,111
2021,Manchester 059D,E01033673,855,335,9,326,317,0,52,41,9,2,242,238,4,0,5,2,3,18,18,203,2,201
2021,Manchester 060A,E01033677,612,285,12,273,215,1,76,48,25,3,94,92,2,0,24,3,21,20,20,112,5,107
2021,Manchester 060B,E01033681,850,415,13,402,311,4,69,53,15,1,205,200,5,0,9,5,4,24,24,124,3,121
2021,Manchester 060C,E01033682,751,336,40,296,276,8,68,47,17,4,172,168,4,0,10,7,3,18,18,139,1,138
2021,Manchester 060E,E01034131,649,311,2,309,224,0,50,37,13,0,137,132,4,1,22,1,21,15,15,114,0,114
2021,Manchester 060F,E01034132,959,437,0,437,321,1,83,59,20,4,181,178,3,0,16,12,4,40,40,201,1,200
2021,Manchester 061A,E01005129,836,335,72,263,425,11,125,45,64,16,115,82,29,4,160,98,62,14,14,76,21,55
2021,Manchester 061B,E01005132,840,240,68,172,503,12,181,59,88,34,105,56,42,7,196,119,77,9,9,97,49,48
2021,Manchester 061C,E01034133,879,340,94,246,394,15,122,55,49,18,152,123,23,6,90,55,35,15,15,145,39,106
2021,Manchester 061D,E01034134,672,216,2,214,294,1,54,36,18,0,213,207,5,1,11,6,5,15,15,162,0,162
2021,Manchester 062D,E01033684,1017,311,2,309,387,0,73,56,15,2,273,266,7,0,5,4,1,36,36,319,2,317
2021,Manchester 062B,E01033688,701,266,94,172,380,19,133,26,84,23,55,31,16,8,150,91,59,23,23,55,29,26
2021,Manchester 062A,E01034135,641,289,9,280,265,3,83,49,31,3,145,138,7,0,22,13,9,12,12,87,9,78
2021,Manchester 062C,E01034136,603,274,1,273,228,2,54,43,11,0,152,148,4,0,4,4,0,16,16,101,4,97
2021,Manchester 063B,E01005233,786,121,31,90,513,10,319,26,261,32,41,14,24,3,131,103,28,12,12,152,107,45
2021,Manchester 063A,E01005234,650,154,50,104,397,8,241,27,187,27,25,9,15,1,106,63,43,17,17,99,66,33
2021,Manchester 063D,E01005238,584,91,20,71,378,14,241,22,175,44,24,10,12,2,82,45,37,17,17,115,72,43
2021,Manchester 063C,E01034137,495,78,18,60,349,20,224,36,160,28,24,10,13,1,67,47,20,14,14,68,47,21
2021,Manchester 064C,E01005199,906,271,51,220,525,16,277,52,209,16,94,56,33,5,125,75,50,13,13,110,51,59
2021,Manchester 064A,E01005200,963,306,82,224,559,25,269,51,193,25,104,62,38,4,145,102,43,16,16,98,41,57
2021,Manchester 064B,E01034138,452,118,25,93,276,5,146,20,115,11,29,16,13,0,84,61,23,12,12,58,37,21
2021,Oldham 001A,E01005357,618,171,128,43,430,100,225,82,93,50,60,31,24,5,43,22,21,2,2,17,12,5
2021,Oldham 001B,E01005358,716,270,113,157,421,42,178,56,78,44,94,36,50,8,102,65,37,5,5,25,10,15
2021,Oldham 001C,E01005359,761,268,155,113,466,136,199,84,67,48,79,48,24,7,51,27,24,1,1,27,14,13
2021,Oldham 001D,E01005360,642,219,140,79,402,94,154,68,49,37,78,32,38,8,75,44,31,1,1,21,13,8
2021,Oldham 002A,E01005441,753,312,123,189,420,53,167,69,69,29,85,40,31,14,111,71,40,4,4,21,11,10
2021,Oldham 002B,E01005442,578,142,88,54,418,93,207,76,83,48,68,33,27,8,46,22,24,4,4,18,9,9
2021,Oldham 002C,E01005444,659,247,116,131,391,52,146,62,53,31,91,40,43,8,97,61,36,5,5,21,10,11
2021,Oldham 002D,E01005445,665,251,75,176,371,24,117,35,49,33,101,49,45,7,125,84,41,4,4,43,20,23
2021,Oldham 003A,E01005361,732,210,139,71,495,131,232,95,82,55,74,26,42,6,57,33,24,1,1,27,13,14
2021,Oldham 003B,E01005443,543,106,54,52,416,98,221,89,80,52,53,19,28,6,43,17,26,1,1,21,13,8
2021,Oldham 003C,E01005446,596,149,57,92,418,66,172,65,65,42,80,31,37,12,98,57,41,2,2,29,13,16
2021,Oldham 003D,E01005447,722,305,122,183,385,34,135,44,69,22,98,54,39,5,110,78,32,8,8,32,18,14
2021,Oldham 004A,E01005390,609,173,93,80,410,93,171,63,70,38,75,35,35,5,70,42,28,1,1,26,15,11
2021,Oldham 004B,E01005394,642,196,115,81,425,87,214,74,98,42,59,30,23,6,64,33,31,1,1,21,6,15
2021,Oldham 004C,E01005395,623,176,86,90,427,84,198,70,84,44,70,30,38,2,72,41,31,3,3,20,9,11
2021,Oldham 004D,E01005396,575,135,75,60,408,94,188,65,75,48,58,20,30,8,65,37,28,3,3,32,16,16
2021,Oldham 005A,E01005355,625,189,69,120,398,39,157,57,76,24,104,41,53,10,95,53,42,3,3,38,19,19
2021,Oldham 005B,E01005356,497,97,41,56,381,52,227,86,87,54,55,27,21,7,47,30,17,0,0,19,9,10
2021,Oldham 005C,E01005399,710,225,105,120,457,95,205,81,79,45,92,33,51,8,64,34,30,1,1,28,10,18
2021,Oldham 005D,E01005403,691,174,69,105,488,52,228,70,107,51,125,52,59,14,83,65,18,0,0,29,14,15
2021,Oldham 006A,E01005410,622,131,77,54,461,96,261,98,115,48,62,30,24,8,39,18,21,3,3,30,13,17
2021,Oldham 006B,E01005411,735,281,173,108,441,98,227,74,105,48,60,32,24,4,55,30,25,1,1,13,4,9
2021,Oldham 006C,E01005414,560,137,69,68,410,70,234,80,114,40,69,41,23,5,35,16,19,2,2,13,6,7
2021,Oldham 006D,E01005415,513,174,122,52,327,77,159,57,67,35,37,19,14,4,54,31,23,0,0,12,5,7
2021,Oldham 007C,E01005452,538,140,64,76,362,77,192,72,63,57,58,33,24,1,35,17,18,0,0,36,17,19
2021,Oldham 007D,E01005453,633,148,71,77,455,61,243,77,114,52,97,47,42,8,49,29,20,5,5,30,13,17
2021,Oldham 007E,E01032558,659,157,56,101,463,28,143,46,72,25,106,19,79,8,182,140,42,4,4,39,29,10
2021,Oldham 007F,E01032559,1008,207,67,140,737,47,362,102,179,81,177,75,88,14,150,99,51,1,1,64,31,33
2021,Oldham 008A,E01005391,655,175,80,95,455,72,203,69,76,58,71,25,34,12,103,65,38,6,6,25,15,10
2021,Oldham 008B,E01005392,805,355,173,182,433,61,126,50,54,22,81,27,46,8,157,101,56,8,8,17,5,12
2021,Oldham 008C,E01005393,531,153,97,56,358,86,155,55,58,42,58,25,27,6,57,34,23,2,2,20,9,11
2021,Oldham 008D,E01005401,684,189,122,67,478,94,247,88,88,71,86,36,41,9,51,16,35,0,0,17,10,7
2021,Oldham 009A,E01005397,607,208,77,131,372,61,153,61,52,40,85,33,47,5,72,41,31,1,1,27,9,18
2021,Oldham 009B,E01005398,675,225,84,141,422,55,175,62,65,48,97,43,46,8,90,50,40,5,5,28,15,13
2021,Oldham 009C,E01005400,796,364,178,186,411,86,133,48,55,30,69,32,29,8,119,77,42,4,4,21,10,11
2021,Oldham 009D,E01005402,663,225,96,129,393,39,178,57,78,43,67,29,34,4,104,73,31,5,5,45,31,14
2021,Oldham 010A,E01005335,541,132,72,60,389,82,168,40,85,43,69,37,30,2,62,32,30,8,8,20,11,9
2021,Oldham 010B,E01005337,790,188,50,138,544,24,322,44,259,19,59,18,37,4,129,90,39,10,10,58,42,16
2021,Oldham 010C,E01005339,602,127,81,46,453,99,264,72,120,72,48,28,17,3,36,21,15,6,6,22,9,13
2021,Oldham 010D,E01005340,626,219,90,129,371,40,153,34,89,30,62,19,35,8,113,77,36,3,3,36,21,15
2021,Oldham 011A,E01005421,771,251,74,177,481,28,143,46,61,36,121,60,51,10,178,142,36,11,11,39,20,19
2021,Oldham 011B,E01005422,524,85,33,52,405,13,128,44,61,23,83,18,58,7,180,141,39,1,1,34,24,10
2021,Oldham 011E,E01032920,1062,322,112,210,670,49,233,76,107,50,162,57,97,8,218,159,59,8,8,70,25,45
2021,Oldham 012A,E01005448,741,335,123,212,376,19,137,41,77,19,63,26,35,2,150,120,30,7,7,30,20,10
2021,Oldham 012B,E01005449,679,253,146,107,387,52,137,57,53,27,75,21,51,3,119,75,44,4,4,39,21,18
2021,Oldham 012C,E01005454,573,146,62,84,402,57,202,87,69,46,77,34,39,4,63,40,23,3,3,25,10,15
2021,Oldham 012D,E01005455,610,156,56,100,419,48,198,67,84,47,76,32,36,8,95,57,38,2,2,35,12,23
2021,Oldham 012E,E01005456,762,308,67,241,414,31,122,35,62,25,81,30,42,9,168,111,57,12,12,40,16,24
2021,Oldham 013A,E01005407,752,200,96,104,526,117,294,103,135,56,74,41,29,4,40,18,22,1,1,26,14,12
2021,Oldham 013B,E01005412,789,265,136,129,499,96,250,106,104,40,75,51,17,7,76,42,34,2,2,25,11,14
2021,Oldham 013C,E01005416,670,206,91,115,443,72,211,80,102,29,100,59,38,3,58,39,19,2,2,21,11,10
2021,Oldham 013D,E01005417,643,160,76,84,448,109,223,81,112,30,74,38,30,6,38,17,21,4,4,35,19,16
2021,Oldham 014A,E01005348,746,249,95,154,399,30,217,46,135,36,48,9,33,6,97,62,35,7,7,98,87,11
2021,Oldham 014B,E01005350,1063,580,139,441,418,14,179,42,125,12,60,35,21,4,137,92,45,28,28,65,47,18
2021,Oldham 014C,E01005432,689,232,69,163,398,18,136,42,66,28,77,23,44,10,165,123,42,2,2,59,35,24
2021,Oldham 014D,E01005433,934,370,63,307,497,16,181,32,125,24,95,36,55,4,187,138,49,18,18,67,48,19
2021,Oldham 015A,E01005329,631,155,66,89,452,83,250,90,108,52,66,37,22,7,47,25,22,6,6,24,12,12
2021,Oldham 015B,E01005330,691,147,64,83,496,85,250,76,109,65,90,40,42,8,70,44,26,1,1,48,16,32
2021,Oldham 015C,E01005333,499,112,72,40,367,83,201,72,77,52,47,21,20,6,35,19,16,1,1,20,10,10
2021,Oldham 015D,E01005336,631,159,101,58,447,98,233,77,91,65,63,28,29,6,50,23,27,3,3,25,14,11
2021,Oldham 016A,E01005349,588,67,28,39,404,4,287,27,226,34,17,2,15,0,87,54,33,9,9,117,98,19
2021,Oldham 016B,E01005351,471,72,16,56,309,9,229,17,182,30,8,2,6,0,59,39,20,4,4,90,68,22
2021,Oldham 016C,E01005352,467,140,37,103,266,21,160,26,114,20,13,6,6,1,67,39,28,5,5,61,46,15
2021,Oldham 016D,E01005353,409,91,25,66,242,4,151,18,116,17,14,2,11,1,64,30,34,9,9,76,60,16
2021,Oldham 016E,E01005354,573,129,40,89,379,13,215,43,140,32,59,25,31,3,83,55,28,9,9,65,52,13
2021,Oldham 017A,E01005327,778,253,127,126,484,64,242,58,133,51,87,43,41,3,88,53,35,3,3,41,23,18
2021,Oldham 017B,E01005328,746,336,101,235,369,27,162,34,97,31,54,33,18,3,114,82,32,12,12,41,30,11
2021,Oldham 017C,E01005331,657,162,68,94,470,74,204,56,114,34,86,29,49,8,105,77,28,1,1,25,15,10
2021,Oldham 017D,E01005334,554,120,51,69,420,57,232,56,105,71,72,23,38,11,59,45,14,0,0,14,9,5
2021,Oldham 017E,E01005338,761,283,159,124,434,68,216,45,142,29,49,26,18,5,89,52,37,12,12,44,29,15
2021,Oldham 018A,E01005387,641,179,71,108,446,58,173,63,76,34,123,53,63,7,91,52,39,1,1,16,7,9
2021,Oldham 018B,E01005388,587,180,88,92,379,62,151,52,64,35,72,37,30,5,91,51,40,3,3,28,9,19
2021,Oldham 018C,E01005389,783,291,94,197,458,45,145,59,63,23,100,40,53,7,161,105,56,7,7,34,18,16
2021,Oldham 018D,E01005418,594,158,100,58,421,71,220,66,100,54,66,35,27,4,63,31,32,1,1,15,7,8
2021,Oldham 019A,E01005428,528,94,24,70,310,8,210,29,158,23,24,7,17,0,59,40,19,9,9,124,102,22
2021,Oldham 019B,E01005431,698,192,71,121,469,35,253,89,140,24,65,28,34,3,108,74,34,8,8,37,22,15
2021,Oldham 019C,E01005450,670,138,34,104,465,13,303,109,175,19,50,15,33,2,91,74,17,8,8,67,53,14
2021,Oldham 019D,E01005451,494,105,40,65,337,40,184,46,101,37,44,17,24,3,65,47,18,4,4,52,38,14
2021,Oldham 020C,E01005408,891,280,165,115,579,120,296,101,144,51,95,44,44,7,67,46,21,1,1,32,12,20
2021,Oldham 020D,E01005409,661,175,101,74,457,92,255,89,111,55,58,27,27,4,48,21,27,4,4,29,13,16
2021,Oldham 020E,E01032922,1071,324,222,102,719,165,369,126,154,89,84,34,43,7,98,54,44,3,3,28,14,14
2021,Oldham 021A,E01005406,587,132,76,56,433,86,256,97,115,44,56,23,25,8,34,17,17,1,1,22,6,16
2021,Oldham 021B,E01005413,642,133,79,54,487,75,281,102,121,58,77,43,26,8,49,25,24,5,5,22,11,11
2021,Oldham 021C,E01005419,650,195,96,99,435,73,205,81,86,38,75,39,27,9,78,55,23,4,4,20,9,11
2021,Oldham 021D,E01005420,744,276,165,111,449,77,184,70,68,46,104,51,44,9,80,46,34,4,4,19,12,7
2021,Oldham 022A,E01005321,619,167,48,119,389,13,262,33,209,20,42,16,21,5,66,48,18,6,6,63,46,17
2021,Oldham 022B,E01005326,557,62,20,42,310,5,223,16,168,39,7,1,5,1,69,41,28,6,6,185,157,28
2021,Oldham 022C,E01005427,509,64,21,43,325,3,235,20,183,32,18,2,16,0,64,32,32,5,5,120,97,23
2021,Oldham 022D,E01005429,463,69,22,47,282,11,203,22,153,28,8,2,6,0,56,31,25,4,4,112,83,29
2021,Oldham 022E,E01005430,720,130,35,95,463,20,319,42,243,34,27,17,8,2,86,55,31,11,11,127,101,26
2021,Oldham 024A,E01005320,646,131,31,100,407,10,263,37,187,39,43,10,31,2,89,65,24,2,2,108,91,17
2021,Oldham 024B,E01005434,791,302,72,230,409,16,210,51,153,6,37,22,14,1,131,107,24,15,15,80,51,29
2021,Oldham 024C,E01005437,543,68,20,48,409,11,298,51,202,45,19,8,8,3,77,48,29,4,4,66,51,15
2021,Oldham 024D,E01005459,481,112,52,60,292,7,166,16,130,20,33,5,27,1,80,47,33,6,6,77,59,18
2021,Oldham 026A,E01005383,709,171,67,104,467,33,259,52,170,37,63,26,32,5,108,83,25,4,4,71,55,16
2021,Oldham 026D,E01005386,647,206,90,116,401,25,144,59,65,20,88,30,49,9,138,93,45,6,6,40,26,14
2021,Oldham 026E,E01032556,670,197,88,109,445,72,153,56,64,33,108,51,51,6,110,76,34,2,2,28,12,16
2021,Oldham 026F,E01032557,764,270,103,167,439,23,129,38,74,17,84,27,50,7,198,155,43,5,5,55,33,22
2021,Oldham 027A,E01005342,725,334,130,204,349,34,145,47,77,21,50,29,15,6,113,67,46,7,7,42,22,20
2021,Oldham 027B,E01005343,546,136,50,86,380,40,152,40,79,33,90,21,55,14,96,61,35,2,2,30,15,15
2021,Oldham 027C,E01005344,778,260,54,206,475,26,167,42,98,27,138,62,65,11,139,104,35,5,5,43,25,18
2021,Oldham 027D,E01005381,757,279,104,175,402,35,179,39,112,28,70,32,33,5,110,73,37,8,8,76,46,30
2021,Oldham 028A,E01005332,986,367,135,232,562,65,234,63,124,47,95,54,37,4,162,110,52,6,6,57,29,28
2021,Oldham 028B,E01005341,592,179,67,112,383,35,163,57,65,41,109,44,56,9,69,43,26,7,7,30,19,11
2021,Oldham 028C,E01005345,619,159,86,73,430,59,203,78,84,41,89,38,33,18,78,41,37,1,1,30,18,12
2021,Oldham 028D,E01005346,598,186,106,80,383,56,190,67,66,57,62,21,32,9,70,31,39,5,5,29,14,15
2021,Oldham 028E,E01005347,539,164,64,100,349,37,152,47,72,33,85,42,31,12,72,48,24,3,3,26,14,12
2021,Oldham 029A,E01005322,536,126,37,89,369,17,157,28,100,29,51,17,31,3,138,88,50,6,6,41,25,16
2021,Oldham 029B,E01005323,620,188,62,126,397,39,121,42,50,29,75,27,43,5,157,110,47,5,5,35,18,17
2021,Oldham 029C,E01005324,690,211,79,132,444,27,152,61,65,26,100,30,61,9,160,107,53,5,5,35,18,17
2021,Oldham 029D,E01005325,513,140,39,101,334,19,117,33,63,21,69,14,52,3,125,104,21,4,4,39,25,14
2021,Oldham 029E,E01005438,1006,257,92,165,664,45,340,65,228,47,94,45,40,9,151,113,38,34,34,85,58,27
2021,Oldham 030A,E01005377,635,168,43,125,440,14,180,48,95,37,91,35,44,12,152,109,43,3,3,27,16,11
2021,Oldham 030B,E01005379,484,118,49,69,332,13,93,25,54,14,63,15,40,8,161,122,39,2,2,34,22,12
2021,Oldham 030C,E01005380,523,94,41,53,396,17,163,51,69,43,68,14,44,10,141,105,36,7,7,33,20,13
2021,Oldham 030D,E01005382,653,226,111,115,386,41,153,37,77,39,59,22,29,8,123,78,45,10,10,41,20,21
2021,Oldham 030E,E01005439,650,175,86,89,425,75,207,74,87,46,71,41,22,8,72,37,35,0,0,50,24,26
2021,Oldham 031A,E01005362,597,182,103,79,387,61,160,45,66,49,68,27,32,9,96,55,41,2,2,28,11,17
2021,Oldham 031B,E01005364,690,193,117,76,479,74,233,90,70,73,90,38,42,10,80,45,35,2,2,18,9,9
2021,Oldham 031C,E01005368,759,320,88,232,406,29,122,54,47,21,86,47,35,4,159,111,48,10,10,33,13,20
2021,Oldham 031D,E01005376,571,180,70,110,347,28,117,25,66,26,69,30,35,4,127,85,42,6,6,44,21,23
2021,Oldham 031E,E01005378,664,205,81,124,424,55,171,68,73,30,86,36,43,7,109,83,26,3,3,35,18,17
2021,Oldham 032A,E01005363,840,330,110,220,477,46,176,66,72,38,123,70,45,8,125,77,48,7,7,33,13,20
2021,Oldham 032B,E01005369,828,238,82,156,543,40,188,60,106,22,141,80,55,6,168,90,78,6,6,47,16,31
2021,Oldham 032C,E01005370,792,356,166,190,411,47,130,53,49,28,87,38,38,11,142,86,56,5,5,25,10,15
2021,Oldham 032D,E01005371,605,194,52,142,363,25,135,49,60,26,115,55,54,6,84,58,26,4,4,48,28,20
2021,Oldham 033A,E01005365,615,180,93,87,406,62,203,78,62,63,67,39,25,3,70,42,28,4,4,29,16,13
2021,Oldham 033B,E01005366,753,295,162,133,433,116,146,44,50,52,64,25,31,8,104,52,52,3,3,25,14,11
2021,Oldham 033C,E01005367,565,128,81,47,415,75,220,69,80,71,61,28,30,3,58,31,27,1,1,22,12,10
2021,Oldham 033D,E01005440,654,224,98,126,396,47,184,76,66,42,77,36,39,2,83,55,28,5,5,34,16,18
2021,Oldham 034A,E01005372,535,150,70,80,365,33,138,40,66,32,82,34,38,10,109,76,33,3,3,20,8,12
2021,Oldham 034B,E01005373,509,153,100,53,338,62,161,50,67,44,61,19,35,7,54,31,23,0,0,18,8,10
2021,Oldham 034C,E01005374,614,156,82,74,423,56,165,63,63,39,89,35,47,7,112,73,39,1,1,35,15,20
2021,Oldham 034D,E01005375,646,180,115,65,439,81,206,75,82,49,76,33,40,3,74,36,38,2,2,27,8,19
2021,Oldham 036C,E01005460,817,196,71,125,532,23,289,49,204,36,51,19,27,5,156,118,38,13,13,89,68,21
2021,Oldham 036D,E01005463,511,107,27,80,355,9,204,29,156,19,27,12,15,0,103,80,23,12,12,49,36,13
2021,Oldham 036A,E01034232,434,103,22,81,258,6,158,13,130,15,15,6,9,0,71,52,19,8,8,73,65,8
2021,Oldham 036B,E01034233,431,100,24,76,245,7,160,29,103,28,18,2,16,0,52,26,26,8,8,86,61,25
2021,Oldham 037B,E01005435,494,57,24,33,346,13,245,31,188,26,6,3,1,2,80,58,22,2,2,91,65,26
2021,Oldham 037D,E01005436,519,91,39,52,348,29,211,40,132,39,40,17,16,7,63,40,23,5,5,80,55,25
2021,Oldham 037A,E01005461,576,85,37,48,363,15,234,26,166,42,12,2,9,1,94,55,39,8,8,128,99,29
2021,Oldham 037C,E01005462,628,140,56,84,388,31,247,45,170,32,37,15,18,4,66,41,25,7,7,100,70,30
2021,Rochdale 001A,E01005518,674,180,78,102,457,62,187,78,71,38,106,50,48,8,96,68,28,6,6,37,17,20
2021,Rochdale 001B,E01005520,806,271,116,155,507,69,212,84,88,40,107,59,42,6,115,71,44,4,4,28,14,14
2021,Rochdale 001C,E01005522,770,362,138,224,383,43,125,49,55,21,102,59,40,3,111,73,38,2,2,25,10,15
2021,Rochdale 001D,E01005523,807,259,103,156,518,86,232,73,107,52,112,61,43,8,84,59,25,4,4,30,15,15
2021,Rochdale 002A,E01005519,622,134,58,76,460,49,225,75,101,49,115,55,55,5,68,48,20,3,3,28,16,12
2021,Rochdale 002B,E01005594,599,136,65,71,431,60,195,80,83,32,92,38,42,12,80,42,38,4,4,32,24,8
2021,Rochdale 002C,E01005597,828,226,91,135,584,86,281,91,150,40,133,57,67,9,82,58,24,2,2,18,5,13
2021,Rochdale 002D,E01005598,689,191,104,87,472,136,212,83,82,47,78,35,37,6,45,24,21,1,1,26,14,12
2021,Rochdale 003A,E01005516,524,114,60,54,388,60,212,90,82,40,61,28,30,3,55,30,25,0,0,22,12,10
2021,Rochdale 003B,E01005517,643,192,110,82,430,110,188,84,65,39,82,43,29,10,47,31,16,3,3,21,7,14
2021,Rochdale 003C,E01005521,674,212,101,111,445,63,250,133,81,36,82,50,23,9,48,19,29,2,2,17,11,6
2021,Rochdale 003D,E01005596,816,194,79,115,569,83,312,103,155,54,98,47,45,6,74,46,28,2,2,53,36,17
2021,Rochdale 004A,E01005578,514,183,47,136,277,17,145,32,83,30,29,13,16,0,82,60,22,4,4,54,37,17
2021,Rochdale 004B,E01005579,550,110,39,71,395,16,202,18,160,24,52,8,35,9,118,81,37,7,7,45,34,11
2021,Rochdale 004C,E01005586,635,221,102,119,368,26,142,29,99,14,73,35,29,9,126,100,26,1,1,46,28,18
2021,Rochdale 004D,E01005593,755,167,60,107,554,56,265,76,149,40,109,42,56,11,121,90,31,3,3,34,26,8
2021,Rochdale 004E,E01005595,749,432,163,269,288,25,116,46,45,25,45,26,16,3,100,68,32,2,2,29,15,14
2021,Rochdale 005A,E01005489,507,112,73,39,376,85,173,68,71,34,59,21,31,7,55,35,20,4,4,19,13,6
2021,Rochdale 005B,E01005490,424,102,46,56,299,24,126,24,69,33,55,18,28,9,86,54,32,8,8,23,16,7
2021,Rochdale 005C,E01005491,688,271,125,146,388,60,160,64,66,30,87,45,36,6,77,51,26,4,4,29,14,15
2021,Rochdale 005D,E01005493,715,199,88,111,477,84,253,97,105,51,76,34,37,5,62,35,27,2,2,39,21,18
2021,Rochdale 005E,E01005494,713,203,91,112,465,65,220,78,108,34,74,35,31,8,99,61,38,7,7,45,26,19
2021,Rochdale 005F,E01005495,698,233,97,136,400,83,193,65,91,37,56,34,19,3,66,45,21,2,2,65,41,24
2021,Rochdale 006A,E01005488,585,109,46,63,460,40,259,77,122,60,91,47,38,6,68,42,26,2,2,16,11,5
2021,Rochdale 006B,E01005492,616,127,75,52,456,94,250,105,98,47,60,27,28,5,48,20,28,4,4,33,18,15
2021,Rochdale 006C,E01005499,682,219,99,120,439,77,205,93,64,48,93,44,38,11,64,40,24,0,0,24,11,13
2021,Rochdale 006D,E01005571,726,208,88,120,497,102,253,92,103,58,97,49,40,8,44,20,24,1,1,21,7,14
2021,Rochdale 007A,E01005570,588,194,93,101,378,88,186,84,67,35,61,29,30,2,42,24,18,1,1,16,5,11
2021,Rochdale 007B,E01005572,620,156,80,76,442,83,223,80,107,36,65,41,20,4,71,40,31,0,0,22,12,10
2021,Rochdale 007C,E01005573,566,124,75,49,407,94,234,75,106,53,45,19,16,10,33,16,17,1,1,35,21,14
2021,Rochdale 007D,E01005574,692,167,92,75,488,110,262,78,120,64,58,30,20,8,57,30,27,1,1,37,24,13
2021,Rochdale 007E,E01005587,517,87,40,47,399,45,263,99,114,50,51,25,22,4,37,24,13,3,3,31,14,17
2021,Rochdale 007F,E01005588,658,282,157,125,360,94,124,45,49,30,56,26,26,4,85,52,33,1,1,16,4,12
2021,Rochdale 008A,E01005580,578,154,51,103,373,14,185,48,111,26,52,25,25,2,113,83,30,9,9,51,35,16
2021,Rochdale 008B,E01005581,721,249,92,157,419,26,239,45,163,31,55,28,23,4,91,73,18,8,8,53,35,18
2021,Rochdale 008D,E01005583,516,149,57,92,277,6,179,26,113,40,15,3,12,0,71,28,43,6,6,90,70,20
2021,Rochdale 008F,E01005585,502,127,36,91,314,18,161,24,116,21,49,27,17,5,75,54,21,11,11,61,43,18
2021,Rochdale 008H,E01034234,457,78,18,60,298,5,208,23,151,34,12,6,5,1,63,29,34,10,10,81,63,18
2021,Rochdale 008I,E01034235,468,92,19,73,296,6,171,26,110,35,39,15,22,2,73,46,27,7,7,80,62,18
2021,Rochdale 009A,E01005496,507,138,52,86,333,19,130,39,66,25,57,12,38,7,120,95,25,7,7,36,25,11
2021,Rochdale 009B,E01005589,715,235,63,172,436,40,168,45,85,38,100,48,50,2,122,89,33,6,6,44,23,21
2021,Rochdale 009C,E01005590,561,114,45,69,361,26,201,36,132,33,42,21,18,3,90,62,28,2,2,86,61,25
2021,Rochdale 009D,E01005591,660,205,105,100,428,73,187,59,97,31,80,35,38,7,85,61,24,3,3,27,17,10
2021,Rochdale 009E,E01005592,609,192,80,112,365,40,160,45,92,23,56,17,36,3,105,65,40,4,4,52,30,22
2021,Rochdale 010A,E01005472,663,224,90,134,402,26,165,36,95,34,78,36,35,7,124,84,40,9,9,37,19,18
2021,Rochdale 010B,E01005473,506,125,38,87,311,19,190,24,129,37,23,9,12,2,67,46,21,12,12,70,51,19
2021,Rochdale 010C,E01005482,893,557,99,458,303,13,118,42,65,11,61,39,18,4,102,71,31,9,9,33,19,14
2021,Rochdale 010D,E01005483,562,246,59,187,254,13,133,23,91,19,25,14,10,1,74,44,30,9,9,62,42,20
2021,Rochdale 010E,E01005484,775,313,87,226,387,10,187,37,122,28,44,17,23,4,135,103,32,11,11,75,47,28
2021,Rochdale 010F,E01005486,600,167,36,131,394,9,227,49,146,32,53,17,33,3,95,71,24,10,10,39,21,18
2021,Rochdale 010G,E01005487,584,148,71,77,363,32,205,43,124,38,34,9,23,2,85,53,32,7,7,73,48,25
2021,Rochdale 011A,E01005474,479,123,76,47,323,66,163,44,80,39,32,17,13,2,58,33,25,4,4,33,24,9
2021,Rochdale 011B,E01005575,761,230,147,83,505,137,236,80,97,59,65,36,18,11,61,40,21,6,6,26,12,14
2021,Rochdale 011C,E01005576,543,100,70,30,388,93,238,68,107,63,27,18,5,4,30,8,22,0,0,55,37,18
2021,Rochdale 011D,E01005577,647,201,111,90,418,104,226,80,102,44,45,24,20,1,41,16,25,2,2,28,14,14
2021,Rochdale 012A,E01005469,682,179,75,104,463,60,219,58,113,48,83,29,45,9,96,60,36,5,5,40,25,15
2021,Rochdale 012B,E01005563,704,159,44,115,462,20,239,48,139,52,62,30,27,5,128,101,27,13,13,83,61,22
2021,Rochdale 012C,E01005565,534,124,43,81,364,21,194,41,102,51,55,20,26,9,89,50,39,5,5,46,26,20
2021,Rochdale 012D,E01005566,828,214,67,147,544,22,240,58,152,30,92,37,49,6,180,139,41,10,10,70,50,20
2021,Rochdale 012E,E01005568,653,212,54,158,379,14,155,25,112,18,46,15,27,4,146,107,39,18,18,62,45,17
2021,Rochdale 012F,E01005569,641,193,74,119,392,41,181,38,106,37,58,22,31,5,106,72,34,6,6,56,36,20
2021,Rochdale 013A,E01005556,697,217,68,149,460,72,216,78,84,54,88,47,31,10,77,50,27,7,7,20,4,16
2021,Rochdale 013B,E01005559,661,260,130,130,372,48,142,46,72,24,79,32,42,5,100,70,30,3,3,29,13,16
2021,Rochdale 013C,E01005560,691,234,119,115,433,101,183,81,66,36,81,57,18,6,68,42,26,0,0,24,11,13
2021,Rochdale 013D,E01005567,809,249,69,180,526,47,252,88,127,37,125,60,55,10,95,74,21,7,7,34,19,15
2021,Rochdale 014A,E01005555,551,117,55,62,410,64,220,64,103,53,64,36,25,3,62,41,21,0,0,24,10,14
2021,Rochdale 014B,E01005557,496,122,85,37,364,97,164,60,66,38,59,21,32,6,42,23,19,2,2,10,6,4
2021,Rochdale 014C,E01005558,701,232,112,120,445,59,185,60,91,34,88,34,44,10,113,74,39,0,0,24,13,11
2021,Rochdale 014D,E01005561,648,206,92,114,413,57,179,85,58,36,92,54,31,7,85,60,25,0,0,29,14,15
2021,Rochdale 014E,E01005562,681,223,99,124,435,48,206,82,84,40,90,44,42,4,84,57,27,7,7,23,12,11
2021,Rochdale 015A,E01005470,511,55,15,40,369,12,251,25,185,41,14,4,10,0,83,45,38,9,9,87,61,26
2021,Rochdale 015B,E01005471,569,147,67,80,361,23,221,45,144,32,34,11,21,2,72,50,22,11,11,61,45,16
2021,Rochdale 015C,E01005475,596,171,76,95,374,21,204,26,126,52,43,12,24,7,93,54,39,13,13,51,41,10
2021,Rochdale 015D,E01005485,676,192,55,137,359,12,223,32,137,54,16,9,2,5,97,53,44,11,11,125,87,38
2021,Rochdale 015E,E01005564,739,163,58,105,484,11,252,33,177,42,59,26,28,5,143,92,51,19,19,92,60,32
2021,Rochdale 016A,E01005464,666,130,51,79,477,20,197,32,123,42,78,21,49,8,173,121,52,9,9,59,39,20
2021,Rochdale 016B,E01005465,793,285,117,168,475,53,221,77,98,46,100,52,41,7,93,63,30,8,8,33,20,13
2021,Rochdale 016C,E01005466,1020,355,105,250,619,29,225,58,135,32,118,37,71,10,235,168,67,12,12,46,23,23
2021,Rochdale 016D,E01005467,831,278,106,172,520,25,187,56,100,31,127,46,75,6,173,119,54,8,8,33,18,15
2021,Rochdale 016E,E01005468,829,165,65,100,635,81,338,103,168,67,134,60,68,6,77,50,27,5,5,29,18,11
2021,Rochdale 017A,E01005476,777,259,112,147,485,58,219,74,104,41,90,37,50,3,114,82,32,4,4,33,17,16
2021,Rochdale 017B,E01005477,850,359,129,230,445,35,138,45,69,24,109,53,50,6,153,117,36,10,10,46,21,25
2021,Rochdale 017C,E01005478,668,191,95,96,435,76,189,70,76,43,77,33,40,4,89,58,31,4,4,42,20,22
2021,Rochdale 017D,E01005479,785,193,94,99,549,73,231,79,102,50,125,61,55,9,112,69,43,8,8,43,21,22
2021,Rochdale 017E,E01005480,718,245,147,98,442,73,203,79,75,49,61,31,22,8,95,58,37,10,10,31,15,16
2021,Rochdale 017F,E01005481,582,145,67,78,393,41,211,60,107,44,66,37,23,6,74,39,35,1,1,44,22,22
2021,Rochdale 018A,E01005497,750,204,91,113,504,49,186,64,83,39,111,30,70,11,155,132,23,3,3,42,26,16
2021,Rochdale 018B,E01005501,992,540,220,320,417,46,139,59,50,30,99,51,39,9,127,102,25,6,6,35,11,24
2021,Rochdale 018C,E01005502,681,278,121,157,377,55,144,61,50,33,79,44,28,7,92,65,27,7,7,26,13,13
2021,Rochdale 018D,E01005504,709,214,79,135,464,35,157,53,63,41,106,44,44,18,159,113,46,7,7,31,14,17
2021,Rochdale 018E,E01005505,960,295,126,169,632,51,256,101,114,41,154,77,66,11,164,106,58,7,7,33,18,15
2021,Rochdale 018F,E01005509,722,351,106,245,338,30,119,47,43,29,87,32,45,10,99,73,26,3,3,33,10,23
2021,Rochdale 019A,E01005510,443,94,53,41,329,69,172,63,64,45,50,15,30,5,36,17,19,2,2,20,7,13
2021,Rochdale 019B,E01005511,494,124,52,72,346,61,156,63,61,32,59,19,34,6,68,30,38,2,2,24,16,8
2021,Rochdale 019C,E01005512,662,227,79,148,406,43,148,66,55,27,96,44,44,8,114,69,45,5,5,29,12,17
2021,Rochdale 019D,E01005513,633,197,69,128,400,25,126,42,63,21,86,33,46,7,155,118,37,8,8,36,25,11
2021,Rochdale 019E,E01005514,778,228,82,146,511,28,191,72,84,35,133,63,57,13,151,108,43,8,8,39,17,22
2021,Rochdale 019F,E01005515,685,172,67,105,468,32,145,45,71,29,83,23,49,11,201,158,43,7,7,45,19,26
2021,Rochdale 020A,E01005498,594,186,53,133,383,38,129,46,50,33,88,37,42,9,123,94,29,5,5,25,9,16
2021,Rochdale 020B,E01005500,648,177,72,105,431,42,210,88,68,54,94,40,50,4,81,50,31,4,4,40,21,19
2021,Rochdale 020C,E01005503,529,112,65,47,402,91,241,79,100,62,41,19,17,5,29,16,13,0,0,15,9,6
2021,Rochdale 020D,E01005506,650,221,98,123,397,58,179,56,81,42,69,19,41,9,88,61,27,3,3,32,13,19
2021,Rochdale 020E,E01005507,979,312,71,241,639,47,255,62,141,52,166,76,80,10,164,122,42,7,7,28,12,16
2021,Rochdale 020F,E01005508,785,172,106,66,572,100,298,92,148,58,110,46,56,8,61,34,27,3,3,41,25,16
2021,Rochdale 021A,E01005524,618,191,75,116,402,61,190,65,82,43,78,28,36,14,70,37,33,3,3,25,13,12
2021,Rochdale 021B,E01005525,858,345,109,236,472,35,166,54,82,30,101,47,48,6,159,122,37,11,11,41,25,16
2021,Rochdale 021C,E01005526,785,219,72,147,530,39,212,77,91,44,139,74,56,9,132,95,37,8,8,36,21,15
2021,Rochdale 021D,E01005528,671,209,79,130,432,50,164,50,68,46,91,34,48,9,123,77,46,4,4,30,7,23
2021,Rochdale 021E,E01005536,682,172,52,120,473,39,185,63,90,32,106,57,45,4,138,96,42,5,5,37,20,17
2021,Rochdale 021F,E01005543,514,142,72,70,352,54,160,61,57,42,71,25,40,6,64,37,27,3,3,20,8,12
2021,Rochdale 022A,E01005527,825,248,80,168,531,27,187,50,113,24,146,72,62,12,153,104,49,18,18,46,28,18
2021,Rochdale 022B,E01005529,744,286,119,167,427,43,117,41,55,21,91,24,58,9,166,105,61,10,10,31,17,14
2021,Rochdale 022C,E01005551,831,263,97,166,510,23,175,56,94,25,110,33,67,10,188,129,59,14,14,58,39,19
2021,Rochdale 022D,E01005552,892,258,120,138,573,30,189,46,120,23,111,30,71,10,226,175,51,17,17,61,41,20
2021,Rochdale 022E,E01005553,770,195,103,92,509,52,165,36,88,41,98,32,57,9,176,111,65,18,18,66,42,24
2021,Rochdale 022F,E01005554,882,233,77,156,593,55,296,99,154,43,142,70,62,10,91,58,33,9,9,56,37,19
2021,Rochdale 023A,E01005534,619,209,97,112,378,41,160,50,64,46,83,33,43,7,88,52,36,6,6,32,18,14
2021,Rochdale 023B,E01005535,652,226,55,171,395,48,155,53,60,42,79,28,39,12,108,78,30,5,5,31,14,17
2021,Rochdale 023C,E01005537,560,158,71,87,375,71,186,76,55,55,68,35,29,4,48,28,20,2,2,27,13,14
2021,Rochdale 023D,E01005538,566,135,63,72,400,19,133,32,72,29,97,33,50,14,148,101,47,3,3,31,15,16
2021,Rochdale 023E,E01005540,592,186,75,111,373,30,172,70,70,32,87,43,40,4,83,53,30,1,1,33,15,18
2021,Rochdale 023F,E01005541,691,226,55,171,435,26,152,64,55,33,116,57,50,9,138,90,48,3,3,30,13,17
2021,Rochdale 023G,E01005542,702,252,112,140,416,29,144,50,68,26,103,46,55,2,134,103,31,6,6,34,21,13
2021,Rochdale 024A,E01005533,804,330,138,192,435,45,158,60,64,34,110,67,34,9,119,82,37,3,3,39,23,16
2021,Rochdale 024B,E01005539,669,312,103,209,336,36,119,56,45,18,64,33,24,7,110,76,34,7,7,21,9,12
2021,Rochdale 024C,E01005546,624,272,122,150,328,53,144,66,48,30,69,34,33,2,60,42,18,2,2,24,11,13
2021,Rochdale 024D,E01005547,735,217,67,150,471,42,200,64,101,35,115,55,52,8,110,76,34,4,4,47,20,27
2021,Rochdale 024E,E01005548,620,293,118,175,304,30,123,47,57,19,61,30,25,6,85,58,27,5,5,23,7,16
2021,Rochdale 025A,E01005530,633,184,130,54,416,90,200,77,70,53,70,33,30,7,53,28,25,3,3,33,23,10
2021,Rochdale 025B,E01005531,522,182,71,111,312,32,131,49,57,25,70,28,34,8,77,49,28,2,2,28,15,13
2021,Rochdale 025C,E01005532,671,252,86,166,375,28,139,39,62,38,67,28,35,4,136,102,34,5,5,44,20,24
2021,Rochdale 025D,E01005544,587,141,87,54,425,77,238,63,131,44,65,28,33,4,44,21,23,1,1,21,12,9
2021,Rochdale 025E,E01005545,482,105,69,36,346,77,206,53,97,56,30,13,16,1,31,15,16,2,2,31,21,10
2021,Rochdale 025F,E01005549,590,110,64,46,450,99,268,77,122,69,52,14,28,10,31,15,16,0,0,30,18,12
2021,Rochdale 025G,E01005550,617,169,113,56,419,95,218,66,100,52,67,33,29,5,39,16,23,0,0,29,14,15
2021,Salford 001A,E01005659,629,181,66,115,414,36,124,42,49,33,106,38,54,14,139,91,48,9,9,34,15,19
2021,Salford 001B,E01005660,735,251,92,159,448,34,136,37,69,30,99,33,59,7,175,137,38,4,4,36,24,12
2021,Salford 001C,E01005663,670,240,64,176,393,31,145,51,66,28,98,43,40,15,105,80,25,14,14,37,21,16
2021,Salford 001D,E01005664,622,170,71,99,416,20,129,27,78,24,94,25,59,10,161,129,32,12,12,36,25,11
2021,Salford 001E,E01005665,813,253,111,142,500,21,117,20,65,32,95,26,56,13,246,185,61,21,21,60,44,16
2021,Salford 002A,E01005703,753,282,90,192,430,21,145,56,57,32,96,31,57,8,162,124,38,6,6,41,21,20
2021,Salford 002B,E01005704,589,188,69,119,371,50,146,58,52,36,76,31,37,8,93,62,31,6,6,30,15,15
2021,Salford 002C,E01005706,659,225,66,159,392,41,131,42,60,29,81,30,45,6,133,88,45,6,6,42,18,24
2021,Salford 002D,E01005708,723,328,146,182,368,45,134,56,52,26,95,47,41,7,88,62,26,6,6,27,11,16
2021,Salford 003A,E01005702,1145,374,141,233,704,57,265,94,121,50,207,116,77,14,170,106,64,5,5,67,47,20
2021,Salford 003C,E01005707,768,278,90,188,454,31,156,49,77,30,107,40,58,9,154,104,50,6,6,36,20,16
2021,Salford 003D,E01033976,807,181,36,145,600,27,271,95,147,29,210,129,74,7,86,63,23,6,6,26,15,11
2021,Salford 003E,E01033977,538,210,73,137,302,34,108,39,42,27,81,43,30,8,76,48,28,3,3,26,8,18
2021,Salford 004A,E01005661,756,219,60,159,510,38,191,60,93,38,120,49,60,11,151,108,43,10,10,27,21,6
2021,Salford 004B,E01005662,634,178,71,107,422,29,125,36,61,28,77,17,47,13,187,149,38,4,4,34,24,10
2021,Salford 004C,E01005709,629,196,89,107,401,38,138,38,70,30,82,16,53,13,135,99,36,8,8,32,25,7
2021,Salford 004D,E01005710,839,147,66,81,649,90,316,103,156,57,127,73,48,6,112,59,53,4,4,43,21,22
2021,Salford 005A,E01005670,817,325,158,167,462,40,181,56,88,37,101,51,40,10,133,99,34,7,7,30,10,20
2021,Salford 005B,E01005672,611,215,62,153,360,29,157,78,50,29,96,57,39,0,71,51,20,7,7,36,14,22
2021,Salford 005C,E01005676,550,154,79,75,383,92,208,90,71,47,49,24,18,7,34,14,20,0,0,13,4,9
2021,Salford 005D,E01005677,682,218,82,136,430,67,194,65,75,54,84,38,37,9,76,47,29,9,9,34,16,18
2021,Salford 006A,E01005686,636,211,79,132,383,39,143,49,55,39,98,39,52,7,97,60,37,6,6,42,18,24
2021,Salford 006B,E01005688,652,169,84,85,451,72,181,50,87,44,88,31,47,10,107,70,37,3,3,32,14,18
2021,Salford 006C,E01005691,667,226,127,99,414,106,189,75,57,57,66,34,26,6,53,26,27,0,0,27,15,12
2021,Salford 006D,E01005692,734,375,119,256,335,38,98,30,40,28,92,46,42,4,99,71,28,8,8,24,9,15
2021,Salford 007A,E01005711,628,196,76,120,404,80,174,60,78,36,94,57,28,9,54,34,20,2,2,28,14,14
2021,Salford 007B,E01005712,840,323,94,229,475,40,172,54,77,41,150,92,54,4,105,68,37,8,8,42,24,18
2021,Salford 007C,E01005713,705,161,107,54,523,118,247,98,103,46,106,59,41,6,50,32,18,2,2,21,11,10
2021,Salford 007D,E01005714,699,183,83,100,488,50,188,50,96,42,120,59,46,15,119,80,39,11,11,28,12,16
2021,Salford 007E,E01005715,757,213,101,112,511,88,248,77,125,46,113,62,47,4,57,27,30,5,5,33,13,20
2021,Salford 007F,E01005718,792,325,116,209,434,67,182,79,66,37,99,52,45,2,84,46,38,2,2,33,9,24
2021,Salford 008A,E01005673,659,209,56,153,410,43,162,55,69,38,90,45,38,7,109,73,36,6,6,40,12,28
2021,Salford 008C,E01005678,650,168,55,113,441,30,141,53,57,31,84,36,38,10,180,134,46,6,6,41,13,28
2021,Salford 008D,E01005679,665,210,65,145,415,25,125,34,64,27,92,40,50,2,166,130,36,7,7,40,18,22
2021,Salford 008E,E01033978,405,103,23,80,272,16,131,39,68,24,72,38,32,2,48,38,10,5,5,30,16,14
2021,Salford 008F,E01033979,469,124,28,96,312,17,106,27,58,21,114,60,50,4,72,51,21,3,3,33,20,13
2021,Salford 009A,E01005687,809,266,106,160,501,36,219,76,105,38,146,91,50,5,96,66,30,4,4,42,14,28
2021,Salford 009B,E01005689,526,148,62,86,352,13,143,34,74,35,73,25,39,9,120,91,29,3,3,26,13,13
2021,Salford 009C,E01005690,691,204,80,124,438,56,194,73,74,47,105,64,37,4,82,38,44,1,1,49,10,39
2021,Salford 009D,E01005693,634,194,96,98,409,48,165,55,71,39,104,48,50,6,91,57,34,1,1,31,15,16
2021,Salford 010A,E01005646,550,151,81,70,319,47,213,47,151,15,27,17,8,2,29,22,7,3,3,80,61,19
2021,Salford 010B,E01005649,643,219,97,122,397,83,259,69,175,15,19,16,3,0,35,21,14,1,1,27,11,16
2021,Salford 010C,E01005650,629,274,87,187,324,22,216,35,160,21,37,17,18,2,48,39,9,1,1,31,12,19
2021,Salford 010D,E01005651,555,97,39,58,414,31,307,51,217,39,27,11,14,2,44,23,21,5,5,44,23,21
2021,Salford 011A,E01005647,626,279,110,169,324,49,201,59,120,22,34,26,7,1,38,24,14,2,2,23,5,18
2021,Salford 011B,E01005648,1024,369,90,279,597,53,325,113,179,33,113,76,31,6,89,59,30,17,17,58,30,28
2021,Salford 011C,E01005652,565,138,45,93,380,26,166,40,94,32,80,30,39,11,106,60,46,2,2,47,33,14
2021,Salford 011D,E01005653,592,159,54,105,364,20,130,34,70,26,69,32,28,9,127,81,46,18,18,69,27,42
2021,Salford 012A,E01005671,756,315,118,197,393,39,150,48,79,23,87,49,33,5,112,68,44,5,5,48,19,29
2021,Salford 012B,E01005674,624,184,72,112,400,32,174,48,87,39,88,43,37,8,101,58,43,5,5,40,19,21
2021,Salford 012C,E01005694,686,155,61,94,504,57,247,78,106,63,109,45,56,8,90,49,41,1,1,27,16,11
2021,Salford 012D,E01005696,714,156,68,88,528,53,235,97,106,32,128,63,61,4,109,75,34,3,3,30,19,11
2021,Salford 012E,E01005698,782,304,134,170,427,33,149,40,78,31,86,39,42,5,155,109,46,4,4,51,24,27
2021,Salford 012F,E01005700,656,190,77,113,432,45,178,63,70,45,90,57,29,4,113,70,43,6,6,34,13,21
2021,Salford 013A,E01005716,671,133,70,63,516,105,270,98,100,72,85,42,37,6,55,36,19,1,1,22,7,15
2021,Salford 013B,E01005717,561,77,34,43,464,49,311,85,166,60,49,23,24,2,50,35,15,5,5,20,7,13
2021,Salford 013C,E01005734,625,213,103,110,388,52,166,49,79,38,83,43,30,10,82,52,30,5,5,24,11,13
2021,Salford 013D,E01005735,597,144,94,50,437,95,229,70,109,50,63,24,34,5,49,26,23,1,1,16,7,9
2021,Salford 013E,E01005736,624,189,112,77,420,88,178,59,83,36,95,53,34,8,56,40,16,3,3,15,6,9
2021,Salford 013F,E01005737,589,104,66,38,452,108,255,76,117,62,64,36,26,2,25,10,15,0,0,33,15,18
2021,Salford 013G,E01005739,786,172,79,93,579,62,329,97,189,43,118,65,45,8,65,38,27,5,5,35,16,19
2021,Salford 014A,E01005695,628,145,84,61,462,75,263,78,138,47,77,33,40,4,44,24,20,3,3,21,8,13
2021,Salford 014B,E01005697,649,180,97,83,448,80,234,78,115,41,78,34,41,3,54,35,19,2,2,21,9,12
2021,Salford 014C,E01005738,824,229,129,100,568,108,288,95,134,59,119,80,36,3,51,31,20,2,2,27,14,13
2021,Salford 014D,E01005740,699,219,119,100,464,102,249,82,147,20,67,32,29,6,44,26,18,2,2,16,9,7
2021,Salford 014E,E01005741,684,178,119,59,489,88,303,94,159,50,65,27,33,5,32,18,14,1,1,17,8,9
2021,Salford 014F,E01005742,665,193,90,103,448,71,219,52,124,43,87,48,32,7,67,42,25,4,4,24,9,15
2021,Salford 015A,E01005625,605,182,89,93,392,54,178,53,76,49,95,63,28,4,62,37,25,3,3,31,13,18
2021,Salford 015B,E01005627,473,120,69,51,318,50,156,49,65,42,68,30,31,7,40,19,21,4,4,35,16,19
2021,Salford 015C,E01005699,755,215,95,120,518,80,250,72,113,65,112,55,57,0,76,49,27,0,0,22,14,8
2021,Salford 015D,E01005701,713,164,87,77,508,89,267,73,133,61,90,46,39,5,60,29,31,2,2,41,9,32
2021,Salford 017A,E01005624,719,210,72,138,449,34,157,57,79,21,96,35,51,10,151,103,48,11,11,60,36,24
2021,Salford 017B,E01005680,794,380,68,312,360,14,115,36,51,28,75,45,24,6,144,92,52,12,12,54,20,34
2021,Salford 017C,E01005683,890,285,101,184,528,17,154,52,73,29,101,50,47,4,247,190,57,9,9,77,22,55
2021,Salford 017G,E01033980,428,119,19,100,228,2,74,23,45,6,78,51,21,6,68,55,13,6,6,81,11,70
2021,Salford 017H,E01033981,737,210,60,150,295,19,83,31,39,13,73,45,19,9,101,64,37,19,19,232,23,209
2021,Salford 018A,E01005622,665,205,92,113,385,19,132,46,62,24,140,79,55,6,85,57,28,9,9,75,12,63
2021,Salford 018B,E01005623,493,111,55,56,320,44,153,47,65,41,77,37,33,7,43,28,15,3,3,62,26,36
2021,Salford 018C,E01005626,517,126,69,57,363,49,193,66,72,55,69,32,31,6,46,19,27,6,6,28,14,14
2021,Salford 018D,E01005628,663,219,71,148,338,52,144,58,57,29,80,52,24,4,53,24,29,9,9,106,17,89
2021,Salford 019A,E01005725,559,177,63,114,337,30,109,23,57,29,78,24,43,11,115,69,46,5,5,45,25,20
2021,Salford 019B,E01005726,617,197,65,132,377,33,159,59,66,34,103,48,42,13,74,52,22,8,8,43,17,26
2021,Salford 019C,E01005727,649,249,54,195,372,23,153,71,56,26,116,88,25,3,71,45,26,9,9,28,8,20
2021,Salford 019D,E01005728,763,207,93,114,512,61,227,68,113,46,133,77,52,4,89,53,36,2,2,44,13,31
2021,Salford 019E,E01005733,497,116,53,63,323,25,117,37,61,19,80,40,32,8,99,63,36,2,2,58,42,16
2021,Salford 020A,E01005631,1041,723,277,446,277,26,88,37,40,11,77,53,19,5,69,36,33,17,17,41,7,34
2021,Salford 020B,E01005632,1114,445,123,322,576,38,238,62,144,32,202,160,37,5,89,66,23,9,9,93,27,66
2021,Salford 020C,E01005633,607,188,77,111,371,34,162,37,75,50,73,30,30,13,97,57,40,5,5,48,19,29
2021,Salford 020D,E01005634,665,169,78,91,471,69,248,76,128,44,113,63,44,6,39,19,20,2,2,25,10,15
2021,Salford 020E,E01005635,679,270,76,194,359,47,177,58,82,37,88,61,24,3,42,19,23,5,5,50,19,31
2021,Salford 020F,E01005636,701,244,104,140,402,73,204,54,99,51,89,65,19,5,32,12,20,4,4,55,15,40
2021,Salford 020G,E01005637,659,209,98,111,399,39,164,56,81,27,126,87,36,3,65,34,31,5,5,51,9,42
2021,Salford 021A,E01005629,673,235,128,107,385,36,190,64,94,32,83,56,23,4,70,35,35,6,6,53,16,37
2021,Salford 021B,E01005630,649,211,82,129,387,31,157,46,85,26,107,62,37,8,89,48,41,3,3,51,17,34
2021,Salford 021C,E01005719,1013,431,133,298,457,34,171,67,80,24,134,110,21,3,99,64,35,19,19,125,21,104
2021,Salford 021E,E01005722,796,226,88,138,490,21,182,51,94,37,154,91,50,13,120,76,44,13,13,80,32,48
2021,Salford 021F,E01005723,655,197,84,113,383,17,146,35,77,34,100,60,30,10,114,74,40,6,6,75,24,51
2021,Salford 021G,E01005724,637,229,121,108,381,62,205,70,85,50,74,44,26,4,36,14,22,4,4,27,7,20
2021,Salford 021H,E01033982,760,232,84,148,447,29,140,46,69,25,99,56,40,3,168,123,45,11,11,81,21,60
2021,Salford 021I,E01033983,641,263,19,244,311,7,74,36,32,6,142,120,20,2,76,58,18,12,12,67,12,55
2021,Salford 023A,E01005654,925,328,56,272,460,11,139,47,76,16,157,134,20,3,133,94,39,20,20,137,28,109
2021,Salford 023B,E01005656,713,229,65,164,360,23,88,34,30,24,114,71,37,6,127,96,31,8,8,124,38,86
2021,Salford 023C,E01005657,753,267,123,144,390,29,134,52,47,35,111,50,56,5,102,53,49,14,14,96,20,76
2021,Salford 023D,E01005721,785,359,126,233,377,53,140,63,46,31,83,56,18,9,95,54,41,6,6,49,12,37
2021,Salford 024C,E01005681,551,269,109,160,232,27,60,22,23,15,45,29,13,3,89,65,24,11,11,50,8,42
2021,Salford 024D,E01005682,1000,599,145,454,354,12,137,36,93,8,74,41,24,9,113,78,35,18,18,47,25,22
2021,Salford 024E,E01033984,997,300,81,219,593,21,193,48,113,32,150,86,51,13,215,141,74,14,14,104,39,65
2021,Salford 025A,E01005729,777,386,96,290,339,13,79,27,37,15,73,28,35,10,166,106,60,8,8,52,36,16
2021,Salford 025B,E01005730,731,230,71,159,461,43,192,63,89,40,111,57,47,7,111,81,30,4,4,40,18,22
2021,Salford 025C,E01005731,587,157,67,90,384,22,147,36,78,33,79,25,42,12,123,86,37,13,13,46,22,24
2021,Salford 025D,E01005732,544,199,63,136,301,32,116,46,43,27,73,31,36,6,75,41,34,5,5,44,21,23
2021,Salford 026A,E01005599,871,336,86,250,472,24,170,57,80,33,115,78,34,3,121,80,41,42,42,63,19,44
2021,Salford 026B,E01005600,889,274,47,227,541,25,205,76,103,26,196,133,52,11,107,87,20,8,8,74,24,50
2021,Salford 026C,E01005601,680,206,53,153,437,29,165,43,88,34,95,35,52,8,141,93,48,7,7,37,15,22
2021,Salford 026D,E01005602,890,439,121,318,407,17,130,50,63,17,100,50,45,5,149,110,39,11,11,44,15,29
2021,Salford 027A,E01005603,750,209,48,161,480,18,168,49,91,28,129,68,50,11,157,118,39,8,8,61,21,40
2021,Salford 027B,E01005604,727,243,104,139,436,40,179,62,81,36,105,42,53,10,104,66,38,8,8,48,15,33
2021,Salford 027C,E01005605,735,248,74,174,436,29,149,51,67,31,113,53,54,6,139,87,52,6,6,51,15,36
2021,Salford 027D,E01005638,974,378,69,309,504,16,166,66,70,30,177,112,58,7,135,96,39,10,10,92,26,66
2021,Salford 029A,E01005639,568,153,57,96,384,16,96,26,52,18,81,22,55,4,188,149,39,3,3,31,15,16
2021,Salford 029B,E01005640,527,134,57,77,350,27,128,41,59,28,81,20,51,10,111,68,43,3,3,43,19,24
2021,Salford 029C,E01005641,619,230,133,97,359,51,116,35,47,34,86,39,40,7,105,60,45,1,1,30,15,15
2021,Salford 029D,E01005642,504,121,44,77,356,56,168,62,64,42,68,31,34,3,62,51,11,2,2,27,15,12
2021,Salford 029E,E01005643,666,259,148,111,383,101,156,63,47,46,72,38,31,3,49,28,21,5,5,24,8,16
2021,Salford 029F,E01005644,610,151,55,96,435,46,210,58,94,58,102,48,44,10,73,43,30,4,4,24,12,12
2021,Salford 029G,E01005645,591,164,105,59,402,99,213,75,76,62,55,19,30,6,34,14,20,1,1,25,7,18
2021,Salford 030A,E01005616,609,204,96,108,374,51,145,43,64,38,73,23,42,8,103,61,42,2,2,31,16,15
2021,Salford 030B,E01005617,605,152,66,86,424,57,188,69,84,35,91,35,46,10,87,49,38,1,1,29,13,16
2021,Salford 030C,E01005618,916,287,113,174,597,46,239,77,120,42,143,72,62,9,161,117,44,8,8,32,14,18
2021,Salford 030D,E01005619,513,148,67,81,337,46,145,52,57,36,72,25,39,8,68,36,32,6,6,28,16,12
2021,Salford 030E,E01005620,1047,293,82,211,710,68,335,86,187,62,161,86,63,12,142,97,45,4,4,44,23,21
2021,Salford 030F,E01005621,790,317,117,200,433,49,148,52,65,31,125,52,65,8,108,79,29,3,3,40,20,20
2021,Salford 031B,E01005612,1051,548,150,398,463,25,235,58,156,21,65,26,33,6,119,76,43,19,19,40,22,18
2021,Salford 031A,E01005613,997,407,62,345,504,25,252,51,176,25,56,18,30,8,152,101,51,19,19,86,37,49
2021,Salford 031C,E01005614,619,98,30,68,489,22,373,35,318,20,26,9,17,0,62,46,16,6,6,32,21,11
2021,Salford 032C,E01005611,1050,386,96,290,487,32,173,59,88,26,103,59,35,9,157,105,52,22,22,177,41,136
2021,Salford 032D,E01005615,685,187,65,122,395,20,213,28,164,21,66,35,24,7,76,52,24,20,20,103,38,65
2021,Salford 032A,E01033985,677,225,44,181,364,11,125,34,72,19,94,53,33,8,117,74,43,17,17,88,21,67
2021,Salford 032B,E01033986,661,226,20,206,338,7,157,51,98,8,113,89,21,3,50,37,13,11,11,97,21,76
2021,Salford 033F,E01032909,1043,466,8,458,350,0,78,55,21,2,223,217,6,0,8,4,4,41,41,227,2,225
2021,Salford 033E,E01033330,824,491,100,391,277,6,118,47,52,19,67,44,18,5,72,38,34,14,14,56,9,47
2021,Salford 033A,E01033987,581,164,6,158,284,2,66,40,23,3,165,156,9,0,27,17,10,24,24,133,3,130
2021,Salford 033B,E01033988,843,415,2,413,282,1,38,28,10,0,178,175,3,0,39,37,2,26,26,146,0,146
2021,Salford 033C,E01033989,675,315,11,304,253,3,65,42,18,5,145,141,4,0,15,11,4,25,25,107,3,104
2021,Salford 033D,E01033990,670,229,4,225,262,1,41,29,12,0,144,140,3,1,11,6,5,65,65,179,4,175
2021,Salford 034C,E01005610,478,122,41,81,278,11,85,21,54,10,64,26,31,7,108,76,32,10,10,78,19,59
2021,Salford 034D,E01032684,630,244,37,207,288,5,104,39,56,9,106,82,21,3,67,49,18,6,6,98,8,90
2021,Salford 034E,E01032906,1138,553,33,520,405,1,115,65,42,8,217,206,9,2,49,33,16,23,23,180,11,169
2021,Salford 034A,E01033991,791,318,41,277,362,4,123,36,50,37,149,119,26,4,65,47,18,21,21,111,7,104
2021,Salford 034B,E01033992,754,270,1,269,312,0,78,39,38,1,207,203,4,0,10,7,3,17,17,172,1,171
2021,Salford 035C,E01005667,1032,386,90,296,499,33,146,42,70,34,137,91,35,11,165,104,61,18,18,147,33,114
2021,Salford 035B,E01032912,977,373,101,272,495,35,122,29,69,24,131,86,41,4,187,148,39,20,20,109,29,80
2021,Salford 035A,E01032914,1145,493,18,475,492,2,138,70,61,7,259,197,61,1,66,51,15,27,27,160,14,146
2021,Salford 036C,E01032915,945,315,73,242,456,19,170,46,65,59,140,108,28,4,113,75,38,14,14,174,29,145
2021,Salford 036A,E01033993,891,237,29,208,336,7,69,34,32,3,169,154,14,1,48,35,13,43,43,318,7,311
2021,Salford 036B,E01033994,637,204,3,201,215,1,35,23,10,2,151,148,3,0,6,2,4,22,22,218,0,218
2021,Salford 037A,E01033995,716,318,9,309,295,2,100,67,29,4,152,148,3,1,13,5,8,28,28,103,3,100
2021,Salford 037B,E01033996,704,312,12,300,319,16,110,71,34,5,158,147,11,0,13,5,8,22,22,73,4,69
2021,Salford 037C,E01033997,624,317,17,300,211,3,71,33,36,2,119,114,5,0,9,4,5,9,9,96,3,93
2021,Salford 037D,E01033998,748,285,15,270,330,11,90,60,25,5,195,191,4,0,19,10,9,15,15,133,2,131
2021,Salford 037E,E01033999,668,226,9,217,296,3,98,43,54,1,162,153,9,0,10,3,7,23,23,146,5,141
2021,Stockport 001A,E01005886,682,253,52,201,401,30,147,48,59,40,97,50,41,6,121,77,44,6,6,28,10,18
2021,Stockport 001B,E01005888,592,145,62,83,408,37,193,57,83,53,75,33,34,8,97,66,31,6,6,39,24,15
2021,Stockport 001C,E01005889,674,253,107,146,385,49,150,59,58,33,77,43,31,3,103,68,35,6,6,36,14,22
2021,Stockport 001D,E01005891,573,191,98,93,355,88,162,69,54,39,59,30,26,3,41,20,21,5,5,27,14,13
2021,Stockport 001E,E01005894,567,145,73,72,395,43,158,54,66,38,107,46,51,10,82,46,36,5,5,27,13,14
2021,Stockport 002A,E01005887,659,176,57,119,449,26,182,53,91,38,91,34,48,9,146,111,35,4,4,34,16,18
2021,Stockport 002B,E01005890,588,149,58,91,397,35,162,53,79,30,84,35,37,12,110,72,38,6,6,42,28,14
2021,Stockport 002C,E01005893,1095,428,86,342,626,43,182,64,81,37,264,193,63,8,127,87,40,10,10,41,15,26
2021,Stockport 002D,E01005896,783,273,62,211,465,37,157,71,60,26,116,60,47,9,149,111,38,6,6,45,11,34
2021,Stockport 002E,E01005919,701,283,79,204,379,20,128,49,58,21,89,46,35,8,136,94,42,6,6,39,21,18
2021,Stockport 003A,E01005862,593,139,69,70,439,50,272,80,135,57,68,37,26,5,47,24,23,2,2,15,8,7
2021,Stockport 003B,E01005892,551,156,56,100,366,49,144,45,69,30,88,51,33,4,82,45,37,3,3,29,10,19
2021,Stockport 003C,E01005895,485,145,75,70,313,35,133,49,53,31,56,19,32,5,86,52,34,3,3,27,15,12
2021,Stockport 003D,E01005920,631,132,72,60,460,53,256,84,114,58,95,52,38,5,54,30,24,2,2,39,14,25
2021,Stockport 003E,E01005921,713,280,83,197,398,29,148,61,57,30,100,59,38,3,113,76,37,8,8,35,10,25
2021,Stockport 003F,E01005922,615,201,78,123,391,79,161,66,61,34,94,53,33,8,54,23,31,3,3,23,7,16
2021,Stockport 004A,E01005753,688,195,83,112,449,26,134,36,55,43,90,34,49,7,191,138,53,8,8,44,25,19
2021,Stockport 004B,E01005754,1037,545,97,448,451,18,108,37,38,33,108,48,51,9,207,158,49,10,10,41,16,25
2021,Stockport 004C,E01005755,720,243,61,182,443,22,149,37,64,48,101,34,60,7,169,129,40,2,2,34,14,20
2021,Stockport 004D,E01005756,1039,382,50,332,616,18,187,71,99,17,194,104,80,10,211,161,50,6,6,41,24,17
2021,Stockport 005A,E01005745,600,167,69,98,402,68,194,74,80,40,75,34,32,9,60,34,26,5,5,31,7,24
2021,Stockport 005B,E01005746,783,427,177,250,338,76,134,58,51,25,66,31,27,8,60,33,27,2,2,18,8,10
2021,Stockport 005C,E01005747,589,152,69,83,419,69,230,68,112,50,75,45,30,0,44,17,27,1,1,18,9,9
2021,Stockport 005D,E01005748,661,182,115,67,454,120,241,81,99,61,69,34,30,5,23,11,12,1,1,25,8,17
2021,Stockport 006A,E01005863,768,279,150,129,447,56,271,93,142,36,89,60,25,4,30,13,17,1,1,42,14,28
2021,Stockport 006B,E01005864,641,199,61,138,409,41,241,74,132,35,93,57,30,6,29,12,17,5,5,33,8,25
2021,Stockport 006C,E01005866,797,344,90,254,404,33,209,76,106,27,108,72,30,6,45,23,22,9,9,49,17,32
2021,Stockport 006D,E01005869,656,187,115,72,431,69,230,67,118,45,77,37,32,8,52,26,26,3,3,38,15,23
2021,Stockport 007A,E01005914,672,248,84,164,403,54,171,61,75,35,98,44,46,8,76,38,38,4,4,21,11,10
2021,Stockport 007B,E01005915,715,257,74,183,421,30,154,55,64,35,120,70,39,11,109,67,42,8,8,37,23,14
2021,Stockport 007C,E01005916,727,240,63,177,448,44,179,59,83,37,119,78,36,5,88,59,29,18,18,39,15,24
2021,Stockport 007D,E01005917,901,369,84,285,483,22,145,62,63,20,154,113,32,9,141,103,38,21,21,49,19,30
2021,Stockport 008A,E01005859,631,230,74,156,376,34,223,70,118,35,81,60,16,5,31,20,11,7,7,25,10,15
2021,Stockport 008B,E01005865,773,179,73,106,560,91,334,87,197,50,74,46,28,0,59,38,21,2,2,34,15,19
2021,Stockport 008C,E01005867,644,220,111,109,403,78,222,61,133,28,67,39,27,1,34,20,14,2,2,21,8,13
2021,Stockport 008D,E01005868,608,184,114,70,389,74,207,51,124,32,55,22,27,6,50,21,29,3,3,35,20,15
2021,Stockport 009A,E01005743,567,168,96,72,373,70,184,70,59,55,65,28,32,5,54,25,29,0,0,26,8,18
2021,Stockport 009B,E01005744,653,224,96,128,399,43,152,51,63,38,96,44,47,5,104,66,38,4,4,30,13,17
2021,Stockport 009C,E01005749,733,211,100,111,498,79,221,68,107,46,104,52,42,10,87,49,38,7,7,24,8,16
2021,Stockport 009D,E01005750,698,178,77,101,497,53,244,86,100,58,123,64,54,5,73,46,27,4,4,23,10,13
2021,Stockport 009E,E01005751,615,189,75,114,400,46,165,58,74,33,120,58,52,10,68,40,28,1,1,26,13,13
2021,Stockport 010A,E01005897,597,155,82,73,414,51,173,45,95,33,92,48,39,5,98,55,43,0,0,28,16,12
2021,Stockport 010B,E01005898,737,218,126,92,486,93,230,72,102,56,88,37,40,11,72,42,30,3,3,33,13,20
2021,Stockport 010C,E01005900,789,308,158,150,460,90,183,70,73,40,90,44,35,11,94,70,24,3,3,21,8,13
2021,Stockport 010D,E01005903,632,144,92,52,463,127,242,95,84,63,52,30,17,5,40,15,25,2,2,25,7,18
2021,Stockport 010E,E01005904,670,222,148,74,426,87,232,65,130,37,65,30,32,3,41,22,19,1,1,22,6,16
2021,Stockport 011A,E01005853,670,212,87,125,426,30,217,65,109,43,77,38,30,9,99,56,43,3,3,32,20,12
2021,Stockport 011B,E01005856,653,177,80,97,445,57,241,63,136,42,68,37,28,3,72,41,31,7,7,31,15,16
2021,Stockport 011C,E01005860,589,115,60,55,453,58,266,76,153,37,70,38,27,5,49,32,17,10,10,21,10,11
2021,Stockport 011D,E01005861,712,274,134,140,414,57,236,79,122,35,66,30,32,4,54,28,26,1,1,24,11,13
2021,Stockport 012A,E01005752,630,230,108,122,381,48,144,36,69,39,76,33,35,8,110,73,37,3,3,19,11,8
2021,Stockport 012B,E01005899,751,298,188,110,423,109,190,60,96,34,65,40,23,2,57,39,18,2,2,30,12,18
2021,Stockport 012C,E01005901,627,182,127,55,427,121,195,69,66,60,67,37,29,1,42,14,28,2,2,18,6,12
2021,Stockport 012D,E01005902,739,256,129,127,461,59,168,69,64,35,89,40,35,14,143,107,36,2,2,22,9,13
2021,Stockport 012E,E01005905,599,197,60,137,376,29,116,36,59,21,95,37,51,7,133,102,31,3,3,26,11,15
2021,Stockport 013A,E01005852,684,237,98,139,412,57,200,74,81,45,104,69,32,3,49,29,20,2,2,35,15,20
2021,Stockport 013B,E01005854,721,211,112,99,491,55,272,60,166,46,115,66,42,7,48,28,20,1,1,19,11,8
2021,Stockport 013C,E01005855,583,163,95,68,397,56,270,81,143,46,42,16,25,1,27,11,16,2,2,23,12,11
2021,Stockport 013D,E01005857,619,188,106,82,378,60,224,53,127,44,40,23,15,2,51,29,22,3,3,53,39,14
2021,Stockport 013E,E01005858,787,316,123,193,450,60,222,81,97,44,106,83,21,2,56,28,28,6,6,21,6,15
2021,Stockport 014A,E01005757,724,235,60,175,453,29,189,103,62,24,108,59,46,3,123,81,42,4,4,36,15,21
2021,Stockport 014C,E01005766,800,323,93,230,405,24,134,47,68,19,110,62,42,6,131,103,28,6,6,72,20,52
2021,Stockport 014D,E01005918,833,472,107,365,330,23,86,33,43,10,57,29,25,3,159,120,39,5,5,31,11,20
2021,Stockport 014E,E01033947,858,434,69,365,377,14,109,50,46,13,124,89,29,6,121,74,47,9,9,47,7,40
2021,Stockport 014F,E01033948,864,542,121,421,297,12,60,37,20,3,84,63,18,3,132,100,32,9,9,25,10,15
2021,Stockport 015A,E01005870,607,185,70,115,398,34,163,54,71,38,105,57,44,4,93,66,27,3,3,24,12,12
2021,Stockport 015B,E01005871,622,198,65,133,389,40,134,55,60,19,108,42,56,10,101,67,34,6,6,35,12,23
2021,Stockport 015C,E01005873,582,143,70,73,418,46,210,62,94,54,89,36,46,7,69,35,34,4,4,21,8,13
2021,Stockport 015D,E01005875,653,162,80,82,463,59,226,79,105,42,100,49,42,9,77,45,32,1,1,28,13,15
2021,Stockport 016A,E01005764,777,272,97,175,481,28,159,70,65,24,146,88,50,8,136,94,42,12,12,24,6,18
2021,Stockport 016B,E01005816,709,222,62,160,438,17,171,75,74,22,139,85,47,7,106,77,29,5,5,49,15,34
2021,Stockport 016C,E01005817,661,238,65,173,387,24,158,60,79,19,115,81,31,3,84,51,33,6,6,36,9,27
2021,Stockport 016D,E01005822,1036,506,103,403,459,14,120,53,49,18,133,92,36,5,174,113,61,18,18,71,27,44
2021,Stockport 017A,E01005880,658,185,96,89,460,88,251,98,115,38,74,44,28,2,44,21,23,3,3,13,9,4
2021,Stockport 017B,E01005881,494,91,63,28,388,117,214,79,97,38,40,15,23,2,15,8,7,2,2,15,7,8
2021,Stockport 017C,E01005883,666,160,109,51,484,161,244,84,127,33,41,23,15,3,38,16,22,0,0,22,6,16
2021,Stockport 017D,E01005908,639,123,86,37,491,102,303,98,147,58,54,30,24,0,32,17,15,0,0,25,13,12
2021,Stockport 018A,E01005765,568,131,53,78,414,51,215,73,91,51,91,43,44,4,52,32,20,5,5,23,9,14
2021,Stockport 018B,E01005818,551,129,41,88,393,23,172,52,85,35,100,51,43,6,95,68,27,3,3,29,16,13
2021,Stockport 018C,E01005819,653,156,75,81,474,56,265,94,119,52,105,55,46,4,43,22,21,5,5,23,5,18
2021,Stockport 018D,E01005820,645,214,81,133,399,26,192,73,89,30,110,71,35,4,66,52,14,5,5,32,18,14
2021,Stockport 018E,E01005821,665,249,76,173,392,35,165,55,77,33,107,59,42,6,81,45,36,4,4,24,9,15
2021,Stockport 018F,E01005823,706,235,69,166,432,29,186,59,102,25,108,54,46,8,106,73,33,3,3,39,16,23
2021,Stockport 019A,E01005825,760,242,72,170,478,51,204,67,96,41,92,55,33,4,128,106,22,3,3,40,21,19
2021,Stockport 019B,E01005872,800,306,83,223,453,49,168,66,72,30,139,81,54,4,93,54,39,4,4,41,15,26
2021,Stockport 019C,E01005874,1041,536,138,398,462,28,154,68,59,27,120,70,44,6,149,112,37,11,11,43,14,29
2021,Stockport 019D,E01005876,606,127,59,68,447,53,213,78,87,48,104,56,40,8,74,39,35,3,3,32,18,14
2021,Stockport 019E,E01005877,767,233,91,142,509,51,219,68,102,49,88,49,33,6,149,117,32,2,2,25,6,19
2021,Stockport 020A,E01005878,737,224,122,102,486,59,217,58,109,50,92,39,49,4,114,82,32,4,4,27,15,12
2021,Stockport 020B,E01005879,587,184,96,88,382,54,179,61,90,28,74,36,35,3,74,50,24,1,1,21,7,14
2021,Stockport 020C,E01005882,497,101,79,22,379,113,211,62,96,53,30,10,17,3,24,16,8,1,1,17,6,11
2021,Stockport 020D,E01005884,591,127,95,32,442,112,240,82,102,56,49,26,17,6,39,20,19,2,2,22,5,17
2021,Stockport 020E,E01005885,690,263,152,111,410,67,169,40,96,33,90,65,25,0,78,45,33,6,6,17,8,9
2021,Stockport 021A,E01005832,637,205,103,102,411,69,200,73,78,49,72,31,34,7,70,37,33,0,0,21,8,13
2021,Stockport 021B,E01005833,464,162,89,73,278,55,132,51,59,22,43,17,19,7,43,29,14,5,5,24,9,15
2021,Stockport 021C,E01005835,578,151,87,64,406,86,236,87,87,62,58,32,21,5,26,11,15,0,0,21,12,9
2021,Stockport 021D,E01005837,662,191,83,108,452,58,225,80,105,40,108,53,50,5,58,38,20,3,3,19,9,10
2021,Stockport 021E,E01005843,594,137,84,53,432,91,229,74,101,54,65,31,26,8,46,31,15,1,1,25,14,11
2021,Stockport 022A,E01005769,785,316,117,199,429,56,149,68,62,19,156,129,26,1,64,37,27,4,4,40,11,29
2021,Stockport 022B,E01005778,602,166,67,99,414,52,197,66,90,41,104,63,34,7,58,32,26,3,3,22,9,13
2021,Stockport 022C,E01005779,592,148,86,62,414,36,233,66,113,54,76,36,33,7,66,44,22,3,3,30,16,14
2021,Stockport 022D,E01005780,569,113,45,68,431,34,247,71,129,47,89,38,45,6,55,32,23,6,6,25,13,12
2021,Stockport 022E,E01005781,905,493,161,332,392,28,137,46,62,29,83,41,40,2,139,93,46,5,5,20,5,15
2021,Stockport 023A,E01005759,726,203,65,138,494,41,207,68,98,41,123,62,57,4,112,71,41,11,11,29,10,19
2021,Stockport 023B,E01005760,876,322,83,239,516,26,193,60,103,30,154,90,63,1,134,102,32,9,9,38,14,24
2021,Stockport 023C,E01005797,676,239,57,182,411,15,146,49,74,23,123,83,30,10,124,96,28,3,3,26,4,22
2021,Stockport 023D,E01005800,685,192,104,88,472,63,254,76,133,45,96,56,33,7,57,26,31,2,2,21,7,14
2021,Stockport 023E,E01005804,464,150,53,97,294,23,141,45,73,23,60,37,21,2,67,46,21,3,3,20,7,13
2021,Stockport 024A,E01005824,617,169,103,66,414,60,210,60,105,45,82,40,37,5,55,27,28,7,7,34,18,16
2021,Stockport 024B,E01005826,633,200,92,108,398,43,118,31,57,30,85,28,48,9,149,113,36,3,3,35,23,12
2021,Stockport 024C,E01005827,740,199,116,83,499,95,262,95,113,54,89,37,44,8,52,25,27,1,1,42,19,23
2021,Stockport 024D,E01005828,570,198,73,125,349,25,94,21,56,17,63,19,36,8,164,126,38,3,3,23,12,11
2021,Stockport 024E,E01005829,491,138,45,93,333,31,134,37,61,36,57,27,22,8,105,67,38,6,6,20,11,9
2021,Stockport 025A,E01005768,758,158,81,77,556,78,342,89,190,63,78,44,32,2,57,34,23,1,1,44,24,20
2021,Stockport 025B,E01005770,637,204,129,75,403,76,224,67,131,26,54,27,23,4,48,33,15,1,1,30,14,16
2021,Stockport 025C,E01005771,569,148,71,77,387,40,244,69,131,44,56,33,19,4,43,19,24,4,4,34,19,15
2021,Stockport 025D,E01005775,642,171,110,61,439,66,282,63,177,42,51,33,14,4,37,18,19,3,3,32,17,15
2021,Stockport 026A,E01005761,543,160,70,90,351,23,184,55,87,42,64,26,35,3,79,58,21,1,1,32,17,15
2021,Stockport 026B,E01005762,799,235,80,155,527,31,195,67,85,43,129,62,55,12,164,106,58,8,8,37,22,15
2021,Stockport 026C,E01005763,644,169,60,109,428,37,178,53,93,32,65,25,36,4,141,97,44,7,7,47,24,23
2021,Stockport 026D,E01005799,696,189,38,151,455,16,161,39,98,24,102,37,54,11,169,117,52,7,7,52,29,23
2021,Stockport 027A,E01005798,808,393,159,234,387,49,188,67,87,34,82,53,23,6,63,28,35,5,5,28,11,17
2021,Stockport 027B,E01005801,894,251,94,157,607,40,310,68,201,41,145,82,58,5,109,71,38,3,3,36,10,26
2021,Stockport 027C,E01005802,602,152,64,88,428,41,255,68,137,50,76,39,34,3,50,20,30,6,6,22,10,12
2021,Stockport 027D,E01005803,592,151,96,55,426,68,272,106,115,51,60,33,24,3,25,16,9,1,1,15,11,4
2021,Stockport 027E,E01005830,704,230,111,119,454,56,208,72,97,39,104,62,36,6,81,50,31,5,5,20,11,9
2021,Stockport 027F,E01005831,676,186,61,125,447,38,212,66,107,39,112,60,45,7,84,47,37,1,1,43,21,22
2021,Stockport 028A,E01005767,597,119,92,27,426,132,237,66,103,68,24,12,9,3,32,16,16,1,1,52,30,22
2021,Stockport 028B,E01005772,565,146,91,55,376,69,222,44,123,55,34,19,13,2,46,24,22,5,5,43,28,15
2021,Stockport 028C,E01005773,655,194,112,82,424,71,237,63,131,43,62,31,26,5,52,25,27,2,2,37,10,27
2021,Stockport 028D,E01005774,729,327,152,175,361,34,156,46,80,30,85,46,36,3,83,49,34,3,3,41,16,25
2021,Stockport 028E,E01005776,615,138,97,41,431,84,267,51,149,67,29,17,11,1,51,29,22,0,0,46,31,15
2021,Stockport 029A,E01005909,658,163,115,48,477,116,263,99,118,46,51,26,20,5,47,29,18,0,0,18,10,8
2021,Stockport 029B,E01005910,758,302,177,125,425,71,165,60,68,37,103,48,51,4,82,52,30,4,4,31,14,17
2021,Stockport 029C,E01005911,542,153,104,49,366,103,196,60,82,54,35,15,18,2,30,12,18,2,2,23,12,11
2021,Stockport 029D,E01005912,663,194,109,85,444,98,198,72,99,27,93,57,33,3,53,32,21,2,2,25,13,12
2021,Stockport 030A,E01005782,581,174,96,78,380,93,168,78,65,25,67,37,27,3,52,30,22,0,0,27,10,17
2021,Stockport 030B,E01005783,732,273,144,129,441,111,204,51,107,46,60,38,20,2,64,36,28,2,2,18,4,14
2021,Stockport 030C,E01005784,550,107,64,43,412,97,242,56,147,39,40,18,20,2,33,16,17,0,0,31,19,12
2021,Stockport 030D,E01005785,659,169,104,65,462,68,287,71,170,46,47,23,22,2,60,27,33,0,0,28,12,16
2021,Stockport 030E,E01005786,810,294,92,202,479,60,291,72,179,40,86,51,28,7,39,19,20,3,3,37,11,26
2021,Stockport 031A,E01005834,630,183,86,97,409,38,187,52,95,40,79,34,38,7,95,61,34,10,10,38,20,18
2021,Stockport 031B,E01005836,847,306,152,154,511,107,226,84,102,40,88,53,26,9,85,48,37,5,5,30,15,15
2021,Stockport 031C,E01005838,892,382,165,217,478,53,193,61,105,27,136,89,39,8,92,61,31,4,4,32,9,23
2021,Stockport 031D,E01005840,765,286,128,158,451,66,177,50,95,32,114,72,39,3,89,64,25,5,5,28,13,15
2021,Stockport 032A,E01005927,491,82,50,32,386,68,253,72,140,41,36,15,20,1,27,6,21,2,2,23,11,12
2021,Stockport 032B,E01005928,672,193,91,102,448,43,200,44,108,48,93,41,42,10,108,75,33,4,4,31,13,18
2021,Stockport 032C,E01005929,599,153,96,57,421,129,224,75,115,34,39,23,12,4,26,15,11,3,3,25,15,10
2021,Stockport 032D,E01005930,598,86,65,21,498,140,297,78,162,57,30,13,15,2,29,14,15,2,2,14,11,3
2021,Stockport 033A,E01005806,498,114,81,33,362,86,168,47,77,44,62,34,25,3,46,26,20,0,0,22,12,10
2021,Stockport 033B,E01005813,598,173,96,77,402,91,205,75,93,37,59,29,27,3,47,25,22,0,0,23,9,14
2021,Stockport 033C,E01005814,541,144,115,29,383,98,220,57,108,55,38,17,20,1,27,10,17,0,0,14,3,11
2021,Stockport 033D,E01005815,583,133,95,38,426,83,228,66,113,49,69,37,25,7,46,21,25,0,0,24,11,13
2021,Stockport 034A,E01005777,711,266,125,141,415,53,178,51,98,29,89,51,34,4,92,50,42,3,3,30,13,17
2021,Stockport 034B,E01005787,481,73,56,17,382,75,259,66,132,61,33,17,16,0,15,7,8,0,0,26,17,9
2021,Stockport 034C,E01005788,622,144,64,80,455,79,260,65,141,54,64,27,33,4,50,26,24,2,2,23,8,15
2021,Stockport 034D,E01005790,506,166,89,77,319,42,171,42,99,30,41,14,26,1,62,35,27,3,3,21,6,15
2021,Stockport 035A,E01005805,585,116,81,35,445,72,276,73,140,63,65,32,32,1,32,16,16,0,0,24,13,11
2021,Stockport 035B,E01005807,624,137,101,36,464,112,265,86,130,49,46,22,20,4,40,14,26,1,1,23,10,13
2021,Stockport 035C,E01005839,548,130,105,25,403,122,217,73,104,40,28,12,12,4,35,13,22,1,1,15,7,8
2021,Stockport 035D,E01005841,630,167,97,70,433,95,207,70,85,52,73,40,31,2,55,27,28,3,3,30,11,19
2021,Stockport 036A,E01005844,547,150,98,52,345,82,189,34,109,46,34,20,14,0,38,18,20,2,2,52,27,25
2021,Stockport 036B,E01005845,613,141,95,46,424,84,224,59,116,49,49,22,22,5,66,25,41,1,1,48,33,15
2021,Stockport 036C,E01005849,654,163,127,36,444,98,252,67,126,59,58,27,26,5,33,10,23,3,3,47,23,24
2021,Stockport 036D,E01005851,601,140,99,41,421,83,253,62,128,63,40,22,16,2,43,19,24,2,2,40,31,9
2021,Stockport 037A,E01005808,526,99,69,30,402,86,256,66,147,43,24,8,15,1,34,15,19,2,2,25,12,13
2021,Stockport 037B,E01005809,499,128,90,38,353,64,193,59,95,39,43,12,28,3,52,32,20,1,1,18,7,11
2021,Stockport 037C,E01005810,661,223,140,83,415,93,215,50,122,43,50,26,21,3,56,33,23,1,1,23,10,13
2021,Stockport 037D,E01005811,629,225,111,114,389,76,216,98,81,37,65,37,22,6,30,14,16,2,2,15,3,12
2021,Stockport 037E,E01005812,479,91,64,27,378,103,220,72,103,45,36,15,19,2,19,7,12,0,0,10,4,6
2021,Stockport 038A,E01005842,652,143,92,51,486,118,254,92,105,57,60,25,28,7,48,25,23,6,6,23,9,14
2021,Stockport 038B,E01005906,635,176,126,50,436,166,207,90,78,39,40,27,10,3,23,10,13,0,0,23,11,12
2021,Stockport 038C,E01005907,616,189,126,63,409,143,180,67,73,40,55,29,19,7,30,14,16,1,1,18,4,14
2021,Stockport 038D,E01005913,637,193,120,73,419,113,231,94,98,39,45,28,15,2,30,8,22,0,0,25,10,15
2021,Stockport 039A,E01005789,734,242,144,98,473,83,268,67,157,44,65,39,23,3,54,27,27,3,3,19,5,14
2021,Stockport 039B,E01005791,640,165,99,66,450,79,237,62,130,45,61,31,22,8,72,48,24,1,1,25,10,15
2021,Stockport 039C,E01005793,629,168,98,70,439,78,229,65,123,41,65,33,28,4,64,37,27,3,3,22,15,7
2021,Stockport 039D,E01005795,527,110,77,33,404,71,239,63,124,52,52,25,25,2,40,20,20,2,2,13,5,8
2021,Stockport 039E,E01005796,497,103,70,33,373,73,219,59,118,42,38,23,15,0,40,23,17,3,3,21,8,13
2021,Stockport 040A,E01005846,619,155,88,67,409,57,238,54,139,45,63,33,26,4,45,22,23,6,6,55,34,21
2021,Stockport 040B,E01005847,627,178,90,88,400,58,196,55,96,45,57,25,24,8,85,50,35,4,4,49,24,25
2021,Stockport 040C,E01005848,802,197,109,88,571,91,334,90,174,70,76,41,29,6,63,42,21,7,7,34,21,13
2021,Stockport 040D,E01005850,743,223,103,120,475,83,236,58,127,51,65,26,35,4,82,54,28,9,9,45,25,20
2021,Stockport 041A,E01005792,593,116,80,36,454,113,269,74,152,43,33,13,18,2,39,20,19,0,0,23,11,12
2021,Stockport 041B,E01005794,499,108,81,27,369,74,234,69,120,45,27,10,16,1,34,18,16,0,0,22,14,8
2021,Stockport 041C,E01005923,609,143,108,35,455,122,251,62,147,42,38,16,18,4,44,19,25,0,0,11,7,4
2021,Stockport 041D,E01005931,634,199,144,55,417,114,222,85,99,38,42,19,18,5,38,15,23,1,1,18,7,11
2021,Stockport 042A,E01005924,527,129,91,38,377,88,234,80,122,32,31,17,14,0,24,10,14,0,0,21,10,11
2021,Stockport 042B,E01005925,609,196,149,47,394,91,231,64,131,36,36,24,9,3,35,21,14,1,1,19,12,7
2021,Stockport 042C,E01005926,858,156,71,85,666,102,418,127,227,64,107,57,46,4,37,22,15,2,2,36,12,24
2021,Stockport 042D,E01005932,522,105,82,23,406,115,220,63,106,51,38,22,14,2,33,16,17,0,0,11,4,7
2021,Tameside 001A,E01006053,844,240,89,151,579,93,292,107,136,49,126,67,54,5,67,45,22,1,1,25,11,14
2021,Tameside 001B,E01006054,806,320,145,175,461,43,212,70,109,33,99,45,47,7,103,70,33,4,4,25,10,15
2021,Tameside 001C,E01006055,691,223,69,154,443,49,176,76,73,27,130,69,57,4,84,61,23,4,4,25,13,12
2021,Tameside 001D,E01006057,674,183,70,113,473,58,214,83,96,35,119,69,46,4,77,41,36,5,5,18,9,9
2021,Tameside 001E,E01006058,1019,413,128,285,562,62,205,82,89,34,181,123,50,8,107,83,24,7,7,44,20,24
2021,Tameside 001F,E01006059,632,187,76,111,428,50,198,63,94,41,100,59,36,5,77,51,26,3,3,17,7,10
2021,Tameside 002A,E01005938,649,191,83,108,429,72,209,67,80,62,70,28,37,5,78,50,28,0,0,29,10,19
2021,Tameside 002B,E01005939,481,105,78,27,328,80,177,51,70,56,25,9,11,5,43,19,24,3,3,48,20,28
2021,Tameside 002C,E01005940,593,160,102,58,405,118,206,63,83,60,33,14,17,2,46,26,20,2,2,28,15,13
2021,Tameside 002D,E01005955,627,123,70,53,464,69,272,95,102,75,71,29,38,4,48,25,23,4,4,40,20,20
2021,Tameside 003A,E01006056,507,158,59,99,326,22,94,25,54,15,86,16,59,11,121,84,37,3,3,23,17,6
2021,Tameside 003B,E01006061,979,244,84,160,686,58,325,94,169,62,132,43,78,11,165,114,51,6,6,49,25,24
2021,Tameside 003C,E01006062,811,175,93,82,609,105,347,126,153,68,89,37,46,6,65,37,28,3,3,27,16,11
2021,Tameside 003D,E01006063,568,130,61,69,408,75,201,76,80,45,80,37,34,9,46,21,25,6,6,30,10,20
2021,Tameside 004A,E01005936,644,146,82,64,476,107,230,92,92,46,79,37,33,9,58,33,25,2,2,22,11,11
2021,Tameside 004B,E01005937,712,194,78,116,484,56,188,59,85,44,90,31,51,8,144,112,32,6,6,34,20,14
2021,Tameside 004C,E01005945,751,208,71,137,498,28,194,53,107,34,110,44,57,9,162,118,44,4,4,45,30,15
2021,Tameside 004D,E01005946,691,223,70,153,438,42,196,61,94,41,80,37,37,6,113,80,33,7,7,30,11,19
2021,Tameside 004E,E01005947,817,304,84,220,466,13,173,56,91,26,99,44,51,4,170,129,41,11,11,47,24,23
2021,Tameside 005A,E01005954,760,402,217,185,334,50,128,43,56,29,76,36,34,6,78,45,33,2,2,24,16,8
2021,Tameside 005B,E01005956,584,176,103,73,374,73,204,96,49,59,63,31,26,6,34,17,17,0,0,34,20,14
2021,Tameside 005C,E01005957,618,174,85,89,403,62,199,66,93,40,67,33,29,5,70,47,23,5,5,41,25,16
2021,Tameside 005D,E01005958,679,211,81,130,430,40,152,53,67,32,99,38,53,8,134,103,31,5,5,38,22,16
2021,Tameside 005E,E01005959,728,186,79,107,494,32,205,45,112,48,88,34,44,10,164,103,61,5,5,48,35,13
2021,Tameside 006A,E01005933,549,128,40,88,382,19,152,30,88,34,77,19,45,13,128,93,35,6,6,39,25,14
2021,Tameside 006B,E01005934,626,159,71,88,439,67,200,79,86,35,73,31,35,7,97,64,33,2,2,28,19,9
2021,Tameside 006C,E01005935,639,225,86,139,389,21,122,45,46,31,77,23,46,8,166,121,45,3,3,25,11,14
2021,Tameside 006D,E01005949,713,272,112,160,398,43,170,54,78,38,92,48,36,8,81,55,26,12,12,43,25,18
2021,Tameside 006E,E01005960,733,255,89,166,437,34,166,51,83,32,90,36,48,6,132,93,39,15,15,41,25,16
2021,Tameside 007A,E01005941,777,283,83,200,427,30,180,56,97,27,91,40,48,3,116,77,39,10,10,67,37,30
2021,Tameside 007B,E01005942,710,195,86,109,477,67,214,72,91,51,102,45,51,6,89,51,38,5,5,38,18,20
2021,Tameside 007C,E01005943,849,314,102,212,492,50,172,80,64,28,144,86,46,12,123,95,28,3,3,43,21,22
2021,Tameside 007D,E01005944,722,151,59,92,530,54,268,79,142,47,117,58,53,6,88,50,38,3,3,41,18,23
2021,Tameside 008A,E01006060,708,297,75,222,373,18,131,43,69,19,99,38,50,11,120,86,34,5,5,38,17,21
2021,Tameside 008B,E01006064,797,329,172,157,443,33,167,54,81,32,85,29,44,12,151,114,37,7,7,25,16,9
2021,Tameside 008C,E01006065,511,80,36,44,401,32,147,44,72,31,71,19,45,7,144,108,36,7,7,30,19,11
2021,Tameside 008D,E01006066,604,191,63,128,375,40,116,45,49,22,105,57,39,9,110,72,38,4,4,38,13,25
2021,Tameside 009A,E01006067,738,153,57,96,558,76,328,118,152,58,96,44,44,8,56,36,20,2,2,27,16,11
2021,Tameside 009B,E01006068,827,415,153,262,382,49,119,58,43,18,128,57,65,6,81,48,33,5,5,30,8,22
2021,Tameside 009C,E01006069,703,195,73,122,471,37,195,64,88,43,95,41,44,10,141,97,44,3,3,37,23,14
2021,Tameside 009D,E01006073,819,234,53,181,562,26,229,69,115,45,143,63,68,12,146,108,38,18,18,23,8,15
2021,Tameside 010A,E01005993,609,193,95,98,395,66,179,74,62,43,86,43,38,5,62,37,25,2,2,21,9,12
2021,Tameside 010B,E01005995,516,92,49,43,397,58,236,88,84,64,68,29,32,7,34,16,18,1,1,27,16,11
2021,Tameside 010C,E01005996,798,222,86,136,534,54,223,59,101,63,116,43,63,10,133,88,45,8,8,42,20,22
2021,Tameside 010D,E01005997,686,245,112,133,411,41,184,56,75,53,87,41,40,6,92,55,37,7,7,30,14,16
2021,Tameside 010E,E01006000,938,454,224,230,447,69,148,56,57,35,99,54,39,6,128,89,39,3,3,37,12,25
2021,Tameside 011A,E01005994,610,153,66,87,427,34,165,65,66,34,120,40,62,18,104,59,45,4,4,30,11,19
2021,Tameside 011B,E01005999,926,308,89,219,543,42,241,69,124,48,131,66,53,12,122,74,48,7,7,75,33,42
2021,Tameside 011C,E01006002,558,165,98,67,357,30,186,60,66,60,61,19,32,10,77,35,42,3,3,36,16,20
2021,Tameside 011D,E01006004,617,131,62,69,465,79,206,70,73,63,100,39,50,11,79,51,28,1,1,21,13,8
2021,Tameside 011E,E01006005,630,244,90,154,358,26,117,44,44,29,75,35,34,6,134,107,27,6,6,28,21,7
2021,Tameside 011F,E01006007,648,185,75,110,429,33,196,75,73,48,106,37,60,9,91,64,27,3,3,34,15,19
2021,Tameside 012A,E01005998,754,193,57,136,502,45,213,72,94,47,106,42,56,8,127,83,44,11,11,59,32,27
2021,Tameside 012B,E01006001,644,179,82,97,418,46,187,71,71,45,93,46,35,12,88,46,42,4,4,47,23,24
2021,Tameside 012C,E01006003,631,178,77,101,400,42,170,61,71,38,76,34,36,6,108,65,43,4,4,53,21,32
2021,Tameside 012D,E01006006,601,146,76,70,429,78,196,69,69,58,102,54,39,9,51,23,28,2,2,26,12,14
2021,Tameside 013A,E01005948,1174,697,116,581,405,15,171,47,101,23,100,63,31,6,103,72,31,16,16,72,46,26
2021,Tameside 013B,E01005950,643,145,35,110,413,20,230,33,169,28,33,15,17,1,121,82,39,9,9,85,63,22
2021,Tameside 013C,E01005951,754,254,90,164,454,32,177,55,98,24,100,45,49,6,135,109,26,10,10,46,30,16
2021,Tameside 013E,E01005953,876,298,130,168,506,32,216,46,125,45,86,48,31,7,165,117,48,7,7,72,41,31
2021,Tameside 013F,E01033949,594,342,70,272,211,3,95,22,60,13,30,22,6,2,74,44,30,9,9,41,21,20
2021,Tameside 013G,E01033950,684,359,96,263,286,10,97,36,46,15,57,32,21,4,114,76,38,8,8,39,19,20
2021,Tameside 014A,E01005961,1105,232,85,147,802,56,427,108,258,61,186,82,91,13,127,91,36,6,6,71,34,37
2021,Tameside 014B,E01005962,596,173,102,71,389,69,176,62,75,39,75,37,37,1,68,41,27,1,1,34,18,16
2021,Tameside 014C,E01005968,618,196,86,110,395,62,198,76,69,53,75,35,32,8,57,26,31,3,3,27,13,14
2021,Tameside 014D,E01005969,569,162,86,76,380,74,175,66,58,51,73,37,27,9,56,30,26,2,2,27,14,13
2021,Tameside 015A,E01006022,1040,480,148,332,531,74,201,89,63,49,148,101,41,6,102,60,42,6,6,29,10,19
2021,Tameside 015B,E01006023,801,351,108,243,417,36,146,60,59,27,88,50,32,6,139,100,39,8,8,33,10,23
2021,Tameside 015C,E01006070,619,190,70,120,399,49,179,67,73,39,109,62,44,3,61,37,24,1,1,30,13,17
2021,Tameside 015D,E01006071,697,140,88,52,540,154,284,102,125,57,63,20,37,6,36,17,19,3,3,17,10,7
2021,Tameside 015E,E01006072,671,146,98,48,498,123,274,98,120,56,54,20,29,5,47,26,21,0,0,27,13,14
2021,Tameside 016A,E01006009,586,185,79,106,370,37,157,67,52,38,81,37,37,7,92,51,41,3,3,31,19,12
2021,Tameside 016B,E01006017,552,107,61,46,430,84,234,61,112,61,70,33,30,7,40,20,20,2,2,15,6,9
2021,Tameside 016C,E01006018,564,130,91,39,412,102,201,83,57,61,66,32,25,9,43,21,22,0,0,22,8,14
2021,Tameside 016D,E01006021,604,176,101,75,395,73,162,64,57,41,88,34,47,7,70,50,20,2,2,33,15,18
2021,Tameside 017A,E01006008,614,166,56,110,425,32,175,70,66,39,112,61,43,8,102,73,29,4,4,23,7,16
2021,Tameside 017B,E01006010,657,268,118,150,369,29,123,47,54,22,97,34,54,9,113,82,31,7,7,20,11,9
2021,Tameside 017C,E01006012,798,226,86,140,530,63,221,89,93,39,127,51,70,6,116,79,37,3,3,42,25,17
2021,Tameside 017D,E01006015,524,102,47,55,396,51,238,83,107,48,64,26,31,7,42,19,23,1,1,26,14,12
2021,Tameside 017E,E01006016,1034,546,130,416,441,32,147,67,64,16,124,75,41,8,132,95,37,6,6,47,21,26
2021,Tameside 018A,E01006011,694,225,81,144,427,45,164,46,88,30,93,29,53,11,121,80,41,4,4,42,21,21
2021,Tameside 018B,E01006013,564,164,79,85,380,73,151,53,60,38,82,31,42,9,71,45,26,3,3,20,9,11
2021,Tameside 018C,E01006014,478,83,40,43,373,38,158,47,76,35,77,34,28,15,97,75,22,3,3,22,12,10
2021,Tameside 018D,E01006019,815,426,181,245,367,41,140,68,39,33,116,70,43,3,66,44,22,4,4,22,11,11
2021,Tameside 018E,E01006020,625,162,80,82,434,50,180,56,81,43,91,26,52,13,107,68,39,6,6,29,16,13
2021,Tameside 019A,E01005963,487,131,59,72,331,42,158,56,63,39,69,32,33,4,60,30,30,2,2,25,11,14
2021,Tameside 019B,E01005964,657,201,78,123,427,50,179,65,77,37,100,40,53,7,93,62,31,5,5,29,14,15
2021,Tameside 019C,E01005965,799,278,110,168,490,49,181,90,67,24,143,80,51,12,114,78,36,3,3,31,20,11
2021,Tameside 019D,E01005966,624,168,49,119,418,22,170,56,76,38,104,35,62,7,117,76,41,5,5,38,24,14
2021,Tameside 019E,E01005967,712,325,140,185,360,33,144,50,66,28,82,35,31,16,96,65,31,5,5,27,14,13
2021,Tameside 020A,E01006031,939,302,93,209,588,25,231,66,132,33,184,97,82,5,143,97,46,5,5,49,30,19
2021,Tameside 020B,E01006032,600,159,60,99,418,31,193,52,112,29,91,41,46,4,93,54,39,10,10,23,11,12
2021,Tameside 020C,E01006033,790,257,66,191,513,40,195,67,88,40,143,67,68,8,130,89,41,5,5,20,9,11
2021,Tameside 020D,E01006034,933,330,121,209,562,50,222,65,122,35,137,57,67,13,146,105,41,7,7,41,23,18
2021,Tameside 020E,E01006035,1018,411,148,263,562,56,219,81,100,38,156,86,61,9,126,78,48,5,5,45,24,21
2021,Tameside 020F,E01006036,949,363,83,280,545,37,227,73,112,42,129,65,51,13,147,107,40,5,5,41,24,17
2021,Tameside 021A,E01005970,648,207,120,87,419,90,216,95,72,49,67,32,33,2,42,15,27,4,4,22,12,10
2021,Tameside 021B,E01005972,763,245,57,188,476,40,163,54,74,35,129,52,65,12,136,85,51,8,8,42,17,25
2021,Tameside 021C,E01005974,820,313,103,210,467,47,128,42,51,35,140,73,58,9,141,90,51,11,11,40,17,23
2021,Tameside 021D,E01005975,688,239,92,147,426,35,185,62,88,35,71,37,33,1,131,82,49,4,4,23,12,11
2021,Tameside 022A,E01006024,686,123,63,60,531,74,327,116,124,87,79,32,35,12,49,20,29,2,2,32,16,16
2021,Tameside 022B,E01006026,731,285,100,185,425,47,177,73,68,36,113,58,46,9,83,54,29,5,5,21,11,10
2021,Tameside 022C,E01006037,647,134,78,56,482,81,252,87,110,55,95,44,37,14,54,36,18,0,0,31,12,19
2021,Tameside 022D,E01006038,664,162,85,77,479,104,202,82,67,53,88,41,40,7,81,43,38,4,4,23,15,8
2021,Tameside 023A,E01006047,591,172,83,89,393,58,157,65,59,33,89,49,36,4,87,58,29,2,2,26,13,13
2021,Tameside 023B,E01006048,762,276,148,128,459,106,185,76,67,42,97,60,33,4,67,48,19,4,4,27,15,12
2021,Tameside 023C,E01006049,767,280,103,177,467,79,198,102,52,44,97,54,37,6,90,60,30,3,3,20,5,15
2021,Tameside 023D,E01006051,725,214,86,128,476,83,217,95,85,37,98,53,38,7,77,45,32,1,1,35,10,25
2021,Tameside 024A,E01005985,697,220,134,86,449,90,231,88,91,52,79,40,34,5,46,13,33,3,3,28,14,14
2021,Tameside 024B,E01005987,698,221,132,89,454,83,228,101,73,54,84,39,37,8,55,27,28,4,4,23,13,10
2021,Tameside 024C,E01005988,639,152,78,74,453,72,231,64,117,50,85,33,48,4,63,35,28,2,2,34,14,20
2021,Tameside 024D,E01005990,627,218,105,113,386,76,175,61,72,42,73,37,32,4,60,32,28,2,2,23,14,9
2021,Tameside 024E,E01005991,623,179,80,99,409,60,178,41,88,49,84,46,30,8,81,50,31,6,6,35,17,18
2021,Tameside 025A,E01005971,632,209,71,138,399,53,152,65,49,38,93,48,39,6,96,50,46,5,5,24,11,13
2021,Tameside 025B,E01005986,535,171,59,112,335,31,147,50,61,36,75,34,36,5,79,48,31,3,3,29,18,11
2021,Tameside 025C,E01005989,506,126,71,55,364,76,204,64,87,53,46,20,22,4,36,15,21,2,2,16,6,10
2021,Tameside 025D,E01005992,585,261,88,173,300,29,117,40,47,30,63,38,23,2,90,60,30,1,1,24,10,14
2021,Tameside 026A,E01005973,598,166,89,77,408,76,167,63,63,41,85,32,44,9,75,36,39,5,5,24,5,19
2021,Tameside 026B,E01005976,631,223,85,138,375,46,139,37,61,41,95,34,53,8,90,55,35,5,5,33,21,12
2021,Tameside 026C,E01005977,664,207,113,94,435,83,178,66,67,45,94,47,43,4,80,43,37,0,0,22,11,11
2021,Tameside 026D,E01005978,600,190,78,112,392,49,120,44,46,30,80,30,32,18,132,90,42,11,11,18,6,12
2021,Tameside 027A,E01006025,781,202,78,124,533,34,189,60,88,41,135,68,58,9,169,114,55,6,6,46,24,22
2021,Tameside 027B,E01006027,1005,360,92,268,593,24,204,77,99,28,181,81,89,11,176,131,45,8,8,52,26,26
2021,Tameside 027C,E01006050,781,272,93,179,472,28,139,43,62,34,104,33,60,11,195,143,52,6,6,37,25,12
2021,Tameside 027D,E01006052,663,198,92,106,429,51,140,48,57,35,77,33,37,7,157,102,55,4,4,36,21,15
2021,Tameside 028A,E01006028,893,461,205,256,396,58,155,56,68,31,77,37,36,4,100,74,26,6,6,36,18,18
2021,Tameside 028B,E01006029,715,208,51,157,455,22,229,53,146,30,84,45,35,4,116,92,24,4,4,52,41,11
2021,Tameside 028C,E01006030,779,243,71,172,496,32,218,79,95,44,112,41,59,12,129,79,50,5,5,40,20,20
2021,Tameside 028D,E01006039,455,128,45,83,287,37,151,34,87,30,42,26,14,2,49,31,18,8,8,40,31,9
2021,Tameside 028E,E01006040,629,187,49,138,373,15,202,52,128,22,58,34,21,3,92,66,26,6,6,69,46,23
2021,Tameside 028F,E01006041,700,224,95,129,432,32,199,44,117,38,105,56,43,6,93,74,19,3,3,44,25,19
2021,Tameside 029A,E01005979,774,305,167,138,439,83,168,72,60,36,94,49,39,6,92,56,36,2,2,30,12,18
2021,Tameside 029B,E01005980,636,217,82,135,397,35,143,57,56,30,90,40,44,6,126,84,42,3,3,22,10,12
2021,Tameside 029C,E01005981,801,362,213,149,413,55,150,53,69,28,90,28,45,17,114,69,45,4,4,26,10,16
2021,Tameside 029D,E01005982,570,173,86,87,372,70,151,49,57,45,64,29,28,7,84,55,29,3,3,25,14,11
2021,Tameside 029E,E01005983,693,222,133,89,446,103,216,79,83,54,77,43,29,5,48,26,22,2,2,25,16,9
2021,Tameside 029F,E01005984,808,371,122,249,405,32,104,42,46,16,97,40,47,10,164,103,61,8,8,32,22,10
2021,Tameside 030A,E01006042,811,307,125,182,476,60,194,71,79,44,131,84,43,4,85,62,23,6,6,28,12,16
2021,Tameside 030B,E01006043,605,173,93,80,408,47,185,66,81,38,90,38,43,9,84,54,30,2,2,24,14,10
2021,Tameside 030C,E01006044,653,195,105,90,432,92,215,81,100,34,76,37,34,5,48,32,16,1,1,26,13,13
2021,Tameside 030D,E01006045,531,132,89,43,373,87,202,80,74,48,51,23,25,3,33,15,18,0,0,26,9,17
2021,Tameside 030E,E01006046,630,146,79,67,457,94,214,74,103,37,83,47,30,6,64,31,33,2,2,27,15,12
2021,Trafford 001A,E01006109,531,284,55,229,210,9,90,23,57,10,29,16,11,2,69,46,23,13,13,37,22,15
2021,Trafford 001B,E01006110,655,156,51,105,416,18,201,39,134,28,72,33,37,2,115,64,51,10,10,83,34,49
2021,Trafford 001C,E01006111,558,128,42,86,360,8,156,16,109,31,47,21,23,3,138,78,60,11,11,70,39,31
2021,Trafford 001D,E01006112,701,214,100,114,386,14,188,30,119,39,42,20,20,2,131,84,47,11,11,101,55,46
2021,Trafford 001F,E01006188,786,252,37,215,424,12,196,44,120,32,111,85,25,1,80,50,30,25,25,110,45,65
2021,Trafford 001G,E01034000,751,399,11,388,271,1,61,40,19,2,155,151,4,0,36,26,10,18,18,81,8,73
2021,Trafford 001H,E01034001,777,366,90,276,341,13,141,35,97,9,68,51,17,0,103,74,29,16,16,70,19,51
2021,Trafford 002A,E01006116,537,129,69,60,380,55,190,53,105,32,67,36,26,5,67,48,19,1,1,28,14,14
2021,Trafford 002B,E01006117,637,109,78,31,497,79,297,79,169,49,68,30,34,4,50,21,29,3,3,31,17,14
2021,Trafford 002C,E01006118,670,249,115,134,398,48,211,65,93,53,71,38,25,8,68,36,32,0,0,23,10,13
2021,Trafford 002D,E01006119,633,116,75,41,488,71,283,81,141,61,58,37,16,5,72,40,32,4,4,29,15,14
2021,Trafford 002E,E01006121,596,136,66,70,435,77,190,65,70,55,78,32,40,6,89,52,37,1,1,25,13,12
2021,Trafford 003A,E01006141,645,154,57,97,444,24,235,50,141,44,80,41,34,5,94,48,46,11,11,47,27,20
2021,Trafford 003B,E01006186,946,345,70,275,521,26,217,67,114,36,141,92,37,12,126,77,49,11,11,80,19,61
2021,Trafford 003C,E01006187,1148,379,85,294,675,23,264,80,141,43,183,108,68,7,198,133,65,7,7,94,26,68
2021,Trafford 003D,E01006189,931,250,74,176,621,44,278,68,162,48,140,81,54,5,150,96,54,9,9,60,23,37
2021,Trafford 004A,E01006113,478,78,42,36,299,24,174,30,96,48,45,19,22,4,53,27,26,3,3,101,59,42
2021,Trafford 004B,E01006114,564,158,76,82,311,30,159,27,88,44,43,22,16,5,74,39,35,5,5,95,55,40
2021,Trafford 004C,E01006115,594,209,68,141,315,32,160,31,88,41,55,36,16,3,61,21,40,7,7,70,31,39
2021,Trafford 004D,E01006145,805,250,80,170,463,30,209,49,119,41,81,54,22,5,133,80,53,10,10,92,39,53
2021,Trafford 004E,E01006146,645,147,73,74,431,34,250,57,144,49,58,29,28,1,84,45,39,5,5,67,34,33
2021,Trafford 005A,E01006122,742,199,110,89,517,103,270,81,127,62,89,41,40,8,55,26,29,0,0,26,15,11
2021,Trafford 005B,E01006123,650,143,78,65,480,92,257,77,121,59,66,26,34,6,65,36,29,0,0,27,10,17
2021,Trafford 005C,E01006124,609,148,96,52,437,106,257,81,116,60,41,18,20,3,31,13,18,2,2,24,14,10
2021,Trafford 005D,E01006128,782,215,138,77,545,92,280,72,161,47,100,54,38,8,70,42,28,3,3,22,8,14
2021,Trafford 005E,E01006131,622,179,94,85,418,71,254,68,122,64,46,23,21,2,46,23,23,1,1,25,13,12
2021,Trafford 006A,E01006155,721,172,67,105,510,57,253,79,131,43,115,68,39,8,83,48,35,2,2,39,19,20
2021,Trafford 006B,E01006157,659,150,55,95,477,35,264,77,142,45,92,46,37,9,83,46,37,3,3,32,16,16
2021,Trafford 006C,E01006159,707,182,62,120,473,28,193,51,108,34,76,27,42,7,171,102,69,5,5,52,34,18
2021,Trafford 006D,E01006182,586,121,70,51,429,38,263,70,132,61,62,35,23,4,65,24,41,1,1,36,23,13
2021,Trafford 006E,E01006183,635,147,65,82,445,57,262,59,143,60,64,34,22,8,57,19,38,5,5,43,26,17
2021,Trafford 007A,E01006125,608,137,85,52,442,64,220,63,93,64,72,31,38,3,83,50,33,3,3,29,15,14
2021,Trafford 007B,E01006126,745,236,90,146,467,45,186,53,106,27,96,30,58,8,139,87,52,1,1,42,22,20
2021,Trafford 007C,E01006127,619,132,73,59,467,73,227,73,96,58,86,37,41,8,76,40,36,5,5,20,12,8
2021,Trafford 007D,E01006130,739,210,125,85,505,71,280,87,136,57,87,41,40,6,66,45,21,1,1,24,11,13
2021,Trafford 007E,E01006132,672,234,114,120,410,49,240,69,115,56,65,34,26,5,55,25,30,1,1,28,16,12
2021,Trafford 008A,E01006156,698,215,84,131,444,57,219,68,109,42,65,29,26,10,99,56,43,4,4,39,19,20
2021,Trafford 008B,E01006158,788,287,82,205,475,56,198,66,103,29,76,35,32,9,134,94,40,11,11,26,15,11
2021,Trafford 008C,E01006179,852,366,139,227,446,35,205,58,100,47,86,54,28,4,108,77,31,12,12,40,15,25
2021,Trafford 008D,E01006184,754,283,133,150,436,59,210,66,97,47,63,32,26,5,100,64,36,4,4,35,17,18
2021,Trafford 009A,E01006198,701,295,134,161,378,56,176,45,89,42,92,64,25,3,53,30,23,1,1,28,12,16
2021,Trafford 009B,E01006199,747,279,106,173,439,33,172,72,80,20,113,72,37,4,117,66,51,4,4,29,9,20
2021,Trafford 009C,E01006200,681,287,165,122,377,83,192,65,96,31,66,41,22,3,33,15,18,3,3,17,5,12
2021,Trafford 009D,E01006201,655,237,90,147,391,25,199,64,105,30,104,59,39,6,61,33,28,2,2,27,8,19
2021,Trafford 009E,E01006202,607,240,90,150,343,45,209,62,105,42,51,31,18,2,37,25,12,1,1,24,9,15
2021,Trafford 010A,E01006120,559,121,73,48,419,92,243,67,133,43,49,21,21,7,33,17,16,2,2,19,9,10
2021,Trafford 010B,E01006129,636,227,131,96,388,77,180,56,87,37,59,29,26,4,68,33,35,4,4,21,9,12
2021,Trafford 010C,E01006133,646,196,125,71,432,101,217,89,79,49,65,32,31,2,47,24,23,2,2,18,12,6
2021,Trafford 010D,E01006197,596,148,97,51,426,46,239,57,137,45,84,48,29,7,55,31,24,2,2,22,8,14
2021,Trafford 010E,E01006203,517,115,52,63,390,69,230,69,105,56,48,22,20,6,40,22,18,3,3,12,7,5
2021,Trafford 011A,E01006142,756,293,152,141,412,45,206,59,106,41,77,43,31,3,78,49,29,6,6,51,19,32
2021,Trafford 011B,E01006143,696,241,97,144,409,49,236,64,133,39,82,43,32,7,37,19,18,5,5,46,22,24
2021,Trafford 011C,E01006144,692,297,111,186,361,25,119,49,51,19,81,59,20,2,132,85,47,4,4,34,11,23
2021,Trafford 011D,E01006180,782,243,54,189,477,22,209,57,123,29,128,76,48,4,108,73,35,10,10,62,19,43
2021,Trafford 011E,E01006181,652,181,99,82,412,39,223,52,135,36,68,36,28,4,78,36,42,4,4,59,27,32
2021,Trafford 012A,E01006147,531,94,57,37,427,56,264,57,164,43,61,28,28,5,43,23,20,3,3,10,5,5
2021,Trafford 012B,E01006149,686,228,131,97,438,52,247,59,152,36,73,48,22,3,62,43,19,4,4,20,8,12
2021,Trafford 012C,E01006150,865,360,142,218,477,70,248,62,149,37,99,72,24,3,56,36,20,4,4,28,10,18
2021,Trafford 012D,E01006154,661,194,56,138,441,32,233,43,159,31,101,68,27,6,73,47,26,2,2,26,12,14
2021,Trafford 012E,E01006165,911,278,85,193,596,33,265,90,153,22,173,133,36,4,114,76,38,11,11,37,14,23
2021,Trafford 013A,E01006166,680,205,85,120,442,51,221,65,110,46,86,43,37,6,82,52,30,2,2,33,17,16
2021,Trafford 013B,E01006169,663,161,100,61,477,83,245,55,136,54,67,31,29,7,74,40,34,8,8,25,9,16
2021,Trafford 013C,E01006170,679,201,119,82,450,61,240,72,132,36,73,33,38,2,73,44,29,3,3,28,14,14
2021,Trafford 013D,E01006171,766,263,96,167,473,28,191,55,97,39,94,34,47,13,152,100,52,8,8,30,21,9
2021,Trafford 014A,E01006098,512,125,75,50,370,61,231,58,143,30,41,19,20,2,35,22,13,2,2,17,8,9
2021,Trafford 014B,E01006099,547,157,74,83,362,49,200,49,125,26,65,42,21,2,46,26,20,2,2,28,14,14
2021,Trafford 014C,E01006164,727,200,110,90,509,94,287,71,166,50,72,35,33,4,56,28,28,0,0,18,9,9
2021,Trafford 014D,E01006174,816,289,111,178,488,77,256,68,155,33,86,52,31,3,67,37,30,2,2,39,15,24
2021,Trafford 014E,E01006178,769,218,95,123,528,79,282,72,168,42,94,53,33,8,71,42,29,2,2,23,12,11
2021,Trafford 015A,E01006097,822,322,157,165,476,99,251,69,152,30,73,54,16,3,49,26,23,4,4,24,7,17
2021,Trafford 015B,E01006160,1092,544,240,304,521,46,284,78,192,14,120,83,35,2,63,42,21,8,8,27,14,13
2021,Trafford 015C,E01006161,946,331,97,234,578,71,334,97,212,25,102,68,29,5,66,50,16,5,5,37,12,25
2021,Trafford 015D,E01006162,676,216,82,134,434,47,294,77,183,34,56,42,12,2,36,17,19,1,1,26,8,18
2021,Trafford 015E,E01006163,814,246,69,177,534,36,272,83,161,28,147,98,48,1,74,56,18,5,5,34,7,27
2021,Trafford 016A,E01006148,685,215,106,109,435,86,245,70,134,41,60,34,24,2,40,24,16,4,4,35,14,21
2021,Trafford 016B,E01006151,573,100,66,34,447,76,304,76,176,52,27,13,14,0,34,14,20,6,6,26,11,15
2021,Trafford 016C,E01006152,621,117,79,38,472,121,282,70,160,52,36,16,16,4,32,14,18,1,1,32,17,15
2021,Trafford 016D,E01006153,627,156,109,47,450,100,293,71,156,66,21,8,9,4,36,15,21,0,0,21,12,9
2021,Trafford 016E,E01006172,649,190,129,61,437,98,267,85,134,48,32,14,17,1,38,20,18,2,2,22,9,13
2021,Trafford 017A,E01006104,755,251,106,145,471,74,204,82,75,47,107,42,52,13,81,46,35,5,5,33,12,21
2021,Trafford 017B,E01006105,674,183,70,113,456,21,144,46,67,31,87,20,57,10,198,154,44,6,6,35,19,16
2021,Trafford 017C,E01006106,598,178,84,94,396,34,160,71,53,36,85,27,55,3,114,72,42,3,3,24,11,13
2021,Trafford 017D,E01006107,697,257,127,130,405,52,164,50,80,34,84,31,44,9,101,63,38,4,4,35,19,16
2021,Trafford 017E,E01006108,624,144,43,101,437,7,115,43,48,24,69,22,40,7,240,172,68,6,6,43,22,21
2021,Trafford 018A,E01006102,567,161,96,65,389,45,218,50,129,39,57,26,29,2,69,41,28,0,0,17,15,2
2021,Trafford 018B,E01006173,607,126,75,51,466,69,265,73,153,39,78,33,38,7,53,19,34,1,1,15,7,8
2021,Trafford 018C,E01006175,741,249,133,116,455,28,168,48,91,29,83,27,45,11,172,118,54,4,4,37,19,18
2021,Trafford 018D,E01006176,725,202,106,96,489,61,253,65,137,51,92,55,32,5,75,43,32,8,8,34,14,20
2021,Trafford 018E,E01006177,598,146,61,85,401,24,170,36,90,44,76,24,39,13,125,95,30,6,6,51,31,20
2021,Trafford 019A,E01006091,1155,310,78,232,794,40,473,93,325,55,144,95,40,9,131,88,43,6,6,51,27,24
2021,Trafford 019B,E01006092,498,115,51,64,358,13,138,29,83,26,68,22,37,9,133,77,56,6,6,25,14,11
2021,Trafford 019C,E01006095,684,194,105,89,466,52,281,69,162,50,75,37,29,9,55,31,24,3,3,24,9,15
2021,Trafford 019D,E01006167,725,291,89,202,399,26,141,34,71,36,63,33,20,10,167,110,57,2,2,35,19,16
2021,Trafford 019E,E01006168,734,236,63,173,435,18,147,42,78,27,74,24,44,6,190,132,58,6,6,63,36,27
2021,Trafford 020A,E01006090,992,317,84,233,640,68,353,102,190,61,117,81,32,4,88,59,29,14,14,35,14,21
2021,Trafford 020B,E01006094,595,141,100,41,425,69,279,55,189,35,34,9,20,5,42,17,25,1,1,29,14,15
2021,Trafford 020C,E01006096,572,92,54,38,455,69,292,61,190,41,50,23,24,3,42,23,19,2,2,25,14,11
2021,Trafford 020D,E01006100,603,165,78,87,422,62,265,68,141,56,61,31,24,6,33,20,13,1,1,16,11,5
2021,Trafford 020E,E01006103,601,91,54,37,485,73,332,70,205,57,42,13,24,5,38,20,18,0,0,25,11,14
2021,Trafford 021A,E01006101,552,83,64,19,450,78,297,71,177,49,37,21,14,2,37,16,21,1,1,19,9,10
2021,Trafford 021B,E01006190,641,139,77,62,486,82,312,80,178,54,49,19,27,3,41,22,19,2,2,16,7,9
2021,Trafford 021C,E01006195,665,109,65,44,520,87,339,77,197,65,53,23,26,4,41,20,21,0,0,36,17,19
2021,Trafford 021D,E01006196,681,165,83,82,493,55,308,87,171,50,77,38,36,3,50,25,25,3,3,23,12,11
2021,Trafford 021E,E01006210,635,146,71,75,468,81,288,69,163,56,49,32,13,4,49,29,20,1,1,21,13,8
2021,Trafford 022A,E01006204,703,234,168,66,438,99,241,62,134,45,40,23,15,2,55,29,26,3,3,31,15,16
2021,Trafford 022B,E01006206,751,248,134,114,461,43,235,58,133,44,58,19,32,7,122,77,45,3,3,42,21,21
2021,Trafford 022C,E01006207,778,313,110,203,432,45,142,38,70,34,96,34,53,9,140,96,44,9,9,33,25,8
2021,Trafford 022D,E01006208,624,185,101,84,412,67,207,53,122,32,52,24,22,6,81,53,28,5,5,27,13,14
2021,Trafford 022E,E01006211,650,176,90,86,430,49,206,62,114,30,63,31,24,8,109,69,40,3,3,44,18,26
2021,Trafford 023A,E01006093,615,152,84,68,445,68,270,75,157,38,57,33,20,4,49,33,16,1,1,18,9,9
2021,Trafford 023B,E01006191,645,135,89,46,490,96,317,66,190,61,46,20,21,5,30,14,16,1,1,20,9,11
2021,Trafford 023C,E01006192,626,168,118,50,445,84,260,72,140,48,54,27,24,3,45,22,23,2,2,13,7,6
2021,Trafford 023D,E01006205,554,152,100,52,383,101,223,60,119,44,34,11,20,3,24,10,14,1,1,19,10,9
2021,Trafford 023E,E01006209,638,144,110,34,468,107,272,60,153,59,46,19,23,4,42,24,18,1,1,26,12,14
2021,Trafford 024A,E01006078,986,344,101,243,613,40,276,75,170,31,190,145,43,2,101,68,33,6,6,29,7,22
2021,Trafford 024B,E01006080,827,242,105,137,550,66,309,81,182,46,109,68,36,5,63,39,24,3,3,35,10,25
2021,Trafford 024C,E01006089,811,192,77,115,564,45,307,72,203,32,130,82,44,4,75,45,30,7,7,55,19,36
2021,Trafford 024D,E01006193,621,162,99,63,441,73,254,53,158,43,53,33,19,1,59,37,22,2,2,18,12,6
2021,Trafford 024E,E01006194,983,286,100,186,650,34,370,69,263,38,136,81,49,6,107,70,37,3,3,47,15,32
2021,Trafford 025A,E01006074,628,177,98,79,428,49,229,53,154,22,66,37,21,8,82,46,36,2,2,23,15,8
2021,Trafford 025B,E01006075,1036,423,154,269,580,89,318,87,191,40,119,97,18,4,44,27,17,10,10,33,2,31
2021,Trafford 025C,E01006076,816,318,167,151,469,129,227,88,110,29,62,45,16,1,46,29,17,5,5,29,12,17
2021,Trafford 025D,E01006079,1055,264,92,172,765,79,450,111,286,53,152,118,28,6,75,48,27,9,9,26,10,16
2021,Trafford 025E,E01006087,559,105,61,44,424,101,233,72,107,54,56,34,18,4,31,20,11,3,3,30,18,12
2021,Trafford 026A,E01006083,482,81,50,31,379,80,241,61,129,51,26,14,10,2,29,16,13,3,3,22,7,15
2021,Trafford 026B,E01006084,635,116,62,54,493,80,323,80,196,47,40,14,25,1,47,28,19,3,3,26,12,14
2021,Trafford 026C,E01006088,662,179,78,101,463,32,303,81,187,35,70,40,27,3,55,38,17,3,3,20,6,14
2021,Trafford 026D,E01006139,717,185,101,84,508,51,322,76,216,30,78,51,24,3,53,26,27,4,4,24,9,15
2021,Trafford 026E,E01006140,628,128,68,60,477,55,307,62,204,41,57,34,21,2,58,34,24,0,0,23,10,13
2021,Trafford 027A,E01006077,802,327,152,175,443,63,193,50,126,17,112,85,26,1,70,53,17,5,5,32,12,20
2021,Trafford 027B,E01006081,502,82,57,25,399,91,259,71,139,49,25,14,10,1,23,12,11,1,1,21,11,10
2021,Trafford 027C,E01006082,673,216,112,104,442,125,232,75,113,44,45,33,9,3,39,22,17,1,1,15,7,8
2021,Trafford 027D,E01006085,630,180,105,75,443,83,251,70,150,31,68,44,19,5,41,29,12,0,0,7,3,4
2021,Trafford 027E,E01006086,654,177,95,82,442,80,249,62,141,46,39,17,18,4,71,43,28,3,3,35,17,18
2021,Trafford 028A,E01006134,527,83,54,29,405,79,277,65,158,54,23,13,10,0,26,10,16,0,0,39,19,20
2021,Trafford 028B,E01006135,650,149,102,47,473,114,271,65,156,50,39,12,23,4,49,31,18,0,0,28,18,10
2021,Trafford 028C,E01006136,619,132,92,40,449,93,292,74,171,47,24,11,11,2,39,28,11,1,1,38,20,18
2021,Trafford 028D,E01006137,477,88,66,22,346,66,235,58,127,50,14,3,10,1,30,13,17,1,1,43,31,12
2021,Trafford 028E,E01006138,780,276,182,94,474,88,275,63,178,34,42,16,21,5,66,40,26,3,3,30,16,14
2021,Wigan 001A,E01006315,651,160,78,82,473,74,245,88,103,54,110,68,37,5,42,26,16,2,2,18,12,6
2021,Wigan 001B,E01006316,838,194,89,105,625,106,326,113,163,50,138,81,48,9,54,36,18,1,1,19,9,10
2021,Wigan 001C,E01006317,727,242,138,104,464,88,194,76,65,53,99,49,39,11,81,46,35,2,2,21,5,16
2021,Wigan 001D,E01006319,585,103,37,66,459,18,275,86,145,44,111,47,61,3,52,37,15,3,3,23,8,15
2021,Wigan 002A,E01006229,649,204,105,99,427,136,197,75,74,48,53,31,18,4,40,21,19,1,1,18,5,13
2021,Wigan 002B,E01006230,859,181,89,92,646,91,354,123,182,49,132,80,47,5,67,34,33,2,2,32,14,18
2021,Wigan 002C,E01006233,564,111,73,38,440,101,263,94,107,62,43,23,16,4,33,13,20,0,0,13,7,6
2021,Wigan 002D,E01006237,795,191,87,104,589,74,337,106,169,62,123,71,45,7,50,26,24,5,5,15,8,7
2021,Wigan 002E,E01006238,744,321,154,167,397,52,133,55,48,30,98,48,42,8,111,65,46,3,3,26,10,16
2021,Wigan 003A,E01006259,551,140,61,79,394,66,201,72,87,42,78,39,33,6,49,23,26,0,0,17,6,11
2021,Wigan 003B,E01006312,621,173,105,68,434,120,211,83,86,42,49,26,21,2,52,28,24,2,2,14,8,6
2021,Wigan 003C,E01006313,590,162,70,92,405,28,181,48,97,36,93,37,51,5,98,59,39,5,5,23,12,11
2021,Wigan 003D,E01006314,795,247,146,101,520,117,278,112,106,60,82,48,30,4,42,24,18,1,1,28,8,20
2021,Wigan 003E,E01006318,634,176,121,55,436,133,208,76,79,53,56,25,26,5,39,18,21,0,0,22,9,13
2021,Wigan 003F,E01006320,561,142,82,60,404,108,206,75,91,40,47,21,20,6,41,19,22,2,2,15,9,6
2021,Wigan 003G,E01006321,690,189,105,84,470,73,272,116,112,44,67,30,32,5,57,35,22,1,1,31,13,18
2021,Wigan 004A,E01006231,640,176,101,75,438,81,255,107,100,48,59,27,28,4,42,23,19,1,1,26,11,15
2021,Wigan 004B,E01006232,812,198,78,120,584,81,336,119,158,59,104,63,39,2,60,33,27,3,3,30,14,16
2021,Wigan 004C,E01006234,535,167,104,63,354,106,146,48,59,39,41,20,17,4,60,27,33,1,1,14,4,10
2021,Wigan 004D,E01006235,705,270,141,129,413,38,178,61,74,43,90,30,49,11,103,75,28,4,4,22,10,12
2021,Wigan 005A,E01006253,674,209,117,92,451,75,168,69,57,42,94,31,54,9,107,59,48,7,7,14,6,8
2021,Wigan 005B,E01006254,609,174,81,93,409,28,162,42,76,44,87,24,57,6,127,82,45,5,5,26,13,13
2021,Wigan 005C,E01006255,663,197,87,110,441,77,226,81,84,61,72,42,26,4,60,30,30,6,6,25,12,13
2021,Wigan 005D,E01006256,745,188,69,119,534,64,226,90,95,41,144,84,53,7,98,64,34,2,2,23,8,15
2021,Wigan 005E,E01006260,635,188,101,87,421,50,210,77,84,49,71,17,44,10,84,54,30,6,6,26,16,10
2021,Wigan 006A,E01006370,950,453,82,371,450,40,192,58,102,32,128,85,41,2,77,42,35,13,13,47,14,33
2021,Wigan 006B,E01006372,664,142,83,59,491,122,276,99,117,60,56,32,19,5,35,12,23,2,2,31,12,19
2021,Wigan 006C,E01006373,632,170,94,76,439,89,228,71,110,47,79,46,30,3,38,20,18,5,5,23,7,16
2021,Wigan 006D,E01006374,676,213,115,98,458,96,242,93,99,50,84,47,35,2,36,22,14,0,0,5,3,2
2021,Wigan 006E,E01006390,770,280,138,142,461,74,191,84,67,40,84,39,40,5,109,70,39,3,3,29,6,23
2021,Wigan 007A,E01006236,694,194,111,83,474,115,247,93,94,60,72,35,33,4,38,21,17,2,2,26,15,11
2021,Wigan 007B,E01006388,807,255,92,163,523,57,210,77,94,39,143,69,66,8,110,66,44,3,3,29,14,15
2021,Wigan 007C,E01006389,506,91,31,60,394,38,229,80,88,61,66,28,35,3,61,42,19,0,0,21,8,13
2021,Wigan 007D,E01006391,666,170,103,67,467,112,219,99,69,51,71,27,35,9,62,28,34,3,3,29,11,18
2021,Wigan 008A,E01006257,534,169,67,102,353,37,149,47,60,42,103,54,43,6,59,29,30,5,5,12,6,6
2021,Wigan 008B,E01006258,710,250,114,136,440,64,220,74,97,49,87,52,31,4,69,39,30,0,0,20,9,11
2021,Wigan 008C,E01006369,1050,482,94,388,518,28,168,64,89,15,170,97,67,6,137,90,47,15,15,50,14,36
2021,Wigan 008D,E01006371,646,207,77,130,406,38,188,72,73,43,106,61,41,4,69,40,29,5,5,33,18,15
2021,Wigan 008E,E01006375,741,243,75,168,453,55,232,90,104,38,96,55,34,7,67,39,28,3,3,45,17,28
2021,Wigan 009A,E01006306,832,456,148,308,337,33,110,48,44,18,91,52,33,6,94,51,43,9,9,39,14,25
2021,Wigan 009B,E01006307,609,203,77,126,378,47,176,66,64,46,85,35,39,11,68,40,28,2,2,28,12,16
2021,Wigan 009C,E01006386,932,593,190,403,316,35,95,44,32,19,64,38,23,3,114,61,53,8,8,23,7,16
2021,Wigan 009D,E01006387,574,174,73,101,379,39,146,67,44,35,92,44,43,5,99,66,33,3,3,21,11,10
2021,Wigan 009E,E01006392,598,207,55,152,357,15,144,39,77,28,84,31,42,11,107,77,30,7,7,34,25,9
2021,Wigan 010A,E01006350,738,229,106,123,467,32,156,48,77,31,115,41,66,8,154,114,40,10,10,42,20,22
2021,Wigan 010B,E01006351,869,274,88,186,545,30,165,59,79,27,133,43,77,13,209,140,69,8,8,50,27,23
2021,Wigan 010C,E01006357,641,174,99,75,427,28,148,36,76,36,104,26,68,10,145,108,37,2,2,40,27,13
2021,Wigan 010D,E01006360,691,214,62,152,437,22,133,50,42,41,125,37,75,13,145,95,50,12,12,40,26,14
2021,Wigan 010E,E01006361,658,196,58,138,424,26,137,42,69,26,113,40,63,10,141,100,41,7,7,38,21,17
2021,Wigan 011A,E01006356,572,165,66,99,367,31,161,49,59,53,83,29,41,13,92,54,38,0,0,40,24,16
2021,Wigan 011B,E01006396,602,141,68,73,437,73,220,84,93,43,88,51,31,6,54,29,25,2,2,24,11,13
2021,Wigan 011C,E01006397,568,272,135,137,295,34,129,48,55,26,68,34,29,5,63,40,23,1,1,1,0,1
2021,Wigan 011D,E01006398,488,192,74,118,277,31,115,43,49,23,71,30,34,7,58,36,22,2,2,19,5,14
2021,Wigan 011E,E01006399,698,213,86,127,457,53,213,63,106,44,107,66,38,3,77,49,28,7,7,28,13,15
2021,Wigan 012A,E01006305,670,193,65,128,431,35,160,39,75,46,88,23,56,9,139,83,56,9,9,46,30,16
2021,Wigan 012B,E01006308,698,226,69,157,426,38,164,62,70,32,115,47,55,13,99,60,39,10,10,46,25,21
2021,Wigan 012C,E01006309,651,161,45,116,459,20,190,58,87,45,112,43,58,11,133,90,43,4,4,31,18,13
2021,Wigan 012D,E01006310,710,268,110,158,408,42,146,43,71,32,105,44,49,12,109,68,41,6,6,34,19,15
2021,Wigan 012E,E01006311,634,186,83,103,408,49,168,67,66,35,88,32,49,7,99,62,37,4,4,40,24,16
2021,Wigan 013A,E01006269,819,309,148,161,473,77,206,76,78,52,91,42,45,4,90,58,32,9,9,37,14,23
2021,Wigan 013B,E01006271,749,222,85,137,500,82,244,101,86,57,104,62,35,7,69,34,35,1,1,27,13,14
2021,Wigan 013C,E01006272,758,294,78,216,440,41,202,77,82,43,104,52,48,4,89,59,30,4,4,24,9,15
2021,Wigan 013D,E01006273,655,212,92,120,415,61,163,64,57,42,90,48,39,3,100,65,35,1,1,28,14,14
2021,Wigan 013E,E01006276,890,234,95,139,620,46,334,113,159,62,130,70,53,7,105,63,42,5,5,36,18,18
2021,Wigan 014A,E01006353,663,205,81,124,426,72,187,80,60,47,90,46,35,9,70,35,35,7,7,32,12,20
2021,Wigan 014B,E01006354,629,220,119,101,388,42,153,60,56,37,99,36,55,8,88,57,31,6,6,21,12,9
2021,Wigan 014C,E01006355,695,236,89,147,435,76,173,72,56,45,111,58,49,4,73,40,33,2,2,24,13,11
2021,Wigan 014D,E01006358,927,309,130,179,579,59,224,79,100,45,174,78,82,14,117,75,42,5,5,39,21,18
2021,Wigan 014E,E01006359,591,187,83,104,373,47,149,52,62,35,77,26,43,8,96,62,34,4,4,31,18,13
2021,Wigan 015A,E01006349,1013,401,104,297,545,47,207,82,87,38,189,128,51,10,96,49,47,6,6,67,15,52
2021,Wigan 015B,E01006352,869,253,71,182,571,49,206,99,74,33,166,84,76,6,138,104,34,12,12,45,29,16
2021,Wigan 015C,E01006404,733,245,92,153,455,34,203,53,107,43,108,45,54,9,105,73,32,5,5,33,23,10
2021,Wigan 015D,E01006405,787,297,125,172,453,46,180,70,73,37,123,51,63,9,102,69,33,2,2,37,21,16
2021,Wigan 015E,E01006411,671,301,100,201,344,31,114,42,56,16,72,21,41,10,126,85,41,1,1,26,13,13
2021,Wigan 016A,E01006270,634,240,124,116,353,77,141,49,47,45,64,24,35,5,66,32,34,5,5,41,25,16
2021,Wigan 016B,E01006274,667,233,113,120,408,34,138,40,64,34,113,38,63,12,121,88,33,2,2,26,16,10
2021,Wigan 016C,E01006275,684,236,112,124,419,40,135,33,68,34,93,31,52,10,145,97,48,6,6,29,16,13
2021,Wigan 016D,E01006277,674,98,36,62,549,50,340,107,165,68,106,40,54,12,52,33,19,1,1,27,20,7
2021,Wigan 016E,E01006286,698,232,144,88,436,112,184,72,64,48,81,38,32,11,56,31,25,3,3,30,15,15
2021,Wigan 017A,E01006239,999,452,143,309,511,44,187,55,90,42,105,45,50,10,156,104,52,19,19,36,18,18
2021,Wigan 017B,E01006240,599,149,50,99,409,26,134,41,67,26,107,36,68,3,138,104,34,4,4,41,17,24
2021,Wigan 017C,E01006241,976,236,69,167,692,40,249,69,145,35,218,121,86,11,177,120,57,8,8,48,32,16
2021,Wigan 017D,E01006287,485,107,62,45,348,83,182,67,69,46,47,22,18,7,35,19,16,1,1,30,14,16
2021,Wigan 017E,E01006289,807,346,96,250,423,30,143,51,63,29,104,52,44,8,139,95,44,7,7,38,23,15
2021,Wigan 018A,E01006362,731,208,118,90,505,105,259,94,121,44,86,48,36,2,52,30,22,3,3,18,10,8
2021,Wigan 018B,E01006363,714,225,173,52,467,127,222,89,76,57,70,34,34,2,43,16,27,5,5,22,7,15
2021,Wigan 018C,E01006364,830,293,130,163,511,69,244,73,137,34,91,42,40,9,104,69,35,3,3,26,10,16
2021,Wigan 018D,E01006365,869,172,80,92,676,86,403,110,207,86,97,40,50,7,90,57,33,0,0,21,12,9
2021,Wigan 018E,E01006366,871,312,151,161,539,95,259,86,111,62,102,50,43,9,81,46,35,2,2,20,8,12
2021,Wigan 018F,E01006367,770,195,111,84,560,124,278,105,126,47,91,47,42,2,65,48,17,2,2,15,6,9
2021,Wigan 018G,E01006368,820,229,140,89,576,99,279,94,126,59,112,59,44,9,83,50,33,3,3,15,6,9
2021,Wigan 019A,E01006278,749,220,112,108,493,111,189,84,59,46,99,46,48,5,89,49,40,5,5,36,23,13
2021,Wigan 019B,E01006279,636,136,68,68,474,89,242,86,109,47,87,37,46,4,54,30,24,2,2,26,13,13
2021,Wigan 019C,E01006280,641,190,108,82,429,75,197,80,67,50,73,30,34,9,81,48,33,3,3,22,10,12
2021,Wigan 019D,E01006281,796,178,87,91,581,85,291,113,120,58,129,60,64,5,71,44,27,5,5,37,19,18
2021,Wigan 019E,E01006285,823,191,105,86,598,124,314,142,110,62,104,59,41,4,50,23,27,6,6,34,13,21
2021,Wigan 020A,E01006406,621,163,90,73,442,111,198,81,61,56,73,36,29,8,56,25,31,4,4,16,11,5
2021,Wigan 020B,E01006407,596,141,66,75,431,84,223,81,77,65,75,23,45,7,48,26,22,1,1,24,11,13
2021,Wigan 020C,E01006408,704,172,68,104,499,46,198,62,83,53,112,39,65,8,142,92,50,1,1,33,17,16
2021,Wigan 020D,E01006409,575,145,92,53,417,104,201,78,65,58,69,30,29,10,42,17,25,1,1,13,4,9
2021,Wigan 020E,E01006410,534,121,75,46,395,85,238,86,82,70,37,16,20,1,29,14,15,6,6,18,8,10
2021,Wigan 021A,E01006393,607,167,90,77,431,88,219,79,77,63,83,44,33,6,41,22,19,0,0,9,3,6
2021,Wigan 021B,E01006394,643,150,99,51,469,120,229,77,102,50,64,31,28,5,55,27,28,1,1,24,13,11
2021,Wigan 021C,E01006395,932,118,41,77,784,72,523,125,286,112,119,50,57,12,70,48,22,0,0,30,16,14
2021,Wigan 021D,E01006400,729,114,46,68,593,66,348,84,201,63,116,55,56,5,62,44,18,1,1,22,13,9
2021,Wigan 021E,E01006401,558,143,75,68,390,79,206,62,92,52,65,29,30,6,39,21,18,1,1,25,14,11
2021,Wigan 021F,E01006402,471,112,75,37,344,84,184,62,66,56,49,19,25,5,27,8,19,0,0,15,9,6
2021,Wigan 021G,E01006403,680,139,86,53,507,127,253,83,99,71,70,34,28,8,55,20,35,2,2,34,13,21
2021,Wigan 022A,E01006290,625,189,97,92,411,107,191,68,84,39,67,31,29,7,44,26,18,2,2,25,15,10
2021,Wigan 022B,E01006291,688,244,91,153,421,47,167,63,60,44,107,51,47,9,98,57,41,2,2,23,10,13
2021,Wigan 022C,E01006292,655,172,106,66,458,96,201,87,62,52,77,38,30,9,79,41,38,5,5,25,16,9
2021,Wigan 022D,E01006293,758,285,112,173,443,61,190,77,85,28,96,46,46,4,92,66,26,4,4,30,11,19
2021,Wigan 023A,E01006242,868,260,109,151,578,87,213,96,84,33,147,88,52,7,127,73,54,4,4,30,19,11
2021,Wigan 023B,E01006243,907,252,105,147,623,88,292,105,134,53,154,69,74,11,85,51,34,4,4,32,15,17
2021,Wigan 023C,E01006244,884,451,204,247,406,61,127,55,49,23,112,61,44,7,102,65,37,4,4,27,10,17
2021,Wigan 023D,E01006245,1157,355,108,247,764,88,343,106,174,63,196,100,80,16,135,94,41,2,2,38,15,23
2021,Wigan 024A,E01006213,699,270,88,182,394,28,161,55,67,39,78,30,38,10,122,95,27,5,5,35,14,21
2021,Wigan 024B,E01006215,757,299,109,190,418,44,169,65,72,32,101,51,48,2,99,62,37,5,5,40,20,20
2021,Wigan 024C,E01006217,935,228,96,132,667,64,297,80,159,58,160,57,85,18,135,94,41,11,11,40,20,20
2021,Wigan 024D,E01006218,995,283,67,216,655,40,277,90,145,42,199,89,99,11,138,99,39,1,1,57,27,30
2021,Wigan 024E,E01006219,522,137,61,76,364,81,160,63,57,40,52,26,20,6,66,36,30,5,5,21,12,9
2021,Wigan 025A,E01006288,758,233,106,127,485,70,151,60,64,27,113,40,69,4,145,97,48,6,6,40,22,18
2021,Wigan 025B,E01006294,910,321,75,246,555,33,225,93,92,40,145,79,53,13,145,100,45,7,7,34,8,26
2021,Wigan 025C,E01006295,801,345,122,223,437,52,162,46,69,47,113,60,46,7,105,59,46,5,5,19,6,13
2021,Wigan 025D,E01006377,658,167,95,72,462,99,249,83,106,60,72,35,32,5,42,16,26,0,0,29,13,16
2021,Wigan 025E,E01006378,595,179,119,60,395,88,198,89,73,36,69,29,36,4,40,13,27,0,0,21,7,14
2021,Wigan 026A,E01006212,582,143,90,53,417,101,187,70,81,36,72,31,35,6,56,29,27,1,1,22,12,10
2021,Wigan 026B,E01006214,609,205,50,155,383,39,150,53,56,41,89,35,46,8,102,69,33,3,3,21,10,11
2021,Wigan 026C,E01006216,872,197,78,119,639,77,315,108,158,49,148,71,65,12,94,55,39,5,5,36,25,11
2021,Wigan 026D,E01006322,875,232,59,173,592,37,225,83,106,36,201,100,88,13,127,87,40,2,2,51,27,24
2021,Wigan 026E,E01006329,487,151,45,106,308,32,142,47,58,37,63,28,28,7,68,41,27,3,3,28,15,13
2021,Wigan 027A,E01006282,749,198,93,105,524,75,236,85,110,41,114,53,56,5,94,63,31,5,5,27,15,12
2021,Wigan 027B,E01006283,719,260,76,184,427,33,163,63,73,27,107,48,54,5,120,83,37,4,4,32,13,19
2021,Wigan 027C,E01006284,675,226,81,145,416,48,191,69,81,41,87,39,41,7,87,46,41,3,3,33,21,12
2021,Wigan 027D,E01006336,701,262,87,175,409,29,133,43,66,24,99,35,60,4,132,89,43,16,16,30,21,9
2021,Wigan 027E,E01006337,669,202,84,118,444,68,218,95,88,35,83,35,37,11,72,37,35,3,3,23,9,14
2021,Wigan 028A,E01006376,739,239,91,148,468,41,195,57,101,37,94,33,54,7,136,86,50,2,2,32,19,13
2021,Wigan 028B,E01006381,772,143,38,105,600,53,380,120,200,60,89,40,46,3,77,49,28,1,1,29,14,15
2021,Wigan 028C,E01006382,511,97,67,30,397,99,219,73,90,56,46,12,33,1,33,20,13,0,0,17,12,5
2021,Wigan 028D,E01006383,629,133,62,71,467,52,255,81,125,49,87,35,41,11,72,39,33,1,1,29,17,12
2021,Wigan 028E,E01006384,586,173,77,96,399,63,217,87,83,47,73,28,41,4,43,15,28,3,3,14,6,8
2021,Wigan 029A,E01006250,915,232,84,148,663,114,321,111,166,44,158,81,71,6,70,39,31,0,0,20,7,13
2021,Wigan 029B,E01006251,655,167,78,89,458,71,229,93,92,44,102,57,38,7,55,29,26,1,1,30,13,17
2021,Wigan 029C,E01006379,689,186,102,84,480,87,217,73,99,45,98,47,47,4,77,42,35,1,1,23,8,15
2021,Wigan 029D,E01006380,1148,293,121,172,803,44,350,124,178,48,252,130,107,15,153,97,56,4,4,52,23,29
2021,Wigan 029E,E01006385,602,131,83,48,447,108,220,79,95,46,72,31,35,6,46,23,23,1,1,24,9,15
2021,Wigan 030A,E01006328,702,280,75,205,380,24,138,51,62,25,105,47,53,5,105,69,36,8,8,42,19,23
2021,Wigan 030B,E01006333,1013,455,95,360,518,45,205,77,99,29,141,84,51,6,114,82,32,13,13,40,18,22
2021,Wigan 030C,E01006334,1000,404,91,313,543,27,176,71,78,27,173,90,73,10,150,101,49,17,17,53,18,35
2021,Wigan 030D,E01006338,783,303,97,206,446,41,163,72,61,30,139,58,79,2,100,66,34,3,3,34,19,15
2021,Wigan 031A,E01006248,1021,359,76,283,634,32,193,65,93,35,228,90,131,7,176,123,53,5,5,28,15,13
2021,Wigan 031B,E01006249,665,171,73,98,459,55,181,65,84,32,107,39,60,8,111,75,36,5,5,35,20,15
2021,Wigan 031C,E01006330,670,153,82,71,497,120,253,106,85,62,77,43,33,1,47,27,20,0,0,20,10,10
2021,Wigan 031D,E01006331,640,133,73,60,493,95,272,104,97,71,71,33,33,5,52,26,26,3,3,14,9,5
2021,Wigan 031E,E01006332,911,393,93,300,491,47,226,86,96,44,131,69,52,10,77,49,28,10,10,27,13,14
2021,Wigan 032A,E01006262,704,192,72,120,483,37,197,66,82,49,130,65,56,9,116,78,38,3,3,29,16,13
2021,Wigan 032B,E01006263,639,172,116,56,447,130,226,64,90,72,46,20,24,2,44,17,27,1,1,20,9,11
2021,Wigan 032C,E01006266,627,173,128,45,432,125,184,86,51,47,70,26,35,9,52,19,33,1,1,22,9,13
2021,Wigan 032D,E01006267,730,294,147,147,408,51,148,50,59,39,88,21,54,13,115,80,35,6,6,28,12,16
2021,Wigan 032E,E01006268,702,219,100,119,462,63,231,72,97,62,82,32,42,8,82,56,26,4,4,21,10,11
2021,Wigan 033A,E01006323,642,185,81,104,431,47,166,63,74,29,104,43,52,9,110,69,41,4,4,26,18,8
2021,Wigan 033B,E01006324,634,253,97,156,353,52,146,67,45,34,72,36,33,3,77,47,30,6,6,28,9,19
2021,Wigan 033C,E01006325,636,161,72,89,442,64,199,85,60,54,93,42,41,10,83,50,33,3,3,33,16,17
2021,Wigan 033D,E01006326,699,295,92,203,370,30,117,48,36,33,104,51,47,6,112,68,44,7,7,34,8,26
2021,Wigan 033E,E01006327,1054,323,130,193,677,27,248,82,129,37,239,121,110,8,158,100,58,5,5,54,23,31
2021,Wigan 034A,E01006246,717,253,96,157,444,78,175,70,75,30,90,40,44,6,96,51,45,5,5,20,10,10
2021,Wigan 034B,E01006247,552,145,83,62,385,75,187,79,52,56,68,30,33,5,55,27,28,0,0,22,9,13
2021,Wigan 034C,E01006252,624,187,97,90,409,103,189,68,75,46,72,23,37,12,45,25,20,0,0,28,11,17
2021,Wigan 034D,E01006297,739,284,91,193,420,28,132,41,57,34,98,35,55,8,156,103,53,6,6,35,20,15
2021,Wigan 034E,E01006335,765,313,82,231,421,35,154,75,48,31,128,54,61,13,100,65,35,4,4,31,12,19
2021,Wigan 035A,E01006220,762,246,115,131,491,76,186,74,65,47,103,36,57,10,124,75,49,2,2,25,13,12
2021,Wigan 035B,E01006221,695,191,89,102,488,89,217,90,82,45,92,48,37,7,85,51,34,5,5,16,7,9
2021,Wigan 035C,E01006222,634,136,86,50,474,102,263,85,113,65,57,24,26,7,50,25,25,2,2,24,9,15
2021,Wigan 035D,E01006224,501,59,28,31,419,34,260,84,122,54,69,26,32,11,55,37,18,1,1,23,11,12
2021,Wigan 035E,E01006226,756,221,112,109,503,101,240,88,111,41,78,38,34,6,79,48,31,5,5,32,15,17
2021,Wigan 036A,E01006223,755,295,94,201,438,59,181,74,70,37,121,69,40,12,71,41,30,6,6,22,4,18
2021,Wigan 036B,E01006225,639,173,96,77,441,118,217,77,92,48,61,32,23,6,44,25,19,1,1,25,14,11
2021,Wigan 036C,E01006261,649,201,120,81,428,76,166,57,64,45,88,36,43,9,91,47,44,7,7,20,8,12
2021,Wigan 036D,E01006264,515,96,71,25,409,101,225,86,83,56,38,20,15,3,44,20,24,1,1,10,6,4
2021,Wigan 036E,E01006265,623,192,83,109,408,72,169,66,69,34,75,37,30,8,90,53,37,2,2,23,6,17
2021,Wigan 037A,E01006296,688,250,71,179,414,26,148,48,68,32,111,41,61,9,124,77,47,5,5,24,12,12
2021,Wigan 037B,E01006298,678,292,128,164,365,39,130,35,64,31,83,43,32,8,109,69,40,4,4,21,12,9
2021,Wigan 037C,E01006299,873,284,119,165,560,88,269,86,136,47,119,63,41,15,80,48,32,4,4,29,11,18
2021,Wigan 037D,E01006300,607,174,127,47,416,120,225,73,99,53,42,18,19,5,29,12,17,0,0,17,4,13
2021,Wigan 037E,E01006301,589,107,72,35,463,97,261,86,121,54,68,32,27,9,35,15,20,2,2,19,8,11
2021,Wigan 038A,E01006227,631,140,63,77,465,74,232,87,94,51,81,31,40,10,77,48,29,1,1,26,14,12
2021,Wigan 038B,E01006228,745,257,79,178,463,54,179,84,67,28,119,53,59,7,108,81,27,3,3,25,12,13
2021,Wigan 038C,E01006342,705,256,123,133,424,52,164,61,67,36,103,47,46,10,101,59,42,4,4,25,11,14
2021,Wigan 038D,E01006344,575,159,96,63,381,53,139,43,59,37,77,29,42,6,107,63,44,5,5,35,19,16
2021,Wigan 038E,E01006346,944,334,127,207,570,68,253,93,118,42,153,82,66,5,93,62,31,3,3,40,24,16
2021,Wigan 039A,E01006339,577,168,105,63,394,118,181,78,61,42,51,23,23,5,42,17,25,2,2,15,7,8
2021,Wigan 039B,E01006340,821,238,96,142,552,60,238,92,95,51,162,94,59,9,89,48,41,3,3,31,15,16
2021,Wigan 039C,E01006343,642,127,46,81,488,80,276,94,120,62,76,32,41,3,56,32,24,0,0,27,12,15
2021,Wigan 039D,E01006345,676,181,104,77,468,84,227,90,94,43,81,43,36,2,73,41,32,3,3,27,12,15
2021,Wigan 039E,E01006348,1119,283,108,175,806,126,405,143,200,62,188,114,67,7,85,58,27,2,2,30,12,18
2021,Wigan 040A,E01006302,778,199,72,127,552,70,262,89,120,53,138,82,51,5,81,53,28,1,1,27,15,12
2021,Wigan 040B,E01006303,702,183,88,95,488,94,221,80,95,46,110,54,51,5,62,34,28,1,1,31,16,15
2021,Wigan 040C,E01006304,659,186,90,96,456,90,194,69,85,40,101,54,38,9,70,39,31,1,1,17,9,8
2021,Wigan 040D,E01006341,756,274,129,145,454,59,209,83,89,37,83,40,39,4,101,72,29,2,2,28,18,10
2021,Wigan 040E,E01006347,649,163,121,42,465,112,257,95,112,50,57,29,23,5,39,21,18,0,0,21,9,12
2021,Birmingham 001A,E01009417,639,180,130,50,432,62,264,67,151,46,45,22,17,6,58,33,25,3,3,27,18,9
2021,Birmingham 001B,E01009418,641,167,94,73,447,72,199,50,120,29,67,27,33,7,107,76,31,2,2,27,15,12
2021,Birmingham 001C,E01009419,603,176,89,87,394,83,213,53,116,44,39,21,13,5,55,34,21,4,4,33,18,15
2021,Birmingham 001D,E01009433,753,213,142,71,514,131,302,77,152,73,40,26,11,3,37,15,22,4,4,26,15,11
2021,Birmingham 002A,E01009415,684,155,99,56,506,110,319,88,183,48,37,15,21,1,39,27,12,1,1,23,8,15
2021,Birmingham 002B,E01009422,854,270,160,110,547,125,275,70,158,47,83,46,34,3,60,37,23,4,4,37,19,18
2021,Birmingham 002C,E01009423,758,286,166,120,447,68,205,56,100,49,77,37,31,9,94,58,36,3,3,25,12,13
2021,Birmingham 002D,E01009425,837,336,196,140,476,143,227,69,111,47,41,24,12,5,61,41,20,4,4,25,10,15
2021,Birmingham 003A,E01009416,1067,243,117,126,774,84,474,111,293,70,89,49,38,2,126,89,37,1,1,50,30,20
2021,Birmingham 003B,E01009420,647,146,95,51,476,59,275,63,176,36,74,35,29,10,67,40,27,1,1,25,15,10
2021,Birmingham 003C,E01009426,612,150,102,48,441,116,247,71,127,49,38,19,13,6,40,15,25,0,0,21,9,12
2021,Birmingham 003D,E01009429,580,127,84,43,436,122,250,57,149,44,40,23,15,2,24,13,11,0,0,17,9,8
2021,Birmingham 003E,E01009431,663,159,80,79,482,86,287,74,163,50,55,23,30,2,50,26,24,4,4,22,14,8
2021,Birmingham 004A,E01009421,651,118,90,28,493,150,296,83,140,73,25,11,10,4,20,4,16,2,2,40,21,19
2021,Birmingham 004B,E01009424,721,275,106,169,419,50,220,84,105,31,85,64,19,2,62,34,28,2,2,27,7,20
2021,Birmingham 004C,E01009427,680,256,117,139,393,74,209,67,97,45,60,40,20,0,41,27,14,9,9,31,17,14
2021,Birmingham 004D,E01009428,640,94,73,21,519,154,303,88,150,65,45,22,22,1,17,10,7,0,0,27,18,9
2021,Birmingham 004E,E01009430,683,133,85,48,510,142,274,87,127,60,49,29,16,4,45,22,23,0,0,40,23,17
2021,Birmingham 004F,E01009468,605,156,92,64,424,98,241,70,114,57,47,29,11,7,36,23,13,2,2,25,10,15
2021,Birmingham 005A,E01009445,791,253,95,158,507,19,173,52,85,36,79,40,34,5,234,165,69,2,2,31,16,15
2021,Birmingham 005B,E01009446,1008,293,112,181,667,76,372,101,210,61,98,51,36,11,115,62,53,6,6,48,24,24
2021,Birmingham 005C,E01009447,632,148,77,71,448,52,220,48,125,47,79,33,40,6,91,55,36,6,6,36,14,22
2021,Birmingham 005D,E01009448,672,183,92,91,455,46,200,60,88,52,83,28,46,9,122,59,63,4,4,34,18,16
2021,Birmingham 005E,E01009452,693,199,117,82,448,74,198,44,115,39,70,29,36,5,99,55,44,7,7,46,21,25
2021,Birmingham 005F,E01009455,694,342,147,195,341,56,126,39,57,30,48,28,16,4,104,73,31,7,7,11,5,6
2021,Birmingham 006A,E01009432,648,199,90,109,415,74,200,66,97,37,56,31,20,5,82,56,26,3,3,34,16,18
2021,Birmingham 006B,E01009435,708,169,71,98,511,75,277,76,128,73,94,56,31,7,63,40,23,2,2,28,14,14
2021,Birmingham 006C,E01009437,820,302,184,118,484,116,257,77,126,54,60,37,20,3,49,27,22,2,2,34,16,18
2021,Birmingham 006D,E01009444,605,142,106,36,440,111,251,67,129,55,51,27,21,3,27,18,9,0,0,23,11,12
2021,Birmingham 006E,E01009454,648,222,78,144,408,83,216,61,99,56,57,32,21,4,51,26,25,1,1,18,8,10
2021,Birmingham 007A,E01009221,594,145,79,66,410,54,182,59,74,49,57,16,33,8,112,69,43,5,5,39,23,16
2021,Birmingham 007B,E01009464,542,123,77,46,383,64,233,66,111,56,45,19,15,11,39,17,22,2,2,36,17,19
2021,Birmingham 007C,E01009465,502,64,38,26,401,59,242,62,119,61,54,19,29,6,43,23,20,3,3,37,22,15
2021,Birmingham 007D,E01009467,657,170,96,74,458,104,228,79,95,54,49,18,30,1,72,42,30,5,5,29,16,13
2021,Birmingham 008A,E01009220,618,172,63,109,415,36,186,55,95,36,84,31,42,11,106,67,39,3,3,31,16,15
2021,Birmingham 008B,E01009222,578,148,53,95,392,24,139,35,63,41,65,21,35,9,154,98,56,10,10,38,25,13
2021,Birmingham 008C,E01009224,591,180,101,79,369,40,181,59,80,42,63,24,33,6,83,34,49,2,2,42,20,22
2021,Birmingham 008D,E01009233,626,162,61,101,429,39,137,36,73,28,81,28,42,11,162,119,43,10,10,35,17,18
2021,Birmingham 009A,E01009449,1109,503,164,339,553,69,231,86,115,30,155,124,27,4,90,54,36,8,8,53,11,42
2021,Birmingham 009B,E01009451,640,246,99,147,368,30,171,40,104,27,91,55,28,8,73,55,18,3,3,26,13,13
2021,Birmingham 009C,E01009453,517,99,57,42,392,51,230,58,115,57,61,24,27,10,46,29,17,4,4,26,10,16
2021,Birmingham 009D,E01009466,655,167,92,75,469,83,281,75,150,56,63,31,24,8,42,22,20,0,0,19,6,13
2021,Birmingham 009E,E01009471,722,243,102,141,452,83,272,80,142,50,59,32,22,5,38,18,20,0,0,27,14,13
2021,Birmingham 010A,E01009135,595,189,112,77,356,73,185,70,75,40,51,24,22,5,43,15,28,4,4,50,21,29
2021,Birmingham 010B,E01009469,583,121,76,45,435,116,214,67,107,40,49,25,22,2,50,26,24,6,6,27,16,11
2021,Birmingham 010C,E01009470,533,71,51,20,433,108,264,83,123,58,40,17,19,4,18,11,7,3,3,29,11,18
2021,Birmingham 010D,E01009472,664,165,96,69,468,85,252,56,134,62,80,43,29,8,49,29,20,2,2,31,17,14
2021,Birmingham 010E,E01009473,689,240,111,129,405,65,204,65,102,37,61,38,18,5,72,45,27,3,3,44,20,24
2021,Birmingham 010F,E01009474,639,174,85,89,441,61,266,79,128,59,60,34,21,5,48,32,16,6,6,24,15,9
2021,Birmingham 011A,E01009127,569,155,51,104,344,19,124,30,58,36,55,21,30,4,137,96,41,9,9,70,31,39
2021,Birmingham 011B,E01009128,521,158,49,109,321,16,117,31,58,28,62,14,38,10,117,71,46,9,9,42,24,18
2021,Birmingham 011C,E01009130,598,201,78,123,357,26,132,42,57,33,66,25,32,9,128,88,40,5,5,40,21,19
2021,Birmingham 011D,E01009131,508,108,40,68,347,21,140,34,72,34,49,11,29,9,127,73,54,10,10,53,34,19
2021,Birmingham 011E,E01009133,600,210,74,136,346,14,124,24,70,30,58,18,31,9,144,91,53,6,6,44,30,14
2021,Birmingham 011F,E01009134,655,214,89,125,394,20,159,48,81,30,80,31,38,11,119,83,36,16,16,47,23,24
2021,Birmingham 011G,E01009137,586,150,64,86,383,26,162,35,84,43,64,21,34,9,125,83,42,6,6,53,26,27
2021,Birmingham 012A,E01009434,709,200,83,117,485,51,301,94,150,57,71,49,22,0,59,30,29,3,3,24,13,11
2021,Birmingham 012B,E01009436,556,114,90,24,416,116,227,73,102,52,47,26,18,3,25,14,11,1,1,26,9,17
2021,Birmingham 012C,E01009438,596,168,81,87,411,91,217,80,90,47,66,35,29,2,36,23,13,1,1,17,7,10
2021,Birmingham 012D,E01009440,645,175,112,63,443,107,236,81,106,49,53,28,20,5,45,20,25,2,2,27,11,16
2021,Birmingham 012E,E01009450,669,182,100,82,452,67,235,76,103,56,81,46,32,3,65,33,32,4,4,35,15,20
2021,Birmingham 013A,E01009223,687,231,106,125,418,49,198,53,94,51,81,40,37,4,81,46,35,9,9,38,20,18
2021,Birmingham 013B,E01009225,749,311,167,144,395,49,144,37,74,33,71,32,37,2,124,88,36,7,7,43,18,25
2021,Birmingham 013C,E01009227,711,209,83,126,464,54,224,77,88,59,74,35,36,3,107,62,45,5,5,38,21,17
2021,Birmingham 013D,E01009228,680,224,93,131,416,46,169,52,81,36,88,42,40,6,110,72,38,3,3,40,23,17
2021,Birmingham 014B,E01009122,665,242,88,154,377,20,149,44,74,31,68,30,34,4,135,85,50,5,5,46,24,22
2021,Birmingham 014C,E01009129,567,152,45,107,359,11,146,29,83,34,63,22,38,3,131,74,57,8,8,56,35,21
2021,Birmingham 014D,E01009132,593,178,69,109,372,24,139,38,64,37,65,23,34,8,135,92,43,9,9,43,27,16
2021,Birmingham 014E,E01009136,845,392,171,221,405,50,139,49,66,24,60,33,23,4,146,98,48,10,10,48,22,26
2021,Birmingham 014F,E01034913,430,125,44,81,270,15,105,22,56,27,40,13,22,5,107,66,41,3,3,35,23,12
2021,Birmingham 014G,E01034914,700,202,77,125,448,38,172,34,102,36,62,19,38,5,174,135,39,2,2,50,32,18
2021,Birmingham 015A,E01009457,603,125,90,35,446,140,243,70,108,65,24,11,11,2,38,14,24,1,1,32,19,13
2021,Birmingham 015B,E01009459,638,163,89,74,439,102,248,67,128,53,51,29,17,5,36,18,18,2,2,36,16,20
2021,Birmingham 015C,E01009461,521,108,76,32,386,94,230,75,101,54,33,15,16,2,27,14,13,2,2,27,15,12
2021,Birmingham 015D,E01009463,617,174,107,67,405,102,213,70,92,51,42,24,16,2,41,22,19,7,7,38,21,17
2021,Birmingham 016A,E01009235,629,148,64,84,444,58,214,67,96,51,61,27,27,7,104,54,50,7,7,37,21,16
2021,Birmingham 016B,E01009243,730,215,99,116,465,41,217,59,119,39,92,56,32,4,111,74,37,4,4,50,32,18
2021,Birmingham 016C,E01009245,568,148,66,82,357,41,182,44,86,52,41,21,16,4,84,51,33,9,9,63,24,39
2021,Birmingham 016D,E01009246,666,211,84,127,417,62,203,67,103,33,54,23,27,4,93,50,43,5,5,38,18,20
2021,Birmingham 016E,E01009247,586,128,59,69,401,41,212,59,99,54,41,12,24,5,101,49,52,6,6,57,31,26
2021,Birmingham 017A,E01009226,670,234,95,139,405,42,143,46,66,31,86,40,43,3,124,82,42,10,10,31,12,19
2021,Birmingham 017B,E01009229,656,193,106,87,416,47,172,53,77,42,80,29,49,2,113,70,43,4,4,47,20,27
2021,Birmingham 017C,E01009230,741,242,98,144,457,55,193,72,82,39,84,42,31,11,118,85,33,7,7,42,18,24
2021,Birmingham 017D,E01009231,781,236,129,107,489,77,243,76,108,59,84,30,49,5,82,46,36,3,3,56,22,34
2021,Birmingham 018A,E01009001,716,237,86,151,433,49,187,70,85,32,81,42,29,10,110,70,40,6,6,46,20,26
2021,Birmingham 018B,E01009003,687,262,90,172,369,62,185,64,75,46,66,49,13,4,51,33,18,5,5,56,21,35
2021,Birmingham 018C,E01009456,708,200,107,93,481,73,298,87,150,61,58,29,23,6,51,23,28,1,1,27,7,20
2021,Birmingham 018D,E01009458,737,380,253,127,332,73,165,58,71,36,53,31,18,4,40,19,21,1,1,25,13,12
2021,Birmingham 018E,E01009460,810,399,126,273,370,46,161,66,65,30,86,54,26,6,73,49,24,4,4,41,16,25
2021,Birmingham 018F,E01009462,768,306,125,181,433,60,211,79,94,38,82,54,26,2,73,39,34,7,7,29,10,19
2021,Birmingham 019A,E01009234,611,184,66,118,395,36,160,39,77,44,93,38,49,6,105,72,33,1,1,32,13,19
2021,Birmingham 019B,E01009236,600,146,59,87,419,48,211,51,113,47,56,23,30,3,100,53,47,4,4,35,22,13
2021,Birmingham 019C,E01009244,807,276,107,169,486,40,221,38,137,46,83,36,44,3,128,91,37,14,14,45,27,18
2021,Birmingham 019D,E01009248,705,183,80,103,486,52,215,68,94,53,104,39,55,10,113,70,43,2,2,36,20,16
2021,Birmingham 020A,E01009403,607,181,60,121,382,26,159,39,88,32,77,36,33,8,117,87,30,3,3,44,23,21
2021,Birmingham 020B,E01009404,627,182,64,118,387,21,147,35,76,36,62,24,30,8,153,91,62,4,4,58,36,22
2021,Birmingham 020C,E01009405,606,211,78,133,340,41,133,41,64,28,62,18,36,8,96,61,35,8,8,55,28,27
2021,Birmingham 020D,E01009406,759,300,118,182,407,27,170,50,82,38,77,41,31,5,128,93,35,5,5,52,32,20
2021,Birmingham 020E,E01009407,696,230,75,155,400,36,188,52,104,32,70,37,27,6,100,59,41,6,6,66,29,37
2021,Birmingham 021A,E01009439,603,173,94,79,396,100,192,54,94,44,51,20,24,7,52,34,18,1,1,34,20,14
2021,Birmingham 021B,E01009441,640,201,88,113,406,61,176,56,83,37,87,51,29,7,77,42,35,5,5,33,15,18
2021,Birmingham 021C,E01009442,593,131,90,41,440,86,244,79,105,60,56,26,24,6,50,23,27,4,4,22,12,10
2021,Birmingham 021D,E01009443,522,152,81,71,352,63,182,62,87,33,48,26,16,6,58,38,20,1,1,18,9,9
2021,Birmingham 022A,E01009123,611,191,61,130,359,23,152,30,92,30,63,29,27,7,113,76,37,8,8,61,30,31
2021,Birmingham 022B,E01009124,713,138,23,115,522,6,148,38,89,21,56,10,42,4,300,257,43,12,12,53,37,16
2021,Birmingham 022C,E01009125,681,161,54,107,467,38,223,46,130,47,51,13,32,6,134,73,61,21,21,53,38,15
2021,Birmingham 022D,E01009232,588,171,78,93,377,57,173,45,85,43,63,23,32,8,76,43,33,8,8,40,21,19
2021,Birmingham 023A,E01009002,786,219,74,145,524,17,149,33,96,20,89,29,55,5,259,214,45,10,10,43,19,24
2021,Birmingham 023C,E01009006,748,292,61,231,398,31,148,61,70,17,103,61,35,7,102,60,42,14,14,58,16,42
2021,Birmingham 023D,E01009007,902,423,77,346,418,13,141,53,71,17,119,70,41,8,124,78,46,21,21,61,15,46
2021,Birmingham 023G,E01034915,632,122,27,95,475,3,136,15,112,9,84,23,58,3,250,225,25,2,2,35,19,16
2021,Birmingham 023H,E01034916,654,251,102,149,342,46,168,60,73,35,65,36,27,2,59,31,28,4,4,61,20,41
2021,Birmingham 024A,E01009237,579,182,78,104,351,25,166,42,88,36,39,11,22,6,103,59,44,18,18,46,29,17
2021,Birmingham 024B,E01009238,631,174,102,72,379,63,196,41,110,45,38,16,18,4,76,35,41,6,6,78,54,24
2021,Birmingham 024C,E01009240,597,167,68,99,387,52,193,43,110,40,41,18,21,2,93,51,42,8,8,43,26,17
2021,Birmingham 024D,E01009241,591,129,48,81,384,31,217,50,130,37,44,13,24,7,86,55,31,6,6,78,49,29
2021,Birmingham 024E,E01009242,637,138,65,73,382,28,223,34,137,52,41,17,21,3,79,45,34,11,11,117,64,53
2021,Birmingham 025A,E01009005,727,257,93,164,431,31,188,54,99,35,94,57,33,4,104,73,31,14,14,39,25,14
2021,Birmingham 025B,E01009009,628,206,86,120,379,56,187,71,77,39,50,22,22,6,84,47,37,2,2,43,29,14
2021,Birmingham 025C,E01009098,935,364,145,219,521,36,219,76,103,40,106,38,59,9,155,91,64,5,5,50,24,26
2021,Birmingham 025D,E01009100,817,277,114,163,479,41,200,73,84,43,89,43,36,10,140,88,52,9,9,61,33,28
2021,Birmingham 025E,E01009105,741,194,90,104,505,56,220,73,98,49,106,48,49,9,118,87,31,5,5,42,20,22
2021,Birmingham 026A,E01009126,542,124,59,65,366,50,189,49,100,40,65,25,31,9,58,37,21,4,4,52,32,20
2021,Birmingham 026B,E01009408,659,209,65,144,371,21,186,37,114,35,46,17,22,7,112,63,49,6,6,79,42,37
2021,Birmingham 026C,E01009409,841,359,95,264,379,23,126,42,64,20,80,47,23,10,130,90,40,20,20,103,41,62
2021,Birmingham 026D,E01009410,814,334,158,176,400,48,175,49,85,41,57,31,23,3,108,73,35,12,12,80,34,46
2021,Birmingham 029A,E01009096,774,313,116,197,423,34,122,37,49,36,89,35,38,16,152,97,55,26,26,38,20,18
2021,Birmingham 029B,E01009097,772,208,80,128,502,34,149,37,70,42,72,16,45,11,237,161,76,10,10,62,37,25
2021,Birmingham 029C,E01009099,800,347,89,258,412,20,100,37,40,23,84,26,50,8,207,151,56,1,1,41,23,18
2021,Birmingham 029D,E01009101,609,198,100,98,375,42,126,40,51,35,63,23,35,5,144,82,62,0,0,36,25,11
2021,Birmingham 029E,E01009103,682,250,130,120,391,33,108,26,48,34,62,20,29,13,183,120,63,5,5,41,25,16
2021,Birmingham 029F,E01009106,571,168,76,92,365,51,147,46,48,53,60,27,25,8,107,67,40,0,0,38,22,16
2021,Birmingham 030A,E01008915,559,125,42,83,356,14,198,31,146,21,29,11,17,1,106,83,23,9,9,78,39,39
2021,Birmingham 030B,E01009411,873,354,96,258,465,30,200,66,93,41,92,42,47,3,132,82,50,11,11,54,32,22
2021,Birmingham 030C,E01009412,645,196,53,143,311,18,147,42,79,26,44,25,17,2,89,47,42,13,13,138,43,95
2021,Birmingham 030D,E01009413,669,201,43,158,383,21,182,38,99,45,47,23,21,3,121,63,58,12,12,85,29,56
2021,Birmingham 030E,E01009414,863,240,38,202,513,23,236,64,135,37,89,35,50,4,147,95,52,18,18,110,53,57
2021,Birmingham 031A,E01008998,648,181,51,130,383,21,171,24,117,30,48,16,29,3,133,74,59,10,10,84,40,44
2021,Birmingham 031B,E01008999,519,127,46,81,316,21,156,33,81,42,33,13,15,5,96,46,50,10,10,76,45,31
2021,Birmingham 031C,E01009000,847,444,98,346,347,31,136,58,57,21,67,41,20,6,105,68,37,8,8,56,20,36
2021,Birmingham 031D,E01009013,898,382,100,282,437,27,156,47,74,35,105,65,35,5,133,81,52,16,16,79,22,57
2021,Birmingham 031E,E01009400,576,160,58,102,326,19,140,34,81,25,60,27,26,7,98,58,40,9,9,90,36,54
2021,Birmingham 031F,E01009401,637,200,37,163,333,25,125,29,70,26,66,24,34,8,101,65,36,16,16,104,49,55
2021,Birmingham 031H,E01033630,598,269,30,239,287,2,105,41,52,12,58,45,11,2,110,84,26,12,12,42,12,30
2021,Birmingham 031I,E01033646,851,446,65,381,324,10,102,36,50,16,73,51,18,4,126,88,38,13,13,81,32,49
2021,Birmingham 032A,E01009049,576,222,86,136,274,19,159,20,95,44,22,8,10,4,65,32,33,9,9,80,45,35
2021,Birmingham 032B,E01009056,751,269,52,217,374,14,168,34,96,38,44,21,23,0,142,108,34,6,6,108,69,39
2021,Birmingham 032C,E01009263,628,245,57,188,321,24,156,49,74,33,27,14,12,1,107,75,32,7,7,62,35,27
2021,Birmingham 032D,E01009264,683,405,63,342,257,6,116,56,52,8,46,34,11,1,77,58,19,12,12,21,10,11
2021,Birmingham 032E,E01009265,593,195,55,140,285,25,171,31,96,44,17,7,8,2,65,39,26,7,7,113,60,53
2021,Birmingham 033A,E01009051,542,126,46,80,323,15,187,24,123,40,19,6,11,2,82,37,45,20,20,93,61,32
2021,Birmingham 033B,E01009053,441,76,32,44,302,13,168,17,129,22,11,3,7,1,105,67,38,5,5,63,48,15
2021,Birmingham 033C,E01009054,433,70,31,39,262,25,167,19,94,54,12,3,9,0,52,20,32,6,6,101,67,34
2021,Birmingham 033D,E01009058,500,88,30,58,302,6,230,24,169,37,15,3,12,0,42,25,17,9,9,110,78,32
2021,Birmingham 033E,E01009061,458,73,31,42,270,9,172,14,122,36,5,0,5,0,75,35,40,9,9,115,90,25
2021,Birmingham 033F,E01009239,557,198,66,132,288,13,135,34,77,24,50,38,10,2,71,48,23,19,19,71,30,41
2021,Birmingham 034A,E01009266,591,157,47,110,348,21,182,27,110,45,29,4,22,3,111,68,43,5,5,86,50,36
2021,Birmingham 034B,E01009269,501,121,36,85,297,19,145,26,101,18,22,4,16,2,104,69,35,7,7,83,44,39
2021,Birmingham 034C,E01009270,632,197,46,151,328,13,166,12,119,35,22,8,12,2,120,73,47,7,7,107,70,37
2021,Birmingham 034D,E01009271,513,119,43,76,314,14,171,8,125,38,29,11,15,3,90,48,42,10,10,80,57,23
2021,Birmingham 034E,E01009273,494,104,42,62,289,26,144,18,83,43,26,10,14,2,70,29,41,23,23,101,66,35
2021,Birmingham 035A,E01009050,748,194,51,143,461,18,228,37,146,45,44,32,9,3,160,118,42,11,11,93,55,38
2021,Birmingham 035D,E01009057,625,206,49,157,341,13,166,16,124,26,31,8,20,3,124,88,36,7,7,78,53,25
2021,Birmingham 035E,E01009059,570,200,39,161,275,7,131,13,89,29,18,4,10,4,106,62,44,13,13,95,69,26
2021,Birmingham 035F,E01009060,478,105,24,81,271,4,148,27,98,23,10,3,7,0,99,65,34,10,10,102,70,32
2021,Birmingham 035H,E01034917,507,135,28,107,296,12,149,21,94,34,18,5,13,0,102,69,33,15,15,76,47,29
2021,Birmingham 035I,E01034918,549,206,36,170,248,21,143,18,90,35,18,5,12,1,63,44,19,3,3,95,64,31
2021,Birmingham 036A,E01009268,432,64,35,29,292,24,195,26,93,76,20,3,11,6,50,21,29,3,3,76,51,25
2021,Birmingham 036B,E01009272,470,118,35,83,293,13,138,12,88,38,32,14,16,2,103,61,42,7,7,59,30,29
2021,Birmingham 036C,E01009274,706,206,72,134,388,19,185,21,110,54,35,27,8,0,134,71,63,15,15,112,69,43
2021,Birmingham 036D,E01009349,562,137,32,105,353,12,157,18,119,20,31,8,16,7,140,92,48,13,13,72,39,33
2021,Birmingham 036E,E01009351,550,112,30,82,378,13,197,21,144,32,22,8,13,1,137,98,39,9,9,60,33,27
2021,Birmingham 036F,E01009354,508,172,80,92,248,9,126,27,81,18,23,8,14,1,77,45,32,13,13,88,52,36
2021,Birmingham 037A,E01008899,457,185,59,126,235,10,119,14,95,10,24,13,6,5,71,44,27,11,11,37,26,11
2021,Birmingham 037C,E01008901,606,217,53,164,313,19,162,24,106,32,9,2,5,2,110,46,64,13,13,76,56,20
2021,Birmingham 037E,E01008916,484,108,22,86,295,7,159,12,125,22,16,3,12,1,102,81,21,11,11,81,58,23
2021,Birmingham 037G,E01034919,480,124,60,64,263,7,176,17,117,42,16,5,8,3,59,26,33,5,5,93,65,28
2021,Birmingham 037H,E01034920,412,47,16,31,233,6,149,8,116,25,9,4,4,1,61,21,40,8,8,132,98,34
2021,Birmingham 039A,E01009275,501,105,34,71,288,15,161,19,114,28,26,11,12,3,72,47,25,14,14,108,68,40
2021,Birmingham 039B,E01009350,474,108,40,68,286,6,155,18,106,31,16,5,8,3,96,58,38,13,13,80,55,25
2021,Birmingham 039C,E01009352,485,124,33,91,221,11,116,11,71,34,6,1,5,0,73,42,31,15,15,140,83,57
2021,Birmingham 039D,E01009353,473,94,30,64,278,10,160,19,108,33,12,5,7,0,90,57,33,6,6,101,62,39
2021,Birmingham 039E,E01009355,474,152,23,129,228,9,92,21,44,27,20,12,5,3,86,59,27,21,21,94,65,29
2021,Birmingham 039I,E01034921,435,76,23,53,285,14,166,20,116,30,17,0,15,2,74,49,25,14,14,74,45,29
2021,Birmingham 039J,E01034922,524,116,31,85,332,18,150,21,99,30,24,1,19,4,128,69,59,12,12,76,51,25
2021,Birmingham 040A,E01008905,485,65,21,44,321,7,206,20,156,30,14,3,10,1,87,46,41,7,7,99,72,27
2021,Birmingham 040B,E01008907,620,207,62,145,318,5,144,22,94,28,27,18,8,1,132,97,35,10,10,95,47,48
2021,Birmingham 040C,E01009047,552,192,40,152,248,10,153,20,107,26,15,6,8,1,56,31,25,14,14,112,71,41
2021,Birmingham 040D,E01009048,641,243,37,206,281,10,138,15,92,31,17,6,10,1,101,59,42,15,15,117,57,60
2021,Birmingham 040E,E01009062,511,112,27,85,308,7,182,28,126,28,19,7,11,1,90,45,45,10,10,91,63,28
2021,Birmingham 041D,E01008909,550,97,23,74,365,4,195,16,155,24,21,6,15,0,131,86,45,14,14,88,63,25
2021,Birmingham 041H,E01034923,526,178,56,122,268,4,150,16,106,28,8,2,6,0,92,48,44,14,14,80,55,25
2021,Birmingham 041I,E01034924,438,145,25,120,200,7,113,9,77,27,5,1,4,0,70,26,44,5,5,93,68,25
2021,Birmingham 041J,E01034925,535,156,54,102,317,8,183,27,146,10,29,4,25,0,88,55,33,9,9,62,47,15
2021,Birmingham 041K,E01034926,533,210,82,128,264,11,130,7,103,20,12,1,9,2,101,45,56,10,10,59,39,20
2021,Birmingham 042A,E01009084,528,87,43,44,355,27,226,22,151,53,33,9,22,2,62,46,16,7,7,86,61,25
2021,Birmingham 042B,E01009085,494,68,39,29,295,35,191,17,128,46,16,4,4,8,47,27,20,6,6,131,96,35
2021,Birmingham 042C,E01009087,579,135,70,65,392,45,221,39,151,31,38,14,15,9,82,47,35,6,6,52,36,16
2021,Birmingham 042D,E01009089,489,68,38,30,358,40,227,29,159,39,20,9,8,3,68,47,21,3,3,63,46,17
2021,Birmingham 042E,E01009090,541,106,59,47,300,19,217,34,148,35,11,3,7,1,42,28,14,11,11,135,97,38
2021,Birmingham 043A,E01009201,714,259,98,161,389,17,144,18,107,19,38,11,19,8,163,97,66,27,27,66,36,30
2021,Birmingham 043B,E01009202,635,214,60,154,363,16,141,22,105,14,40,11,22,7,157,115,42,9,9,58,39,19
2021,Birmingham 043D,E01034927,642,233,66,167,356,9,123,22,88,13,21,6,15,0,195,159,36,8,8,53,32,21
2021,Birmingham 043E,E01034928,498,150,22,128,307,5,119,6,104,9,18,4,13,1,157,128,29,8,8,41,20,21
2021,Birmingham 044A,E01009082,497,109,58,51,348,22,158,25,97,36,31,8,18,5,134,78,56,3,3,40,30,10
2021,Birmingham 044B,E01009086,628,132,42,90,417,25,286,51,183,52,15,5,7,3,87,53,34,4,4,79,57,22
2021,Birmingham 044C,E01009480,582,94,43,51,417,16,251,46,174,31,42,13,26,3,96,64,32,12,12,71,48,23
2021,Birmingham 044D,E01009481,716,115,51,64,482,19,317,40,235,42,22,7,9,6,114,65,49,10,10,119,90,29
2021,Birmingham 044E,E01009486,609,112,43,69,396,15,219,28,161,30,21,9,11,1,128,96,32,13,13,101,63,38
2021,Birmingham 044F,E01009487,571,87,33,54,383,12,254,27,174,53,16,2,9,5,90,59,31,11,11,101,71,30
2021,Birmingham 045A,E01009088,684,262,153,109,378,70,165,46,80,39,51,21,26,4,88,51,37,4,4,44,24,20
2021,Birmingham 045B,E01009091,657,214,83,131,396,43,160,36,87,37,69,24,34,11,115,74,41,9,9,47,29,18
2021,Birmingham 045C,E01009305,702,237,81,156,424,19,129,37,65,27,80,34,40,6,178,138,40,18,18,41,26,15
2021,Birmingham 045D,E01009307,727,292,113,179,403,34,134,48,58,28,89,31,47,11,143,94,49,3,3,32,11,21
2021,Birmingham 045E,E01009309,782,294,110,184,451,23,166,49,91,26,86,38,43,5,173,129,44,3,3,37,19,18
2021,Birmingham 046A,E01009304,810,277,114,163,479,32,151,51,71,29,120,49,57,14,174,108,66,2,2,54,25,29
2021,Birmingham 046B,E01009306,711,252,106,146,413,52,161,46,70,45,78,35,37,6,119,80,39,3,3,46,23,23
2021,Birmingham 046C,E01009308,765,230,95,135,494,31,166,49,93,24,106,36,59,11,187,135,52,4,4,41,24,17
2021,Birmingham 046D,E01009310,806,256,107,149,494,37,166,49,84,33,91,35,48,8,194,138,56,6,6,56,32,24
2021,Birmingham 047A,E01009348,818,317,75,242,416,22,142,31,85,26,55,31,17,7,177,105,72,20,20,85,46,39
2021,Birmingham 047B,E01009358,742,251,49,202,385,13,174,21,107,46,30,12,14,4,125,84,41,43,43,106,56,50
2021,Birmingham 047C,E01009359,691,171,36,135,427,26,200,26,140,34,28,7,18,3,162,117,45,11,11,93,49,44
2021,Birmingham 047D,E01009360,954,251,68,183,583,13,232,42,158,32,56,26,26,4,260,184,76,22,22,120,62,58
2021,Birmingham 047E,E01009361,775,222,86,136,447,13,181,30,124,27,43,14,23,6,195,156,39,15,15,106,45,61
2021,Birmingham 048A,E01009478,623,150,51,99,407,13,218,33,161,24,29,6,20,3,140,103,37,7,7,66,43,23
2021,Birmingham 048B,E01009479,597,140,60,80,350,12,217,20,162,35,21,7,10,4,93,53,40,7,7,107,69,38
2021,Birmingham 048C,E01009482,473,91,21,70,305,5,164,22,119,23,24,8,13,3,95,62,33,17,17,77,54,23
2021,Birmingham 048D,E01009484,488,113,22,91,286,4,153,22,108,23,21,10,11,0,90,56,34,18,18,89,73,16
2021,Birmingham 048E,E01009485,500,64,27,37,337,10,234,20,178,36,13,1,11,1,75,42,33,5,5,99,70,29
2021,Birmingham 049A,E01008906,511,89,24,65,330,4,214,14,175,25,13,0,10,3,91,51,40,8,8,92,76,16
2021,Birmingham 049B,E01008911,639,214,72,142,386,4,154,6,131,17,39,9,27,3,179,142,37,10,10,39,29,10
2021,Birmingham 049D,E01009347,569,178,58,120,323,13,132,20,82,30,33,17,10,6,137,89,48,8,8,68,44,24
2021,Birmingham 049E,E01033559,911,454,7,447,339,1,87,63,21,3,193,186,7,0,28,21,7,30,30,118,5,113
2021,Birmingham 049F,E01033638,666,238,77,161,365,6,160,16,128,16,36,12,23,1,152,113,39,11,11,63,31,32
2021,Birmingham 050A,E01008910,441,124,27,97,259,8,138,17,102,19,20,7,11,2,83,42,41,10,10,58,41,17
2021,Birmingham 050B,E01008913,934,396,154,242,467,11,192,36,144,12,32,18,11,3,218,151,67,14,14,71,38,33
2021,Birmingham 050E,E01033561,413,175,48,127,175,4,65,19,41,5,16,13,3,0,82,53,29,8,8,63,22,41
2021,Birmingham 050F,E01033617,853,497,5,492,251,0,86,49,36,1,114,105,8,1,23,18,5,28,28,105,5,100
2021,Birmingham 050G,E01034929,521,140,17,123,347,2,118,18,93,7,43,7,36,0,168,141,27,16,16,34,22,12
2021,Birmingham 050H,E01034930,507,235,10,225,211,2,70,13,50,7,63,52,10,1,49,40,9,27,27,61,12,49
2021,Birmingham 051B,E01009483,525,99,28,71,326,6,211,20,158,33,14,1,12,1,91,50,41,4,4,100,63,37
2021,Birmingham 051C,E01009488,719,158,55,103,467,16,256,31,179,46,23,5,14,4,159,105,54,13,13,94,70,24
2021,Birmingham 051D,E01009489,519,71,21,50,353,11,214,29,152,33,18,4,12,2,98,68,30,12,12,95,71,24
2021,Birmingham 051E,E01009491,524,84,34,50,321,15,213,23,156,34,12,1,11,0,78,50,28,3,3,119,84,35
2021,Birmingham 051F,E01034931,429,42,16,26,292,5,205,15,134,56,7,2,5,0,71,32,39,4,4,95,81,14
2021,Birmingham 051G,E01034932,436,137,33,104,221,4,113,11,88,14,6,4,1,1,90,71,19,8,8,78,55,23
2021,Birmingham 052B,E01009192,612,70,32,38,341,9,228,21,160,47,9,2,7,0,88,51,37,7,7,201,144,57
2021,Birmingham 052D,E01009199,541,169,13,156,322,4,167,34,115,18,34,15,16,3,101,70,31,16,16,50,16,34
2021,Birmingham 052E,E01009204,712,254,65,189,382,9,174,21,132,21,28,6,15,7,166,111,55,5,5,76,35,41
2021,Birmingham 052G,E01034933,409,83,14,69,240,5,137,14,91,32,7,4,3,0,82,44,38,9,9,86,57,29
2021,Birmingham 052H,E01034934,432,77,14,63,261,3,138,14,106,18,21,1,20,0,96,50,46,3,3,94,70,24
2021,Birmingham 053A,E01009151,627,139,43,96,388,13,201,28,138,35,38,14,22,2,127,75,52,9,9,100,61,39
2021,Birmingham 053B,E01009152,575,207,39,168,209,7,122,19,69,34,17,6,10,1,50,22,28,13,13,159,82,77
2021,Birmingham 053C,E01009153,819,341,66,275,339,12,137,19,91,27,78,45,30,3,99,62,37,13,13,139,40,99
2021,Birmingham 053D,E01009345,503,131,22,109,329,11,139,13,100,26,20,9,10,1,143,103,40,16,16,43,27,16
2021,Birmingham 053E,E01009346,530,106,32,74,354,14,192,30,134,28,18,7,8,3,123,78,45,7,7,70,50,20
2021,Birmingham 054A,E01009092,614,152,44,108,411,19,153,32,95,26,51,10,31,10,182,125,57,6,6,51,32,19
2021,Birmingham 054B,E01009093,644,189,62,127,419,19,170,44,107,19,62,18,37,7,157,106,51,11,11,36,23,13
2021,Birmingham 054C,E01009094,548,128,40,88,373,25,182,41,117,24,50,24,25,1,115,68,47,1,1,47,28,19
2021,Birmingham 054D,E01009298,585,149,50,99,384,8,145,33,89,23,62,14,39,9,161,106,55,8,8,52,26,26
2021,Birmingham 054E,E01009311,558,123,44,79,403,24,160,30,87,43,63,28,31,4,146,102,44,10,10,32,20,12
2021,Birmingham 054F,E01009511,483,116,54,62,288,14,116,22,75,19,52,13,36,3,101,60,41,5,5,79,53,26
2021,Birmingham 055A,E01009475,612,114,43,71,390,6,241,21,184,36,26,9,13,4,108,59,49,9,9,108,73,35
2021,Birmingham 055B,E01009476,578,165,52,113,329,13,215,25,163,27,10,5,5,0,83,58,25,8,8,84,64,20
2021,Birmingham 055C,E01009477,529,101,40,61,356,20,200,28,150,22,34,14,13,7,98,61,37,4,4,72,56,16
2021,Birmingham 055D,E01009490,633,146,39,107,408,18,249,40,165,44,31,8,16,7,97,63,34,13,13,79,49,30
2021,Birmingham 055E,E01009492,538,93,23,70,368,18,219,26,170,23,26,10,14,2,99,62,37,6,6,77,59,18
2021,Birmingham 056A,E01009095,666,200,77,123,399,29,216,41,131,44,47,21,23,3,101,70,31,6,6,67,40,27
2021,Birmingham 056B,E01009507,573,226,94,132,271,16,131,26,82,23,24,9,9,6,91,73,18,9,9,76,47,29
2021,Birmingham 056C,E01009508,606,181,64,117,370,43,188,45,100,43,41,19,18,4,90,55,35,8,8,55,36,19
2021,Birmingham 056D,E01009509,631,201,37,164,323,24,174,40,94,40,39,18,17,4,72,49,23,14,14,107,76,31
2021,Birmingham 056E,E01009510,685,263,139,124,368,35,145,39,82,24,38,12,21,5,144,113,31,6,6,54,41,13
2021,Birmingham 057A,E01009297,800,299,124,175,455,55,169,58,72,39,85,30,44,11,142,92,50,4,4,46,22,24
2021,Birmingham 057B,E01009299,623,190,74,116,398,33,158,44,76,38,50,18,21,11,148,94,54,9,9,35,18,17
2021,Birmingham 057C,E01009300,716,173,55,118,491,25,157,44,78,35,68,29,31,8,232,160,72,9,9,52,36,16
2021,Birmingham 057D,E01009301,769,321,85,236,400,12,126,38,63,25,90,33,48,9,170,121,49,2,2,48,21,27
2021,Birmingham 057E,E01009303,711,330,125,205,360,19,145,35,74,36,80,36,35,9,113,68,45,3,3,21,12,9
2021,Birmingham 058A,E01009195,672,105,57,48,428,13,276,29,207,40,16,6,9,1,118,80,38,5,5,139,109,30
2021,Birmingham 058C,E01009197,485,76,27,49,328,8,198,12,153,33,19,7,10,2,98,63,35,5,5,81,59,22
2021,Birmingham 058F,E01033649,499,79,23,56,350,6,253,20,207,26,13,1,10,2,69,47,22,9,9,70,52,18
2021,Birmingham 058G,E01034935,830,134,42,92,559,9,376,37,305,34,29,11,14,4,137,90,47,8,8,137,92,45
2021,Birmingham 060A,E01009138,677,128,43,85,425,27,258,41,166,51,47,29,15,3,82,45,37,11,11,124,83,41
2021,Birmingham 060B,E01009139,559,167,46,121,297,30,157,31,87,39,39,20,16,3,63,37,26,8,8,95,42,53
2021,Birmingham 060C,E01009140,842,273,54,219,444,49,230,66,138,26,65,44,20,1,81,53,28,19,19,125,44,81
2021,Birmingham 060D,E01009145,729,232,66,166,409,29,216,52,120,44,59,44,14,1,98,57,41,7,7,88,38,50
2021,Birmingham 060E,E01009147,670,304,33,271,250,16,134,43,63,28,42,27,11,4,48,31,17,10,10,116,37,79
2021,Birmingham 062A,E01009512,706,165,65,100,479,26,196,48,107,41,67,24,31,12,181,122,59,9,9,62,40,22
2021,Birmingham 062B,E01009514,623,204,115,89,375,23,145,27,88,30,52,23,18,11,147,90,57,8,8,44,31,13
2021,Birmingham 062C,E01009516,519,134,67,67,341,35,164,42,86,36,41,15,20,6,97,57,40,4,4,44,25,19
2021,Birmingham 062D,E01009517,700,172,69,103,462,32,216,56,122,38,73,21,42,10,130,77,53,11,11,66,40,26
2021,Birmingham 063A,E01009325,510,67,26,41,365,21,208,25,153,30,17,1,12,4,112,65,47,7,7,78,56,22
2021,Birmingham 063D,E01009342,406,73,19,54,247,17,175,17,121,37,5,0,3,2,47,22,25,3,3,86,67,19
2021,Birmingham 063E,E01009343,494,96,23,73,301,9,175,26,126,23,9,3,4,2,98,64,34,10,10,97,61,36
2021,Birmingham 063F,E01033642,834,117,55,62,586,22,408,38,291,79,20,7,10,3,123,74,49,13,13,131,99,32
2021,Birmingham 064A,E01008986,785,412,59,353,313,11,174,71,82,21,68,58,9,1,51,43,8,9,9,60,16,44
2021,Birmingham 064B,E01008987,625,245,92,153,204,14,81,25,45,11,31,16,11,4,62,30,32,16,16,176,14,162
2021,Birmingham 064C,E01008988,986,488,58,430,380,15,178,76,83,19,102,90,10,2,47,23,24,38,38,118,27,91
2021,Birmingham 064D,E01008989,925,502,152,350,366,26,152,73,66,13,104,97,7,0,71,48,23,13,13,57,16,41
2021,Birmingham 064E,E01008990,510,182,60,122,288,42,167,49,92,26,48,39,8,1,24,12,12,7,7,40,9,31
2021,Birmingham 064F,E01008991,577,140,89,51,384,74,242,44,146,52,27,16,11,0,32,18,14,9,9,53,33,20
2021,Birmingham 066A,E01008882,670,165,49,116,428,10,227,40,159,28,38,17,14,7,143,93,50,10,10,77,52,25
2021,Birmingham 066B,E01008896,568,115,43,72,378,17,194,31,136,27,36,14,16,6,126,84,42,5,5,75,67,8
2021,Birmingham 066C,E01008898,557,118,44,74,373,18,204,42,130,32,31,13,9,9,111,72,39,9,9,66,45,21
2021,Birmingham 066D,E01009326,558,109,55,54,372,19,223,18,172,33,14,2,11,1,108,60,48,8,8,77,57,20
2021,Birmingham 066E,E01009341,524,147,38,109,318,10,161,21,113,27,26,9,14,3,115,93,22,6,6,59,41,18
2021,Birmingham 066F,E01009513,595,133,38,95,394,13,246,38,181,27,27,11,14,2,101,65,36,7,7,68,54,14
2021,Birmingham 067A,E01008881,584,148,88,60,375,27,203,37,122,44,37,14,16,7,92,51,41,16,16,61,43,18
2021,Birmingham 067B,E01008897,617,132,56,76,418,39,243,51,153,39,22,8,10,4,105,53,52,9,9,67,46,21
2021,Birmingham 067C,E01009515,633,215,105,110,358,49,191,49,106,36,54,28,18,8,56,21,35,8,8,60,34,26
2021,Birmingham 067D,E01009518,705,254,115,139,387,53,199,59,83,57,61,30,25,6,69,39,30,5,5,64,47,17
2021,Birmingham 067E,E01009521,617,147,68,79,413,47,230,64,109,57,58,26,26,6,75,34,41,3,3,57,31,26
2021,Birmingham 069A,E01009302,612,204,109,95,381,79,156,52,59,45,68,35,27,6,75,40,35,3,3,27,10,17
2021,Birmingham 069B,E01009314,749,215,107,108,480,45,207,70,106,31,84,27,45,12,134,87,47,10,10,54,32,22
2021,Birmingham 069C,E01009321,817,268,96,172,493,25,147,38,74,35,74,31,37,6,235,165,70,12,12,56,27,29
2021,Birmingham 069D,E01009322,723,262,82,180,410,17,153,42,74,37,83,32,42,9,151,101,50,6,6,51,28,23
2021,Birmingham 069E,E01009323,640,152,71,81,425,29,183,44,108,31,61,23,32,6,144,99,45,8,8,63,36,27
2021,Birmingham 070A,E01009329,708,161,39,122,393,9,239,30,165,44,20,7,10,3,104,58,46,21,21,154,110,44
2021,Birmingham 070B,E01009334,437,77,35,42,225,13,149,12,87,50,10,3,5,2,47,17,30,6,6,135,92,43
2021,Birmingham 070C,E01009337,493,84,25,59,328,9,223,14,174,35,10,3,6,1,76,47,29,10,10,81,59,22
2021,Birmingham 070D,E01009338,431,58,28,30,271,7,165,13,123,29,13,3,8,2,83,45,38,3,3,102,71,31
2021,Birmingham 070E,E01009380,505,106,28,78,308,6,193,18,154,21,12,2,7,3,90,63,27,7,7,91,70,21
2021,Birmingham 071A,E01009362,490,207,35,172,243,3,130,12,107,11,14,7,6,1,91,66,25,5,5,40,25,15
2021,Birmingham 071B,E01009363,576,196,51,145,313,16,169,33,113,23,28,12,14,2,88,48,40,12,12,67,54,13
2021,Birmingham 071C,E01009364,556,165,25,140,342,6,143,11,110,22,27,17,10,0,158,104,54,8,8,49,36,13
2021,Birmingham 071D,E01009365,589,204,42,162,304,6,160,21,113,26,24,18,5,1,99,44,55,15,15,81,63,18
2021,Birmingham 071E,E01009379,680,292,118,174,312,11,165,26,109,30,21,4,17,0,103,66,37,12,12,76,42,34
2021,Birmingham 072A,E01009312,613,159,78,81,414,54,226,64,105,57,63,27,31,5,70,38,32,1,1,40,21,19
2021,Birmingham 072B,E01009324,716,201,121,80,480,84,229,76,94,59,84,39,38,7,78,42,36,5,5,35,19,16
2021,Birmingham 072C,E01009519,597,150,71,79,414,59,193,55,87,51,78,37,32,9,79,44,35,5,5,33,21,12
2021,Birmingham 072D,E01009520,709,239,116,123,424,65,226,63,108,55,65,24,34,7,63,31,32,5,5,46,31,15
2021,Birmingham 073A,E01009066,878,358,239,119,470,121,282,78,160,44,30,22,7,1,35,19,16,2,2,50,31,19
2021,Birmingham 073B,E01009070,678,223,108,115,415,53,246,65,152,29,65,51,11,3,46,32,14,5,5,40,19,21
2021,Birmingham 073C,E01009252,644,142,56,86,438,65,223,65,125,33,92,63,26,3,54,39,15,4,4,64,23,41
2021,Birmingham 073D,E01009260,627,204,122,82,339,79,186,46,101,39,29,23,6,0,44,24,20,1,1,84,49,35
2021,Birmingham 073E,E01009261,726,229,123,106,428,70,241,70,128,43,48,27,20,1,67,39,28,2,2,69,28,41
2021,Birmingham 074A,E01008984,783,410,108,302,293,19,122,39,68,15,46,27,17,2,94,51,43,12,12,80,31,49
2021,Birmingham 074B,E01008994,648,240,81,159,340,38,163,57,92,14,60,44,14,2,60,35,25,19,19,68,12,56
2021,Birmingham 074C,E01008996,681,245,81,164,363,13,189,40,129,20,28,15,12,1,126,76,50,7,7,73,39,34
2021,Birmingham 074D,E01008997,627,213,87,126,358,46,173,59,78,36,30,22,8,0,106,61,45,3,3,56,17,39
2021,Birmingham 075A,E01009065,635,171,73,98,421,50,271,73,153,45,59,41,16,2,35,15,20,6,6,43,13,30
2021,Birmingham 075B,E01009067,685,243,100,143,414,47,254,81,141,32,70,53,17,0,40,28,12,3,3,28,4,24
2021,Birmingham 075C,E01009068,728,274,95,179,369,29,190,50,124,16,102,82,16,4,44,27,17,4,4,85,9,76
2021,Birmingham 075D,E01009069,854,362,100,262,421,45,166,62,85,19,137,109,25,3,62,48,14,11,11,71,4,67
2021,Birmingham 075E,E01009072,849,314,90,224,456,34,215,75,121,19,135,119,13,3,63,35,28,9,9,79,11,68
2021,Birmingham 076A,E01008885,502,123,55,68,336,38,180,48,82,50,41,15,22,4,68,37,31,9,9,43,30,13
2021,Birmingham 076B,E01008886,693,261,113,148,392,21,176,52,92,32,65,34,26,5,125,85,40,5,5,40,14,26
2021,Birmingham 076C,E01008888,632,129,58,71,462,44,236,75,111,50,107,46,56,5,67,48,19,8,8,41,19,22
2021,Birmingham 076D,E01009313,631,173,86,87,421,45,217,42,116,59,76,38,36,2,78,39,39,5,5,37,24,13
2021,Birmingham 077A,E01009368,417,123,30,93,205,8,106,15,70,21,6,2,4,0,80,44,36,5,5,89,65,24
2021,Birmingham 077D,E01009371,522,101,25,76,320,5,201,26,148,27,7,3,3,1,98,61,37,9,9,101,74,27
2021,Birmingham 077E,E01009397,464,73,21,52,299,4,170,20,116,34,10,4,4,2,109,55,54,6,6,92,63,29
2021,Birmingham 077F,E01033650,726,149,70,79,427,22,273,18,217,38,14,3,6,5,103,47,56,15,15,150,116,34
2021,Birmingham 078A,E01008883,635,162,58,104,392,23,221,42,146,33,31,10,18,3,102,58,44,15,15,81,52,29
2021,Birmingham 078B,E01008884,715,179,78,101,453,9,238,41,177,20,48,21,19,8,148,107,41,10,10,83,57,26
2021,Birmingham 078C,E01008887,616,171,64,107,392,16,186,35,117,34,57,24,28,5,125,86,39,8,8,53,32,21
2021,Birmingham 078D,E01008889,665,240,98,142,347,41,177,37,120,20,49,27,13,9,71,45,26,9,9,78,40,38
2021,Birmingham 079A,E01008982,702,263,60,203,363,21,197,76,93,28,75,65,8,2,55,35,20,15,15,76,14,62
2021,Birmingham 079C,E01008992,478,142,59,83,298,54,168,49,96,23,35,29,6,0,24,15,9,17,17,38,13,25
2021,Birmingham 079E,E01009283,612,180,60,120,326,33,166,53,92,21,73,46,25,2,46,22,24,8,8,106,33,73
2021,Birmingham 079G,E01034936,405,146,91,55,220,56,109,26,67,16,22,16,5,1,28,17,11,5,5,39,12,27
2021,Birmingham 079H,E01034937,443,172,21,151,213,25,138,54,61,23,35,30,3,2,13,9,4,2,2,58,21,37
2021,Birmingham 080A,E01009249,645,189,86,103,417,40,203,63,104,36,72,47,22,3,95,51,44,7,7,39,17,22
2021,Birmingham 080B,E01009250,732,218,87,131,480,83,211,74,93,44,74,34,37,3,106,64,42,6,6,34,16,18
2021,Birmingham 080C,E01009251,630,180,78,102,421,58,241,78,109,54,64,44,20,0,52,31,21,6,6,29,25,4
2021,Birmingham 080D,E01009253,629,140,58,82,456,67,255,73,118,64,62,31,27,4,68,37,31,4,4,33,15,18
2021,Birmingham 080E,E01009255,623,197,81,116,359,30,148,44,73,31,55,22,29,4,121,77,44,5,5,67,39,28
2021,Birmingham 080F,E01009257,619,177,63,114,391,32,160,33,91,36,71,28,35,8,121,78,43,7,7,51,26,25
2021,Birmingham 081A,E01009315,840,380,148,232,410,64,159,49,77,33,72,48,20,4,110,67,43,5,5,50,23,27
2021,Birmingham 081B,E01009316,794,266,93,173,474,52,230,80,106,44,83,48,30,5,89,52,37,20,20,54,29,25
2021,Birmingham 081C,E01009317,845,237,92,145,556,55,216,66,95,55,115,50,56,9,167,114,53,3,3,52,30,22
2021,Birmingham 081D,E01009318,638,175,81,94,428,57,204,72,84,48,89,47,36,6,73,35,38,5,5,35,18,17
2021,Birmingham 081E,E01009319,625,165,79,86,424,64,221,63,85,73,74,34,30,10,62,33,29,3,3,36,19,17
2021,Birmingham 081F,E01009320,653,188,79,109,412,63,193,53,97,43,84,45,35,4,63,27,36,9,9,53,29,24
2021,Birmingham 082A,E01009372,417,53,21,32,271,5,174,16,133,25,19,3,15,1,63,28,35,10,10,93,68,25
2021,Birmingham 082B,E01009373,461,78,33,45,296,7,206,18,144,44,6,1,3,2,70,38,32,7,7,87,58,29
2021,Birmingham 082D,E01009396,508,94,31,63,268,7,160,21,100,39,10,5,5,0,83,33,50,8,8,146,109,37
2021,Birmingham 082F,E01033643,823,147,49,98,515,13,350,36,256,58,14,6,6,2,129,89,40,9,9,161,114,47
2021,Birmingham 083A,E01009367,553,178,24,154,280,11,162,21,102,39,18,5,12,1,82,45,37,7,7,95,70,25
2021,Birmingham 083B,E01009375,552,131,25,106,330,11,202,21,144,37,8,3,4,1,98,53,45,11,11,91,74,17
2021,Birmingham 083C,E01009377,432,106,36,70,279,11,130,16,96,18,20,8,10,2,111,68,43,7,7,47,37,10
2021,Birmingham 083D,E01009383,413,128,33,95,212,5,122,14,72,36,26,11,10,5,44,15,29,15,15,73,51,22
2021,Birmingham 083E,E01009399,421,72,17,55,279,8,162,14,115,33,18,5,12,1,85,64,21,6,6,70,51,19
2021,Birmingham 084A,E01009366,537,134,47,87,337,8,161,24,110,27,47,11,34,2,115,57,58,6,6,66,38,28
2021,Birmingham 084B,E01009374,437,175,49,126,217,14,118,10,90,18,8,5,3,0,69,31,38,8,8,45,35,10
2021,Birmingham 084C,E01009376,541,224,56,168,238,8,119,19,75,25,27,18,8,1,76,45,31,8,8,79,45,34
2021,Birmingham 084F,E01033648,826,286,45,241,374,15,192,25,127,40,31,20,8,3,126,77,49,10,10,166,127,39
2021,Birmingham 085A,E01009073,644,150,47,103,451,21,139,28,85,26,49,14,32,3,233,195,38,9,9,43,28,15
2021,Birmingham 085B,E01009074,711,275,74,201,391,11,153,34,92,27,62,28,29,5,154,107,47,11,11,45,22,23
2021,Birmingham 085C,E01009254,846,327,160,167,470,49,236,69,130,37,51,26,24,1,124,86,38,10,10,49,15,34
2021,Birmingham 085D,E01009256,679,227,92,135,421,45,188,41,106,41,73,38,29,6,110,75,35,5,5,31,19,12
2021,Birmingham 085E,E01009258,651,238,78,160,387,33,151,31,89,31,52,22,26,4,143,99,44,8,8,26,13,13
2021,Birmingham 087B,E01009071,737,291,130,161,402,53,208,67,111,30,73,53,16,4,58,35,23,10,10,44,12,32
2021,Birmingham 087C,E01009075,816,414,150,264,304,24,107,34,61,12,73,50,21,2,89,60,29,11,11,98,20,78
2021,Birmingham 087E,E01009078,609,205,71,134,265,22,119,31,71,17,60,43,12,5,57,29,28,7,7,139,9,130
2021,Birmingham 087F,E01033562,1012,332,124,208,484,50,218,64,126,28,87,66,18,3,109,58,51,20,20,196,26,170
2021,Birmingham 088C,E01009183,581,128,48,80,380,56,222,65,122,35,50,33,16,1,48,24,24,4,4,73,40,33
2021,Birmingham 088D,E01009186,779,293,81,212,442,52,218,68,112,38,113,70,42,1,53,33,20,6,6,44,18,26
2021,Birmingham 088F,E01034938,516,122,33,89,257,11,151,11,110,30,22,4,16,2,70,39,31,3,3,137,72,65
2021,Birmingham 088G,E01034939,440,115,23,92,200,7,109,13,66,30,23,14,7,2,57,32,25,4,4,125,70,55
2021,Birmingham 089A,E01008890,708,260,70,190,379,19,181,38,105,38,65,34,26,5,106,67,39,8,8,69,40,29
2021,Birmingham 089B,E01008891,714,265,94,171,430,49,221,74,100,47,79,44,32,3,81,45,36,0,0,19,12,7
2021,Birmingham 089C,E01008892,498,139,48,91,289,20,126,20,80,26,21,4,13,4,113,64,49,9,9,70,36,34
2021,Birmingham 089D,E01008893,729,257,75,182,412,35,209,73,94,42,89,53,33,3,73,50,23,6,6,60,26,34
2021,Birmingham 089E,E01008894,714,364,130,234,288,29,140,39,71,30,44,31,11,2,63,32,31,12,12,62,26,36
2021,Birmingham 089F,E01008895,765,232,52,180,460,38,210,59,112,39,85,46,36,3,119,74,45,8,8,73,31,42
2021,Birmingham 089G,E01009015,787,328,123,205,389,24,199,52,115,32,78,39,34,5,80,55,25,8,8,70,31,39
2021,Birmingham 090A,E01009014,814,152,40,112,579,23,313,47,218,48,52,25,23,4,166,101,65,25,25,83,56,27
2021,Birmingham 090B,E01009018,719,284,95,189,367,48,201,51,102,48,48,26,18,4,64,34,30,6,6,68,29,39
2021,Birmingham 090C,E01009026,708,199,60,139,449,25,244,48,168,28,56,25,23,8,116,85,31,8,8,60,36,24
2021,Birmingham 090D,E01009028,618,164,59,105,396,18,199,32,139,28,52,23,24,5,121,84,37,6,6,58,36,22
2021,Birmingham 090E,E01009029,518,120,51,69,341,11,192,39,128,25,29,12,12,5,103,69,34,6,6,57,33,24
2021,Birmingham 092A,E01009182,640,332,61,271,245,4,126,50,57,19,46,31,13,2,61,41,20,8,8,63,38,25
2021,Birmingham 092B,E01009184,721,330,89,241,305,25,146,50,73,23,78,61,16,1,47,34,13,9,9,86,16,70
2021,Birmingham 092C,E01009187,651,262,125,137,345,65,181,61,99,21,61,40,19,2,36,23,13,2,2,44,10,34
2021,Birmingham 092D,E01009188,660,272,69,203,345,40,187,61,103,23,68,42,23,3,49,32,17,1,1,43,16,27
2021,Birmingham 092E,E01009384,700,397,96,301,247,11,97,37,46,14,72,56,10,6,58,34,24,9,9,56,18,38
2021,Birmingham 092F,E01009385,601,325,64,261,222,19,81,38,36,7,72,59,12,1,44,30,14,6,6,54,19,35
2021,Birmingham 093A,E01009185,761,339,123,216,354,71,161,52,81,28,66,57,8,1,49,29,20,7,7,68,39,29
2021,Birmingham 093B,E01009389,479,100,42,58,248,16,166,21,97,48,12,7,3,2,47,15,32,7,7,131,74,57
2021,Birmingham 093C,E01009390,648,335,33,302,229,15,112,25,66,21,44,37,6,1,56,36,20,2,2,84,43,41
2021,Birmingham 093D,E01009394,729,364,73,291,274,22,145,34,84,27,60,48,12,0,44,27,17,3,3,91,54,37
2021,Birmingham 094A,E01008918,723,248,90,158,440,41,148,30,87,31,60,27,30,3,186,139,47,5,5,35,20,15
2021,Birmingham 094B,E01008920,548,143,81,62,375,54,174,61,63,50,67,21,39,7,78,46,32,2,2,30,12,18
2021,Birmingham 094C,E01008921,621,209,79,130,371,60,159,61,63,35,51,23,28,0,96,63,33,5,5,41,15,26
2021,Birmingham 094D,E01008931,624,244,87,157,338,31,127,36,70,21,47,14,25,8,123,79,44,10,10,42,29,13
2021,Birmingham 094E,E01009259,718,255,68,187,413,31,136,37,68,31,55,25,25,5,186,121,65,5,5,50,25,25
2021,Birmingham 095A,E01008919,696,241,71,170,422,54,185,52,104,29,72,36,27,9,105,64,41,6,6,33,11,22
2021,Birmingham 095B,E01009064,592,163,66,97,376,37,183,45,102,36,59,32,24,3,90,58,32,7,7,53,17,36
2021,Birmingham 095C,E01009077,690,214,100,114,427,61,202,55,124,23,74,36,34,4,86,56,30,4,4,49,11,38
2021,Birmingham 095D,E01009291,586,153,50,103,377,23,161,39,83,39,84,49,30,5,100,66,34,9,9,56,23,33
2021,Birmingham 095E,E01009500,610,200,70,130,364,29,144,31,81,32,64,28,26,10,115,75,40,12,12,46,25,21
2021,Birmingham 096A,E01009284,995,286,54,232,402,21,159,47,101,11,101,79,19,3,99,69,30,22,22,307,33,274
2021,Birmingham 096C,E01009286,516,46,21,25,58,4,24,5,14,5,7,2,5,0,16,14,2,7,7,412,18,394
2021,Birmingham 096E,E01009289,606,92,22,70,80,1,27,3,22,2,12,8,4,0,31,19,12,9,9,434,14,420
2021,Birmingham 096F,E01009290,526,44,7,37,53,5,12,0,9,3,15,10,4,1,18,10,8,3,3,429,5,424
2021,Birmingham 096H,E01034940,437,108,15,93,100,2,31,4,22,5,16,11,4,1,45,37,8,6,6,229,9,220
2021,Birmingham 096I,E01034941,427,44,7,37,42,1,13,3,7,3,8,3,4,1,14,11,3,6,6,341,5,336
2021,Birmingham 097A,E01009017,484,74,37,37,334,30,206,26,131,49,19,6,10,3,73,38,35,6,6,76,56,20
2021,Birmingham 097B,E01009043,600,140,74,66,385,28,231,37,139,55,25,14,10,1,93,40,53,8,8,75,56,19
2021,Birmingham 097C,E01009044,456,77,30,47,281,18,173,19,129,25,15,10,4,1,70,48,22,5,5,98,71,27
2021,Birmingham 097D,E01009045,699,216,134,82,385,48,203,31,129,43,40,13,24,3,86,49,37,8,8,98,66,32
2021,Birmingham 097E,E01009046,605,153,95,58,372,54,226,48,119,59,30,13,4,13,61,27,34,1,1,80,60,20
2021,Birmingham 097F,E01009395,524,175,42,133,253,19,147,26,92,29,17,12,5,0,66,27,39,4,4,96,61,35
2021,Birmingham 098A,E01009016,726,340,144,196,334,25,174,40,95,39,50,24,20,6,82,43,39,3,3,52,31,21
2021,Birmingham 098B,E01009022,588,117,39,78,414,22,239,42,135,62,46,20,18,8,98,52,46,9,9,57,43,14
2021,Birmingham 098C,E01009023,559,105,52,53,400,43,250,60,141,49,38,16,17,5,62,35,27,7,7,54,35,19
2021,Birmingham 098D,E01009030,625,138,50,88,408,31,239,53,132,54,35,21,11,3,96,70,26,7,7,79,56,23
2021,Birmingham 099A,E01009281,697,296,183,113,376,69,202,62,116,24,55,28,22,5,47,23,24,3,3,25,14,11
2021,Birmingham 099B,E01009292,665,194,58,136,398,42,225,60,119,46,67,39,25,3,57,29,28,7,7,73,16,57
2021,Birmingham 099C,E01009294,805,240,95,145,512,52,226,75,118,33,103,57,46,0,127,80,47,4,4,53,10,43
2021,Birmingham 099D,E01009295,670,262,135,127,283,54,139,44,79,16,44,25,19,0,41,23,18,5,5,125,24,101
2021,Birmingham 100A,E01009280,746,237,96,141,455,32,226,83,125,18,103,67,34,2,90,49,41,4,4,54,16,38
2021,Birmingham 100B,E01009282,696,241,66,175,357,23,159,57,77,25,69,49,17,3,94,52,42,12,12,98,30,68
2021,Birmingham 100C,E01009288,448,135,55,80,255,58,130,36,66,28,40,31,8,1,24,14,10,3,3,58,14,44
2021,Birmingham 100D,E01009293,619,195,76,119,301,35,156,48,86,22,55,40,15,0,48,28,20,7,7,123,22,101
2021,Birmingham 100E,E01009296,591,175,41,134,319,21,146,50,79,17,83,55,27,1,64,46,18,5,5,97,20,77
2021,Birmingham 101A,E01008924,634,231,95,136,363,49,174,57,79,38,77,37,33,7,59,42,17,4,4,40,19,21
2021,Birmingham 101B,E01009501,568,152,47,105,371,19,137,30,75,32,63,23,35,5,143,93,50,9,9,45,30,15
2021,Birmingham 101C,E01009502,581,207,110,97,332,18,154,60,74,20,47,14,26,7,110,76,34,3,3,42,20,22
2021,Birmingham 101D,E01009503,581,170,64,106,360,22,143,37,72,34,62,23,35,4,125,79,46,8,8,51,27,24
2021,Birmingham 101E,E01009505,644,182,85,97,424,28,180,58,85,37,49,15,32,2,162,104,58,5,5,38,22,16
2021,Birmingham 102A,E01008917,509,126,53,73,354,58,177,62,68,47,48,18,27,3,68,33,35,3,3,29,17,12
2021,Birmingham 102B,E01008923,640,246,103,143,360,36,123,36,63,24,62,18,42,2,133,93,40,6,6,34,22,12
2021,Birmingham 102C,E01008925,509,140,73,67,347,76,160,57,48,55,54,21,28,5,53,27,26,4,4,22,10,12
2021,Birmingham 102D,E01008927,598,221,72,149,351,29,103,39,41,23,56,26,22,8,159,111,48,4,4,26,13,13
2021,Birmingham 102E,E01008928,738,340,119,221,374,33,139,42,66,31,48,19,23,6,151,97,54,3,3,24,17,7
2021,Birmingham 103A,E01009019,606,159,59,100,392,23,173,29,110,34,54,20,24,10,134,89,45,8,8,55,37,18
2021,Birmingham 103B,E01009020,557,140,53,87,359,24,179,38,100,41,43,16,20,7,105,71,34,8,8,58,44,14
2021,Birmingham 103C,E01009021,680,179,54,125,460,19,162,32,99,31,72,31,32,9,199,150,49,8,8,41,19,22
2021,Birmingham 103D,E01009024,615,162,56,106,397,13,187,41,114,32,35,7,23,5,156,95,61,6,6,56,34,22
2021,Birmingham 103E,E01009025,573,133,48,85,394,19,164,33,90,41,57,17,32,8,149,102,47,5,5,46,26,20
2021,Birmingham 103F,E01009033,701,200,59,141,449,19,217,43,151,23,69,23,37,9,140,91,49,4,4,52,35,17
2021,Birmingham 104A,E01009175,593,170,55,115,368,19,173,47,98,28,102,63,37,2,66,39,27,8,8,55,18,37
2021,Birmingham 104B,E01009177,633,203,87,116,369,21,185,56,114,15,87,63,22,2,71,42,29,5,5,61,21,40
2021,Birmingham 104C,E01009178,761,273,81,192,409,12,174,67,94,13,140,104,31,5,77,49,28,6,6,79,14,65
2021,Birmingham 104D,E01009179,638,183,94,89,406,59,232,59,115,58,59,38,17,4,47,20,27,9,9,49,26,23
2021,Birmingham 104E,E01009189,589,185,75,110,366,57,196,57,103,36,64,46,16,2,47,31,16,2,2,38,14,24
2021,Birmingham 105A,E01008933,543,125,44,81,372,37,221,48,118,55,43,20,17,6,68,38,30,3,3,46,29,17
2021,Birmingham 105B,E01008934,547,135,74,61,370,58,216,50,115,51,37,17,17,3,54,20,34,5,5,42,27,15
2021,Birmingham 105C,E01009031,645,188,87,101,388,49,226,53,119,54,36,26,10,0,73,40,33,4,4,69,41,28
2021,Birmingham 105D,E01009037,755,254,129,125,434,87,239,73,126,40,43,24,15,4,59,24,35,6,6,67,37,30
2021,Birmingham 105E,E01009176,678,240,96,144,368,51,180,49,88,43,47,32,14,1,87,56,31,3,3,70,43,27
2021,Birmingham 106C,E01008929,698,298,123,175,368,26,125,42,61,22,75,34,31,10,136,96,40,6,6,32,17,15
2021,Birmingham 106D,E01008930,790,227,72,155,521,34,240,71,139,30,113,63,43,7,129,88,41,5,5,42,24,18
2021,Birmingham 106E,E01009495,537,154,77,77,358,27,126,43,56,27,62,20,34,8,136,93,43,7,7,25,11,14
2021,Birmingham 106F,E01033629,1052,385,137,248,605,51,224,55,122,47,87,40,41,6,237,174,63,6,6,62,29,33
2021,Birmingham 107A,E01008953,660,222,70,152,384,30,168,47,89,32,78,46,25,7,97,68,29,11,11,54,27,27
2021,Birmingham 107B,E01008963,619,210,58,152,368,22,159,48,84,27,79,41,30,8,101,63,38,7,7,41,20,21
2021,Birmingham 107C,E01008964,621,227,107,120,360,31,148,45,81,22,78,45,27,6,93,53,40,10,10,34,23,11
2021,Birmingham 107D,E01008965,574,146,57,89,383,45,196,63,95,38,80,49,28,3,58,39,19,4,4,45,22,23
2021,Birmingham 107E,E01008966,681,231,87,144,399,29,163,27,112,24,67,38,26,3,130,70,60,10,10,51,22,29
2021,Birmingham 108A,E01009032,589,127,75,52,379,41,239,40,132,67,25,12,11,2,70,33,37,4,4,83,57,26
2021,Birmingham 108B,E01009034,553,112,55,57,368,48,235,37,137,61,37,19,13,5,46,20,26,2,2,73,49,24
2021,Birmingham 108C,E01009035,612,103,46,57,434,41,225,53,126,46,42,12,25,5,116,72,44,10,10,75,47,28
2021,Birmingham 108D,E01009036,537,150,69,81,324,44,191,28,101,62,41,15,20,6,44,25,19,4,4,63,38,25
2021,Birmingham 109A,E01009494,622,175,83,92,426,23,124,29,61,34,44,12,27,5,231,171,60,4,4,21,12,9
2021,Birmingham 109B,E01009496,637,194,125,69,411,89,190,62,81,47,63,28,25,10,66,37,29,3,3,32,21,11
2021,Birmingham 109C,E01009497,755,247,98,149,472,45,231,52,108,71,86,36,41,9,106,63,43,4,4,36,17,19
2021,Birmingham 109D,E01009504,641,185,106,79,412,76,221,69,122,30,48,20,24,4,63,38,25,4,4,44,21,23
2021,Birmingham 109E,E01009506,623,178,111,67,422,93,228,57,122,49,48,21,23,4,51,24,27,2,2,23,14,9
2021,Birmingham 110A,E01008967,648,181,100,81,435,79,257,63,136,58,42,24,14,4,54,26,28,3,3,32,12,20
2021,Birmingham 110B,E01008968,712,198,122,76,460,75,276,79,154,43,48,23,19,6,61,40,21,0,0,54,30,24
2021,Birmingham 110C,E01008970,603,186,82,104,378,48,162,32,101,29,49,23,23,3,114,64,50,5,5,39,19,20
2021,Birmingham 110D,E01008981,589,144,81,63,402,79,237,73,119,45,50,24,24,2,32,12,20,4,4,43,23,20
2021,Birmingham 111A,E01008932,656,222,85,137,393,27,187,54,107,26,55,33,19,3,118,67,51,6,6,41,22,19
2021,Birmingham 111B,E01008935,675,240,81,159,372,19,164,40,101,23,53,20,25,8,133,88,45,3,3,63,33,30
2021,Birmingham 111C,E01008936,656,217,77,140,386,59,187,40,106,41,42,22,17,3,92,53,39,6,6,53,27,26
2021,Birmingham 111D,E01008938,571,146,55,91,386,24,195,24,137,34,49,12,25,12,108,75,33,10,10,39,21,18
2021,Birmingham 111E,E01008939,703,261,99,162,386,28,174,45,89,40,60,27,26,7,118,78,40,6,6,56,30,26
2021,Birmingham 112A,E01008951,613,199,102,97,379,53,195,49,118,28,72,42,25,5,57,32,25,2,2,35,12,23
2021,Birmingham 112B,E01008952,875,326,54,272,460,17,150,73,61,16,181,136,40,5,100,59,41,12,12,89,13,76
2021,Birmingham 112C,E01008955,743,237,64,173,447,43,180,75,76,29,149,102,41,6,69,46,23,6,6,59,17,42
2021,Birmingham 112D,E01008956,556,157,83,74,375,40,226,65,125,36,59,28,25,6,46,23,23,4,4,24,10,14
2021,Birmingham 112E,E01008957,727,264,51,213,412,23,154,62,68,24,109,80,28,1,114,75,39,12,12,51,13,38
2021,Birmingham 113A,E01008950,719,304,122,182,397,103,185,58,92,35,45,25,16,4,61,32,29,3,3,18,5,13
2021,Birmingham 113B,E01008954,597,161,87,74,417,98,219,71,93,55,39,18,21,0,58,33,25,3,3,19,11,8
2021,Birmingham 113C,E01008958,768,324,169,155,420,68,137,53,48,36,69,31,32,6,144,87,57,2,2,24,11,13
2021,Birmingham 113D,E01009493,1021,587,210,377,391,43,152,43,91,18,60,33,24,3,132,104,28,4,4,43,14,29
2021,Birmingham 115A,E01008937,631,200,92,108,374,43,143,43,75,25,45,18,24,3,135,90,45,8,8,57,34,23
2021,Birmingham 115B,E01008940,579,177,63,114,359,19,134,32,82,20,60,18,35,7,135,91,44,11,11,43,20,23
2021,Birmingham 115C,E01008941,576,149,58,91,373,23,164,31,86,47,53,25,21,7,125,81,44,8,8,54,36,18
2021,Birmingham 115D,E01008944,734,247,88,159,449,39,176,52,97,27,93,48,41,4,137,85,52,4,4,38,18,20
2021,Birmingham 116A,E01008959,801,319,191,128,453,73,195,51,99,45,77,50,23,4,103,65,38,5,5,29,13,16
2021,Birmingham 116B,E01008960,624,165,62,103,430,31,260,77,130,53,86,44,33,9,51,27,24,2,2,29,8,21
2021,Birmingham 116C,E01008961,726,350,111,239,339,43,149,59,59,31,72,46,23,3,68,39,29,7,7,37,13,24
2021,Birmingham 116D,E01008962,859,276,83,193,533,46,161,52,76,33,81,30,49,2,240,193,47,5,5,50,28,22
2021,Birmingham 117A,E01008942,628,180,65,115,398,30,157,43,76,38,88,30,47,11,116,71,45,7,7,50,28,22
2021,Birmingham 117B,E01008943,573,176,59,117,351,26,138,35,66,37,68,26,32,10,118,75,43,1,1,46,21,25
2021,Birmingham 117C,E01008969,690,217,95,122,438,55,220,52,126,42,80,39,30,11,75,46,29,8,8,35,16,19
2021,Birmingham 117D,E01008971,749,258,109,149,448,59,209,63,101,45,70,38,26,6,103,65,38,7,7,43,16,27
2021,Birmingham 118A,E01008972,758,250,75,175,443,41,166,37,93,36,83,40,38,5,146,95,51,7,7,65,26,39
2021,Birmingham 118B,E01008973,877,324,101,223,508,51,219,67,108,44,101,56,40,5,135,79,56,2,2,45,20,25
2021,Birmingham 118C,E01008974,1104,303,100,203,749,69,351,72,217,62,159,99,44,16,166,98,68,4,4,52,33,19
2021,Birmingham 118D,E01008975,660,237,121,116,396,49,192,68,85,39,88,43,39,6,65,36,29,2,2,27,14,13
2021,Birmingham 119A,E01009172,557,170,63,107,344,26,133,24,78,31,60,26,26,8,119,75,44,6,6,43,24,19
2021,Birmingham 119B,E01009173,637,141,45,96,430,12,156,40,85,31,74,28,35,11,183,128,55,5,5,66,33,33
2021,Birmingham 119C,E01009174,521,178,74,104,315,30,109,39,47,23,62,25,33,4,112,80,32,2,2,28,14,14
2021,Birmingham 119D,E01009498,679,190,46,144,443,25,143,55,58,30,85,30,43,12,180,127,53,10,10,46,23,23
2021,Birmingham 119E,E01009499,662,174,63,111,427,34,175,53,82,40,79,26,43,10,128,74,54,11,11,61,34,27
2021,Birmingham 120A,E01009205,614,177,83,94,405,63,212,59,94,59,64,27,30,7,65,36,29,1,1,32,13,19
2021,Birmingham 120B,E01009206,648,181,103,78,433,84,212,77,81,54,68,30,29,9,68,33,35,1,1,34,15,19
2021,Birmingham 120C,E01009211,687,246,87,159,413,57,206,93,69,44,74,50,21,3,73,43,30,3,3,28,14,14
2021,Birmingham 120D,E01009218,643,204,129,75,407,79,251,66,141,44,44,18,24,2,32,17,15,1,1,32,18,14
2021,Birmingham 120E,E01009219,607,156,66,90,422,55,157,50,75,32,90,46,41,3,110,68,42,10,10,29,16,13
2021,Birmingham 121A,E01008976,647,212,92,120,386,32,145,38,78,29,51,27,19,5,149,82,67,9,9,49,17,32
2021,Birmingham 121B,E01008978,629,315,100,215,286,14,88,17,56,15,40,16,22,2,136,105,31,8,8,28,19,9
2021,Birmingham 121C,E01008979,705,276,99,177,389,43,120,48,48,24,74,27,38,9,147,99,48,5,5,40,24,16
2021,Birmingham 121D,E01008980,680,215,80,135,431,29,128,39,66,23,63,26,23,14,203,128,75,8,8,34,17,17
2021,Birmingham 122A,E01008945,741,236,68,168,461,40,196,57,96,43,94,46,39,9,127,84,43,4,4,44,22,22
2021,Birmingham 122B,E01008946,646,234,97,137,370,39,163,51,81,31,76,33,32,11,90,52,38,2,2,42,23,19
2021,Birmingham 122C,E01008947,539,158,63,95,360,29,153,44,67,42,86,33,46,7,89,56,33,3,3,21,15,6
2021,Birmingham 122D,E01008948,618,173,87,86,428,64,182,72,72,38,96,44,42,10,81,43,38,5,5,17,10,7
2021,Birmingham 122E,E01008949,507,131,81,50,353,50,175,67,59,49,77,35,36,6,48,23,25,3,3,23,9,14
2021,Birmingham 123A,E01008977,704,242,64,178,431,30,144,56,60,28,90,50,35,5,163,118,45,4,4,31,16,15
2021,Birmingham 123B,E01009109,514,123,22,101,351,10,98,27,60,11,68,22,40,6,171,135,36,4,4,40,27,13
2021,Birmingham 123C,E01009119,661,238,115,123,401,66,182,58,85,39,73,42,28,3,74,43,31,6,6,22,8,14
2021,Birmingham 123D,E01009120,778,271,96,175,474,55,180,68,83,29,138,68,65,5,96,67,29,5,5,33,13,20
2021,Birmingham 124A,E01009162,635,163,79,84,438,54,204,65,89,50,89,36,44,9,86,62,24,5,5,34,18,16
2021,Birmingham 124B,E01009207,666,178,96,82,460,69,232,71,112,49,82,38,33,11,73,29,44,4,4,28,20,8
2021,Birmingham 124C,E01009208,703,171,78,93,508,57,247,91,106,50,105,51,47,7,94,55,39,5,5,24,7,17
2021,Birmingham 124D,E01009209,946,358,117,241,532,61,217,84,86,47,102,60,33,9,141,102,39,11,11,56,19,37
2021,Birmingham 124E,E01009213,752,271,122,149,447,87,166,69,66,31,79,45,27,7,110,73,37,5,5,34,14,20
2021,Birmingham 125B,E01009155,581,208,94,114,340,34,122,46,38,38,59,26,26,7,119,60,59,6,6,33,13,20
2021,Birmingham 125D,E01009157,617,216,106,110,355,36,102,39,38,25,64,23,31,10,150,103,47,3,3,46,25,21
2021,Birmingham 125E,E01009160,711,265,63,202,411,23,102,31,45,26,63,16,40,7,219,165,54,4,4,35,20,15
2021,Birmingham 125F,E01009161,610,200,100,100,367,57,118,44,44,30,78,33,39,6,109,76,33,5,5,43,20,23
2021,Birmingham 125H,E01034942,669,138,16,122,485,10,218,58,145,15,116,56,54,6,136,108,28,5,5,46,29,17
2021,Birmingham 125I,E01034943,730,261,111,150,423,46,128,41,52,35,91,31,50,10,150,95,55,8,8,46,24,22
2021,Birmingham 126A,E01009117,802,285,90,195,462,21,130,34,79,17,68,18,45,5,238,174,64,5,5,55,38,17
2021,Birmingham 126B,E01009210,834,306,109,197,493,57,169,63,72,34,106,57,39,10,155,96,59,6,6,35,19,16
2021,Birmingham 126C,E01009212,774,282,72,210,457,43,157,47,78,32,84,38,39,7,158,115,43,15,15,35,19,16
2021,Birmingham 126D,E01009214,767,317,113,204,408,21,134,48,57,29,85,35,37,13,161,97,64,7,7,42,24,18
2021,Birmingham 126E,E01009215,933,447,196,251,447,38,128,48,60,20,80,35,41,4,188,130,58,13,13,39,12,27
2021,Birmingham 127A,E01009108,435,114,73,41,303,72,149,56,56,37,40,22,16,2,37,15,22,5,5,18,9,9
2021,Birmingham 127B,E01009111,598,139,49,90,422,50,196,59,99,38,84,40,37,7,90,54,36,2,2,37,14,23
2021,Birmingham 127C,E01009112,642,196,100,96,419,50,173,51,84,38,77,36,37,4,112,67,45,7,7,27,16,11
2021,Birmingham 127D,E01009116,569,159,109,50,379,114,196,62,103,31,38,25,12,1,27,10,17,4,4,31,14,17
2021,Birmingham 127E,E01009118,680,234,111,123,403,60,165,53,66,46,77,31,42,4,93,55,38,8,8,43,18,25
2021,Birmingham 128A,E01009107,697,243,79,164,416,27,128,28,75,25,70,26,35,9,185,154,31,6,6,38,26,12
2021,Birmingham 128B,E01009110,606,238,70,168,322,43,103,35,47,21,73,34,32,7,99,65,34,4,4,46,27,19
2021,Birmingham 128C,E01009113,704,274,115,159,380,14,123,41,60,22,63,25,34,4,174,132,42,6,6,50,27,23
2021,Birmingham 128D,E01009114,650,256,115,141,355,44,115,37,48,30,80,45,30,5,110,74,36,6,6,39,22,17
2021,Birmingham 128E,E01009115,613,203,94,109,371,41,129,55,43,31,73,25,39,9,125,90,35,3,3,39,25,14
2021,Birmingham 129A,E01009158,895,261,80,181,563,25,199,65,97,37,145,64,68,13,189,132,57,5,5,71,42,29
2021,Birmingham 129C,E01009165,643,295,94,201,324,15,121,45,54,22,79,40,37,2,106,80,26,3,3,24,12,12
2021,Birmingham 129D,E01009169,701,184,80,104,484,48,194,60,85,49,123,52,60,11,112,70,42,7,7,33,12,21
2021,Birmingham 129E,E01034944,662,302,183,119,327,73,91,34,44,13,60,34,25,1,102,87,15,1,1,33,18,15
2021,Birmingham 129F,E01034945,637,195,73,122,407,51,155,49,71,35,94,54,33,7,105,62,43,2,2,35,20,15
2021,Birmingham 130A,E01009159,912,264,93,171,596,56,297,100,155,42,118,56,50,12,123,80,43,2,2,52,30,22
2021,Birmingham 130B,E01009164,627,225,98,127,368,47,161,56,64,41,79,39,35,5,75,51,24,6,6,34,20,14
2021,Birmingham 130C,E01009167,588,146,63,83,405,36,166,51,73,42,89,36,45,8,111,71,40,3,3,37,16,21
2021,Birmingham 130D,E01009171,723,244,83,161,449,57,166,50,78,38,105,55,45,5,118,83,35,3,3,30,16,14
2021,Birmingham 131A,E01009166,566,169,66,103,362,24,137,42,62,33,90,52,36,2,107,79,28,4,4,35,13,22
2021,Birmingham 131B,E01009168,653,202,87,115,425,67,183,72,57,54,100,49,42,9,72,41,31,3,3,26,7,19
2021,Birmingham 131C,E01009170,634,167,81,86,440,55,195,74,80,41,97,45,45,7,88,57,31,5,5,27,14,13
2021,Birmingham 131D,E01009216,836,259,120,139,543,74,231,82,103,46,97,46,45,6,134,100,34,7,7,34,15,19
2021,Birmingham 131E,E01009217,656,168,81,87,458,69,217,81,78,58,98,45,50,3,67,40,27,7,7,30,8,22
2021,Birmingham 132A,E01009039,651,144,79,65,466,77,265,71,153,41,61,29,23,9,61,35,26,2,2,41,21,20
2021,Birmingham 132B,E01009040,614,129,64,65,430,58,271,66,149,56,57,30,21,6,40,16,24,4,4,55,36,19
2021,Birmingham 132C,E01009041,636,142,62,80,458,52,274,81,144,49,49,28,19,2,82,41,41,1,1,36,19,17
2021,Birmingham 132D,E01009042,525,118,51,67,382,35,194,59,97,38,59,28,27,4,91,68,23,3,3,25,15,10
2021,Birmingham 132E,E01032589,604,209,115,94,350,48,204,53,107,44,29,20,7,2,67,38,29,2,2,45,23,22
2021,Birmingham 133A,E01009262,535,105,28,77,309,26,200,39,106,55,23,7,11,5,55,23,32,5,5,121,77,44
2021,Birmingham 133B,E01009267,600,175,77,98,320,48,187,31,101,55,24,13,10,1,56,18,38,5,5,105,68,37
2021,Birmingham 133C,E01009276,542,106,58,48,360,42,225,32,114,79,16,6,7,3,74,32,42,3,3,76,46,30
2021,Birmingham 133D,E01009278,546,112,44,68,348,30,215,40,105,70,22,10,10,2,74,23,51,7,7,86,58,28
2021,Birmingham 133E,E01009279,451,55,26,29,325,27,210,39,104,67,23,6,13,4,58,29,29,7,7,71,51,20
2021,Birmingham 133F,E01032591,472,76,54,22,307,46,195,29,91,75,10,1,6,3,49,20,29,7,7,89,63,26
2021,Birmingham 134A,E01008995,912,361,116,245,488,13,163,42,105,16,64,30,31,3,239,164,75,9,9,63,26,37
2021,Birmingham 134B,E01033557,988,555,13,542,342,7,114,72,39,3,152,145,7,0,30,18,12,39,39,91,7,84
2021,Birmingham 134C,E01033624,770,316,27,289,364,4,149,66,81,2,112,100,10,2,77,58,19,22,22,90,7,83
2021,Birmingham 134D,E01033626,595,264,51,213,252,3,88,34,49,5,64,56,8,0,86,71,15,11,11,79,6,73
2021,Birmingham 134E,E01033640,901,360,37,323,424,4,179,52,114,13,86,70,14,2,127,88,39,28,28,117,29,88
2021,Birmingham 135B,E01033567,640,360,7,353,214,0,62,37,21,4,104,98,6,0,23,18,5,25,25,66,4,62
2021,Birmingham 135C,E01033615,485,227,4,223,201,2,79,45,30,4,93,87,6,0,15,8,7,12,12,57,0,57
2021,Birmingham 135D,E01033616,757,424,47,377,256,4,75,42,26,7,78,61,17,0,73,56,17,26,26,77,7,70
2021,Birmingham 135E,E01034946,585,302,58,244,223,6,70,35,34,1,91,80,11,0,40,32,8,16,16,60,6,54
2021,Birmingham 135F,E01034947,698,280,26,254,340,11,136,31,85,20,78,68,10,0,93,64,29,22,22,78,17,61
2021,Birmingham 136A,E01009143,750,288,50,238,406,7,165,40,110,15,41,18,22,1,173,131,42,20,20,56,20,36
2021,Birmingham 136B,E01009146,1044,717,88,629,259,7,81,44,37,0,83,70,12,1,70,44,26,18,18,68,9,59
2021,Birmingham 136C,E01033564,725,412,8,404,257,5,94,51,36,7,123,118,5,0,21,10,11,14,14,56,5,51
2021,Birmingham 136E,E01034948,906,436,26,410,387,5,123,43,75,5,127,107,17,3,100,70,30,32,32,83,14,69
2021,Birmingham 136F,E01034949,740,405,33,372,268,2,106,52,48,6,79,69,9,1,54,40,14,27,27,67,11,56
2021,Birmingham 137A,E01009141,813,342,80,262,400,9,143,27,95,21,41,18,18,5,181,124,57,26,26,71,33,38
2021,Birmingham 137B,E01033565,875,416,12,404,357,3,96,71,23,2,224,216,7,1,14,6,8,20,20,102,0,102
2021,Birmingham 137C,E01033618,758,372,13,359,299,9,95,62,31,2,155,149,6,0,18,8,10,22,22,87,4,83
2021,Birmingham 137E,E01033627,505,203,56,147,233,5,94,32,50,12,56,42,13,1,68,39,29,10,10,69,17,52
2021,Birmingham 137F,E01034950,703,342,4,338,263,1,64,42,22,0,182,176,6,0,6,4,2,10,10,98,0,98
2021,Birmingham 137G,E01034951,601,243,20,223,284,5,80,47,30,3,136,125,11,0,44,20,24,19,19,74,6,68
2021,Birmingham 138A,E01033620,739,467,29,438,215,2,61,39,16,6,110,108,1,1,17,9,8,25,25,57,3,54
2021,Birmingham 138B,E01033622,1163,589,28,561,419,3,123,84,37,2,211,201,9,1,37,29,8,45,45,155,1,154
2021,Birmingham 138C,E01033623,1067,716,13,703,288,1,71,56,12,3,193,188,4,1,14,10,4,9,9,63,1,62
2021,Birmingham 138D,E01033625,1100,615,21,594,410,6,157,104,49,4,185,173,12,0,29,20,9,33,33,75,7,68
2021,Birmingham 139A,E01009200,607,161,28,133,378,8,173,29,122,22,31,11,17,3,157,112,45,9,9,68,36,32
2021,Birmingham 139B,E01009327,409,62,21,41,278,8,190,20,135,35,12,3,8,1,61,36,25,7,7,69,50,19
2021,Birmingham 139C,E01009328,511,60,24,36,298,17,196,7,133,56,4,2,0,2,73,32,41,8,8,153,117,36
2021,Birmingham 139D,E01009331,580,72,32,40,406,11,287,45,201,41,9,3,6,0,88,44,44,11,11,102,71,31
2021,Birmingham 139E,E01009332,596,188,53,135,339,9,181,23,135,23,21,9,7,5,115,68,47,13,13,69,45,24
2021,Birmingham 139F,E01009333,401,56,23,33,281,4,195,19,159,17,14,3,9,2,61,43,18,7,7,64,47,17
2021,Birmingham 139G,E01009335,484,64,26,38,327,13,228,27,151,50,8,1,7,0,73,37,36,5,5,93,75,18
2021,Birmingham 139H,E01009344,469,86,30,56,311,3,169,20,125,24,16,4,10,2,112,74,38,11,11,72,55,17
2021,Birmingham 141A,E01009008,601,193,94,99,362,58,178,60,68,50,63,27,30,6,57,29,28,6,6,46,23,23
2021,Birmingham 141B,E01009011,791,300,127,173,443,59,202,67,83,52,72,35,30,7,100,55,45,10,10,48,24,24
2021,Birmingham 141C,E01009012,605,178,78,100,372,38,186,62,86,38,63,33,24,6,80,37,43,5,5,55,29,26
2021,Birmingham 141G,E01009079,486,110,36,74,330,28,134,33,77,24,43,19,23,1,117,81,36,8,8,46,20,26
2021,Birmingham 141F,E01009080,404,65,17,48,292,14,105,17,74,14,37,7,24,6,132,92,40,4,4,47,33,14
2021,Birmingham 141H,E01009081,559,225,66,159,307,12,131,27,84,20,27,12,15,0,129,88,41,8,8,27,14,13
2021,Birmingham 141I,E01009083,548,175,71,104,329,14,156,23,107,26,36,9,22,5,117,73,44,6,6,44,30,14
2021,Birmingham 141E,E01009102,646,207,68,139,393,22,166,46,92,28,57,21,31,5,135,89,46,13,13,46,26,20
2021,Birmingham 141D,E01009104,623,179,50,129,396,11,168,39,103,26,61,23,30,8,148,102,46,8,8,48,26,22
2021,Birmingham 142A,E01009339,467,105,53,52,292,16,179,19,130,30,12,2,10,0,79,50,29,6,6,70,42,28
2021,Birmingham 142D,E01009382,469,71,29,42,267,13,185,15,135,35,13,3,7,3,45,23,22,11,11,131,86,45
2021,Birmingham 142E,E01009392,420,66,26,40,244,27,149,14,98,37,10,3,6,1,54,32,22,4,4,110,77,33
2021,Birmingham 142B,E01034952,407,82,17,65,282,7,153,25,110,18,30,9,20,1,82,53,29,10,10,43,23,20
2021,Birmingham 142C,E01034953,411,54,22,32,277,15,173,18,130,25,8,2,6,0,75,42,33,6,6,80,51,29
2021,Birmingham 143C,E01009391,514,89,18,71,347,13,220,25,176,19,19,9,9,1,91,66,25,4,4,78,54,24
2021,Birmingham 143D,E01009393,480,86,20,66,316,11,206,25,163,18,15,3,10,2,79,46,33,5,5,78,47,31
2021,Birmingham 143A,E01034954,515,115,29,86,335,11,196,27,149,20,41,14,22,5,77,52,25,10,10,65,35,30
2021,Birmingham 143B,E01034955,571,92,21,71,390,11,240,26,176,38,18,7,7,4,113,75,38,8,8,89,62,27
2021,Coventry 001A,E01009589,647,171,69,102,425,35,202,59,106,37,98,41,51,6,83,52,31,7,7,51,29,22
2021,Coventry 001F,E01032536,952,374,95,279,516,38,252,77,122,53,119,53,57,9,99,67,32,8,8,62,35,27
2021,Coventry 001G,E01032537,821,282,139,143,485,71,207,67,93,47,89,25,61,3,105,61,44,13,13,54,25,29
2021,Coventry 001H,E01032538,974,348,98,250,534,46,192,70,84,38,132,81,47,4,151,103,48,13,13,92,38,54
2021,Coventry 002A,E01009590,593,135,66,69,417,57,204,58,93,53,68,34,26,8,79,44,35,9,9,41,16,25
2021,Coventry 002B,E01009591,595,136,54,82,406,26,175,45,95,35,76,41,31,4,126,67,59,3,3,53,31,22
2021,Coventry 002C,E01009593,622,151,88,63,427,56,216,52,113,51,69,19,40,10,78,42,36,8,8,44,31,13
2021,Coventry 002D,E01009598,769,169,96,73,527,68,295,65,152,78,76,25,48,3,86,48,38,2,2,73,41,32
2021,Coventry 004A,E01009604,559,156,69,87,358,40,179,40,97,42,52,26,24,2,81,47,34,6,6,45,20,25
2021,Coventry 004B,E01009605,707,198,83,115,456,30,160,42,83,35,83,39,41,3,175,125,50,8,8,53,22,31
2021,Coventry 004C,E01009607,769,337,73,264,389,16,118,46,45,27,65,29,33,3,183,131,52,7,7,43,18,25
2021,Coventry 004D,E01009608,623,178,88,90,392,34,169,46,87,36,70,26,34,10,111,73,38,8,8,53,28,25
2021,Coventry 004E,E01009610,607,187,60,127,367,32,166,44,84,38,53,17,28,8,116,68,48,0,0,53,34,19
2021,Coventry 005A,E01009564,687,174,49,125,413,12,214,31,144,39,66,29,33,4,109,64,45,12,12,100,59,41
2021,Coventry 005B,E01009575,452,108,28,80,273,9,141,24,84,33,39,20,15,4,81,49,32,3,3,71,36,35
2021,Coventry 005C,E01009606,772,164,64,100,531,37,277,67,157,53,115,50,56,9,91,52,39,11,11,77,49,28
2021,Coventry 005D,E01009609,584,148,61,87,372,28,173,46,92,35,51,17,29,5,115,71,44,5,5,64,32,32
2021,Coventry 006A,E01009524,748,349,207,142,376,56,185,70,68,47,66,36,28,2,66,34,32,3,3,23,14,9
2021,Coventry 006B,E01009525,576,133,76,57,400,53,199,54,72,73,69,31,32,6,78,38,40,1,1,43,24,19
2021,Coventry 006C,E01009527,656,167,53,114,457,49,196,58,105,33,113,63,44,6,95,60,35,4,4,32,15,17
2021,Coventry 006D,E01009594,554,107,63,44,406,67,211,63,94,54,64,29,29,6,62,35,27,2,2,41,17,24
2021,Coventry 007A,E01009577,678,208,66,142,421,9,158,38,100,20,110,33,72,5,138,105,33,6,6,49,26,23
2021,Coventry 007B,E01009579,870,257,89,168,552,19,220,62,125,33,86,39,41,6,214,168,46,13,13,61,45,16
2021,Coventry 007C,E01009581,695,230,109,121,417,24,181,44,100,37,73,21,41,11,127,76,51,12,12,48,25,23
2021,Coventry 007D,E01009584,865,205,79,126,587,58,216,85,92,39,159,65,78,16,148,116,32,6,6,73,36,37
2021,Coventry 007E,E01009585,605,105,14,91,427,3,203,32,154,17,78,32,44,2,136,105,31,7,7,73,48,25
2021,Coventry 007F,E01009709,420,94,41,53,289,15,94,15,67,12,29,8,19,2,150,120,30,1,1,37,26,11
2021,Coventry 008A,E01009576,717,255,110,145,423,41,205,74,87,44,68,36,28,4,102,65,37,7,7,39,13,26
2021,Coventry 008B,E01009578,572,147,73,74,391,80,215,85,82,48,51,28,20,3,45,25,20,0,0,34,19,15
2021,Coventry 008C,E01009582,721,234,90,144,437,52,223,80,98,45,79,43,29,7,80,54,26,3,3,50,24,26
2021,Coventry 008D,E01009583,654,205,88,117,405,59,212,55,112,45,40,16,19,5,87,53,34,7,7,44,16,28
2021,Coventry 008E,E01009586,723,186,99,87,490,64,227,73,89,65,86,27,52,7,107,72,35,6,6,47,24,23
2021,Coventry 009A,E01009565,458,72,33,39,281,15,183,24,122,37,14,4,10,0,61,39,22,8,8,105,76,29
2021,Coventry 009B,E01009566,657,169,23,146,398,6,189,31,139,19,62,34,26,2,126,93,33,15,15,90,42,48
2021,Coventry 009C,E01009567,588,185,51,134,325,12,184,24,125,35,24,8,15,1,97,71,26,8,8,78,42,36
2021,Coventry 009D,E01009568,540,101,34,67,334,18,203,28,131,44,38,11,25,2,70,41,29,5,5,105,52,53
2021,Coventry 010A,E01009523,628,136,96,40,446,120,249,83,109,57,49,22,22,5,27,5,22,1,1,46,24,22
2021,Coventry 010B,E01009526,602,143,86,57,422,74,219,71,102,46,76,33,38,5,53,28,25,0,0,37,20,17
2021,Coventry 010C,E01009528,860,193,121,72,635,125,329,83,181,65,92,47,39,6,84,43,41,5,5,32,16,16
2021,Coventry 010D,E01009531,775,319,160,159,430,102,175,53,87,35,77,39,34,4,75,47,28,1,1,26,11,15
2021,Coventry 011A,E01009587,782,168,48,120,538,32,270,57,171,42,76,32,39,5,150,102,48,10,10,76,38,38
2021,Coventry 011B,E01009624,600,181,58,123,370,27,180,43,99,38,59,22,35,2,93,51,42,11,11,49,20,29
2021,Coventry 011C,E01009625,874,223,81,142,570,50,294,61,159,74,84,38,38,8,133,84,49,9,9,81,50,31
2021,Coventry 011D,E01009626,633,162,52,110,428,40,203,46,105,52,77,32,41,4,101,63,38,7,7,43,23,20
2021,Coventry 012A,E01009622,662,173,68,105,427,26,166,38,89,39,76,31,31,14,156,90,66,3,3,62,32,30
2021,Coventry 012B,E01009623,668,249,67,182,374,36,168,48,83,37,81,35,39,7,83,46,37,6,6,45,32,13
2021,Coventry 012C,E01009627,727,246,107,139,391,33,183,46,102,35,62,29,28,5,104,62,42,9,9,90,56,34
2021,Coventry 012D,E01009628,635,191,94,97,393,44,184,54,94,36,68,36,27,5,90,48,42,7,7,51,26,25
2021,Coventry 013A,E01009599,561,259,119,140,271,83,86,39,36,11,43,23,16,4,53,33,20,6,6,31,15,16
2021,Coventry 013B,E01009663,622,200,136,64,386,78,181,48,82,51,47,28,16,3,76,30,46,4,4,36,15,21
2021,Coventry 013C,E01009710,601,221,84,137,350,44,161,55,76,30,69,35,31,3,74,36,38,2,2,30,10,20
2021,Coventry 013D,E01009711,752,197,96,101,505,56,234,64,129,41,116,58,50,8,94,55,39,5,5,50,26,24
2021,Coventry 014A,E01009522,740,213,111,102,481,61,237,79,119,39,91,45,40,6,87,47,40,5,5,46,28,18
2021,Coventry 014B,E01009529,627,173,80,93,426,63,204,64,101,39,76,32,30,14,75,40,35,8,8,28,14,14
2021,Coventry 014C,E01009530,554,136,71,65,390,49,212,67,102,43,58,19,33,6,70,44,26,1,1,28,9,19
2021,Coventry 014D,E01009645,563,125,53,72,401,44,199,56,85,58,80,31,45,4,77,45,32,1,1,37,20,17
2021,Coventry 015A,E01009569,495,124,32,92,296,14,126,21,79,26,40,14,23,3,105,79,26,11,11,75,29,46
2021,Coventry 015B,E01009570,683,156,43,113,426,18,236,26,168,42,68,17,48,3,95,62,33,9,9,101,60,41
2021,Coventry 015C,E01009571,643,291,68,223,305,12,156,40,102,14,40,13,26,1,88,54,34,9,9,47,23,24
2021,Coventry 015E,E01009573,497,141,39,102,272,9,160,21,113,26,27,9,17,1,70,45,25,6,6,84,54,30
2021,Coventry 015F,E01009574,563,162,54,108,346,18,175,34,111,30,39,17,21,1,98,75,23,16,16,55,32,23
2021,Coventry 015G,E01034735,612,175,15,160,382,1,231,45,171,15,79,55,22,2,60,41,19,11,11,55,23,32
2021,Coventry 015H,E01034736,567,145,30,115,357,5,162,21,124,17,62,28,30,4,119,83,36,9,9,65,40,25
2021,Coventry 016A,E01009655,847,262,70,192,534,28,234,52,145,37,84,40,39,5,169,117,52,19,19,51,19,32
2021,Coventry 016B,E01009656,699,228,97,131,413,37,160,44,82,34,101,71,25,5,108,65,43,7,7,58,23,35
2021,Coventry 016C,E01009659,784,278,61,217,398,16,142,40,81,21,81,48,31,2,136,91,45,23,23,108,66,42
2021,Coventry 016D,E01009662,567,195,52,143,313,32,173,49,73,51,32,16,14,2,72,40,32,4,4,59,34,25
2021,Coventry 016E,E01009664,591,145,47,98,390,40,195,57,95,43,63,18,36,9,88,56,32,4,4,56,32,24
2021,Coventry 017A,E01009643,592,158,65,93,412,63,202,60,98,44,69,32,33,4,72,43,29,6,6,22,7,15
2021,Coventry 017B,E01009644,678,188,92,96,472,56,244,81,114,49,92,53,33,6,76,49,27,4,4,18,6,12
2021,Coventry 017C,E01009647,826,296,126,170,435,56,217,74,105,38,76,49,23,4,79,47,32,7,7,95,24,71
2021,Coventry 017D,E01009648,593,127,60,67,436,50,227,71,109,47,80,38,33,9,72,39,33,7,7,30,12,18
2021,Coventry 017E,E01009652,620,189,108,81,400,67,202,62,93,47,59,27,28,4,71,33,38,1,1,31,11,20
2021,Coventry 017F,E01009653,634,173,99,74,430,53,234,62,122,50,78,36,33,9,62,44,18,3,3,31,17,14
2021,Coventry 018A,E01009613,493,116,58,58,343,35,198,52,96,50,47,17,28,2,60,34,26,3,3,34,22,12
2021,Coventry 018B,E01009657,610,145,66,79,402,38,209,59,95,55,87,44,36,7,67,37,30,1,1,63,33,30
2021,Coventry 018C,E01009712,595,161,75,86,383,35,196,54,112,30,73,32,36,5,79,45,34,0,0,51,24,27
2021,Coventry 018D,E01009714,563,126,59,67,409,43,202,48,105,49,68,29,36,3,91,53,38,5,5,28,19,9
2021,Coventry 018E,E01009716,643,161,81,80,430,37,207,55,111,41,76,33,35,8,104,64,40,6,6,52,26,26
2021,Coventry 019A,E01009580,608,227,123,104,334,66,174,59,94,21,38,30,8,0,48,27,21,8,8,47,23,24
2021,Coventry 019B,E01009713,522,108,46,62,372,49,188,46,99,43,61,22,37,2,69,39,30,5,5,42,27,15
2021,Coventry 019C,E01009715,583,185,68,117,365,52,196,56,99,41,49,21,26,2,66,45,21,2,2,33,18,15
2021,Coventry 019D,E01009717,574,131,74,57,408,72,219,66,107,46,44,18,22,4,70,41,29,3,3,35,21,14
2021,Coventry 019E,E01009718,846,389,154,235,410,36,159,45,82,32,69,31,30,8,142,102,40,4,4,47,26,21
2021,Coventry 020B,E01009630,710,177,55,122,454,19,186,55,100,31,86,45,38,3,153,105,48,10,10,79,35,44
2021,Coventry 020C,E01009631,599,203,74,129,334,16,112,26,61,25,50,18,27,5,148,80,68,8,8,62,38,24
2021,Coventry 020D,E01009632,983,535,128,407,341,12,121,56,53,12,82,69,12,1,101,68,33,25,25,107,14,93
2021,Coventry 020E,E01009650,755,384,51,333,266,14,71,33,27,11,95,83,8,4,73,33,40,13,13,105,13,92
2021,Coventry 020F,E01034737,598,149,31,118,350,12,185,40,109,36,43,19,21,3,98,55,43,12,12,99,62,37
2021,Coventry 020G,E01034738,545,162,34,128,256,7,108,21,56,31,52,36,15,1,65,27,38,24,24,127,46,81
2021,Coventry 021A,E01009614,585,156,76,80,387,52,184,51,93,40,65,25,36,4,79,50,29,7,7,42,16,26
2021,Coventry 021B,E01009654,710,178,64,114,494,49,264,65,148,51,85,35,38,12,92,56,36,4,4,38,17,21
2021,Coventry 021C,E01009658,636,158,57,101,427,47,238,58,140,40,67,36,28,3,68,38,30,7,7,51,25,26
2021,Coventry 021D,E01009660,649,181,59,122,372,37,184,36,101,47,59,40,13,6,80,44,36,12,12,96,44,52
2021,Coventry 022A,E01009646,604,145,57,88,430,44,235,70,120,45,81,42,37,2,64,39,25,6,6,29,9,20
2021,Coventry 022B,E01009692,523,171,122,49,332,91,163,51,74,38,46,21,23,2,31,17,14,1,1,20,7,13
2021,Coventry 022C,E01009693,675,223,117,106,421,69,164,64,68,32,106,54,46,6,78,48,30,4,4,31,11,20
2021,Coventry 022D,E01009694,615,182,96,86,407,82,211,64,104,43,68,39,27,2,45,23,22,1,1,26,6,20
2021,Coventry 023A,E01009695,745,262,171,91,458,144,208,73,85,50,60,32,22,6,46,22,24,0,0,25,15,10
2021,Coventry 023B,E01009696,650,198,107,91,427,109,181,68,79,34,81,45,28,8,56,33,23,0,0,25,9,16
2021,Coventry 023C,E01009704,599,147,76,71,425,99,216,80,87,49,63,28,27,8,46,18,28,1,1,27,13,14
2021,Coventry 023D,E01009705,570,143,92,51,411,103,232,82,105,45,50,25,23,2,24,15,9,2,2,16,8,8
2021,Coventry 024A,E01009636,962,287,37,250,490,10,210,45,142,23,107,74,31,2,133,105,28,30,30,185,37,148
2021,Coventry 024B,E01009637,521,122,49,73,320,5,188,27,127,34,29,5,23,1,88,55,33,10,10,79,59,20
2021,Coventry 024C,E01009638,756,370,49,321,326,8,112,27,71,14,55,13,42,0,133,104,29,18,18,60,27,33
2021,Coventry 024D,E01009639,554,121,41,80,327,23,185,26,121,38,41,6,31,4,63,39,24,15,15,106,56,50
2021,Coventry 024E,E01009640,736,179,42,137,464,6,203,38,145,20,82,29,45,8,162,128,34,11,11,93,35,58
2021,Coventry 024F,E01009641,823,334,68,266,294,6,110,31,66,13,63,43,19,1,91,67,24,24,24,195,29,166
2021,Coventry 025A,E01009697,864,224,108,116,603,99,298,94,160,44,106,63,37,6,92,64,28,8,8,37,10,27
2021,Coventry 025B,E01009698,633,169,97,72,441,101,215,74,95,46,68,35,28,5,56,25,31,1,1,23,8,15
2021,Coventry 025D,E01009706,645,193,100,93,424,94,196,63,93,40,74,37,33,4,60,41,19,0,0,28,13,15
2021,Coventry 025E,E01034739,710,234,15,219,446,11,195,57,125,13,134,88,41,5,100,81,19,6,6,30,8,22
2021,Coventry 025F,E01034740,736,253,91,162,443,44,221,70,105,46,73,34,32,7,105,63,42,0,0,40,17,23
2021,Coventry 026A,E01009649,574,149,68,81,387,50,189,49,111,29,67,33,34,0,75,34,41,6,6,38,15,23
2021,Coventry 026B,E01009684,680,282,77,205,356,35,144,50,62,32,72,38,28,6,101,59,42,4,4,42,20,22
2021,Coventry 026C,E01009685,715,216,93,123,466,55,224,78,96,50,96,59,30,7,82,47,35,9,9,33,15,18
2021,Coventry 026D,E01009686,676,180,82,98,439,51,225,75,96,54,95,47,41,7,60,32,28,8,8,57,22,35
2021,Coventry 026E,E01009687,603,182,74,108,379,54,177,66,84,27,79,33,39,7,64,41,23,5,5,42,11,31
2021,Coventry 027A,E01009615,656,206,43,163,320,33,168,50,86,32,50,29,19,2,56,35,21,13,13,130,34,96
2021,Coventry 027B,E01009616,604,153,47,106,388,38,210,71,93,46,58,32,19,7,72,37,35,10,10,63,21,42
2021,Coventry 027C,E01009617,466,117,45,72,290,48,140,39,67,34,45,22,20,3,53,28,25,4,4,59,37,22
2021,Coventry 027D,E01009618,656,141,55,86,468,46,224,66,105,53,102,41,44,17,91,56,35,5,5,47,19,28
2021,Coventry 027E,E01009620,1019,225,82,143,706,46,392,119,217,56,139,63,70,6,118,80,38,11,11,88,43,45
2021,Coventry 027F,E01009621,548,154,62,92,304,27,130,35,66,29,57,26,28,3,82,54,28,8,8,90,57,33
2021,Coventry 028A,E01009633,736,204,49,155,272,5,87,32,45,10,59,35,20,4,106,62,44,15,15,260,32,228
2021,Coventry 028B,E01009634,689,162,40,122,295,22,112,24,67,21,38,19,14,5,51,37,14,72,72,232,19,213
2021,Coventry 028D,E01009661,797,230,44,186,364,11,107,27,59,21,77,34,40,3,117,84,33,52,52,203,27,176
2021,Coventry 028E,E01034741,424,165,10,155,122,2,39,16,17,6,32,23,8,1,30,20,10,19,19,137,6,131
2021,Coventry 028F,E01034742,445,122,25,97,129,7,35,9,14,12,20,12,8,0,43,25,18,24,24,194,12,182
2021,Coventry 029A,E01009674,747,273,69,204,407,25,157,47,83,27,99,55,39,5,116,75,41,10,10,67,31,36
2021,Coventry 029B,E01009699,625,196,93,103,399,86,172,57,81,34,71,28,38,5,65,33,32,5,5,30,11,19
2021,Coventry 029C,E01009700,833,432,92,340,351,21,147,51,72,24,71,39,22,10,106,75,31,6,6,50,28,22
2021,Coventry 029D,E01009701,717,279,95,184,404,47,173,74,56,43,82,39,36,7,97,70,27,5,5,34,16,18
2021,Coventry 029E,E01009702,736,301,90,211,398,30,138,42,73,23,74,31,42,1,149,108,41,7,7,37,18,19
2021,Coventry 030A,E01009688,630,221,48,173,303,23,111,34,61,16,96,64,29,3,62,37,25,11,11,106,24,82
2021,Coventry 030B,E01009689,912,465,218,247,342,71,94,40,44,10,101,80,19,2,71,39,32,5,5,105,7,98
2021,Coventry 030C,E01009690,635,213,56,157,271,21,95,42,40,13,88,57,29,2,57,38,19,10,10,151,5,146
2021,Coventry 030D,E01009691,599,214,44,170,276,16,74,40,29,5,91,70,20,1,79,57,22,16,16,109,6,103
2021,Coventry 031A,E01009548,928,355,97,258,450,39,210,71,103,36,109,86,23,0,75,42,33,17,17,123,19,104
2021,Coventry 031B,E01009553,870,483,48,435,268,14,87,38,42,7,84,70,13,1,58,46,12,25,25,119,12,107
2021,Coventry 031D,E01009651,729,398,79,319,274,7,76,22,42,12,62,36,19,7,121,77,44,8,8,57,15,42
2021,Coventry 031E,E01034743,423,333,96,237,65,10,18,11,7,0,15,14,1,0,9,7,2,13,13,25,1,24
2021,Coventry 031F,E01034744,479,261,34,227,146,7,42,28,11,3,35,31,4,0,29,21,8,33,33,72,10,62
2021,Coventry 032A,E01009676,676,190,54,136,438,44,201,60,100,41,89,47,38,4,98,65,33,6,6,48,12,36
2021,Coventry 032B,E01009681,549,160,74,86,351,48,184,60,85,39,70,35,31,4,45,24,21,4,4,38,13,25
2021,Coventry 032C,E01009682,600,165,92,73,397,57,198,73,79,46,75,32,35,8,64,33,31,3,3,38,15,23
2021,Coventry 032D,E01009683,709,168,53,115,435,28,175,44,107,24,100,56,42,2,124,88,36,8,8,106,18,88
2021,Coventry 033A,E01009532,574,175,95,80,373,57,173,62,77,34,82,36,40,6,60,36,24,1,1,26,12,14
2021,Coventry 033B,E01009535,569,137,98,39,406,117,191,60,90,41,40,11,24,5,53,25,28,5,5,26,11,15
2021,Coventry 033C,E01009536,605,160,94,66,407,94,202,63,96,43,54,22,25,7,55,22,33,2,2,38,19,19
2021,Coventry 033D,E01009543,617,92,25,67,487,47,352,109,162,81,46,21,21,4,38,18,20,4,4,38,21,17
2021,Coventry 033E,E01009707,730,182,77,105,505,73,243,73,125,45,93,47,40,6,92,54,38,4,4,43,25,18
2021,Coventry 033F,E01009708,606,183,96,87,388,76,177,62,69,46,65,37,21,7,64,32,32,6,6,35,15,20
2021,Coventry 034A,E01009554,580,190,85,105,324,35,147,47,73,27,78,40,33,5,57,33,24,7,7,66,7,59
2021,Coventry 034B,E01009555,588,137,82,55,389,86,212,74,98,40,48,26,18,4,42,26,16,1,1,62,17,45
2021,Coventry 034C,E01009556,706,290,123,167,352,43,186,60,95,31,71,46,23,2,48,28,20,4,4,64,8,56
2021,Coventry 034D,E01009557,538,106,76,30,395,106,242,88,106,48,25,9,11,5,21,10,11,1,1,37,13,24
2021,Coventry 034E,E01009558,631,199,64,135,365,47,198,74,91,33,68,49,15,4,45,23,22,7,7,67,7,60
2021,Coventry 034F,E01009559,579,203,143,60,339,92,191,61,84,46,35,30,5,0,20,10,10,1,1,37,13,24
2021,Coventry 035C,E01009537,626,222,110,112,357,46,138,40,63,35,72,28,29,15,98,57,41,3,3,47,23,24
2021,Coventry 035D,E01009538,625,190,78,112,382,37,177,70,78,29,70,29,29,12,94,56,38,4,4,53,27,26
2021,Coventry 035F,E01009612,550,147,54,93,362,14,149,39,87,23,58,20,28,10,134,97,37,7,7,41,24,17
2021,Coventry 035G,E01032527,667,195,79,116,429,49,194,73,74,47,73,28,36,9,110,68,42,3,3,43,26,17
2021,Coventry 035H,E01032528,694,232,107,125,433,65,187,70,92,25,54,22,29,3,119,81,38,8,8,29,16,13
2021,Coventry 035I,E01034745,461,71,11,60,339,2,170,36,111,23,70,39,28,3,94,67,27,3,3,51,23,28
2021,Coventry 035J,E01034746,555,113,39,74,386,8,151,23,115,13,44,8,29,7,173,134,39,10,10,56,37,19
2021,Coventry 036C,E01009679,802,258,105,153,310,18,148,46,79,23,45,25,14,6,89,58,31,10,10,234,26,208
2021,Coventry 036F,E01032532,663,214,82,132,405,70,194,85,67,42,81,52,21,8,56,24,32,4,4,44,20,24
2021,Coventry 036G,E01032533,617,92,37,55,433,78,292,90,118,84,25,10,12,3,36,18,18,2,2,92,39,53
2021,Coventry 036H,E01034747,695,199,56,143,415,27,133,38,70,25,75,23,45,7,174,137,37,6,6,81,25,56
2021,Coventry 036I,E01034748,537,192,87,105,272,11,82,18,47,17,50,17,28,5,123,103,20,6,6,73,20,53
2021,Coventry 037B,E01009549,654,175,91,84,435,88,267,79,136,52,40,24,12,4,37,15,22,3,3,44,19,25
2021,Coventry 037C,E01009550,725,197,81,116,459,54,229,80,110,39,88,54,31,3,77,45,32,11,11,69,25,44
2021,Coventry 037E,E01009552,683,257,138,119,388,56,212,39,128,45,30,20,10,0,88,49,39,2,2,38,16,22
2021,Coventry 037F,E01032534,719,238,102,136,415,44,216,43,118,55,48,21,25,2,100,49,51,7,7,66,27,39
2021,Coventry 037G,E01032535,471,92,47,45,332,44,184,68,84,32,50,26,22,2,52,24,28,2,2,47,21,26
2021,Coventry 038A,E01009544,739,310,127,183,374,52,196,70,93,33,61,35,23,3,58,28,30,7,7,55,14,41
2021,Coventry 038E,E01032529,655,285,111,174,331,41,138,56,69,13,73,41,23,9,72,49,23,7,7,39,12,27
2021,Coventry 038F,E01032530,789,239,111,128,495,57,251,94,118,39,107,56,44,7,73,37,36,7,7,55,21,34
2021,Coventry 038G,E01034749,764,250,56,194,386,16,160,35,109,16,84,54,28,2,89,59,30,37,37,128,18,110
2021,Coventry 038H,E01034750,1059,245,10,235,649,4,391,90,280,21,132,101,28,3,87,60,27,35,35,165,50,115
2021,Coventry 039A,E01009539,939,392,64,328,482,18,174,44,96,34,104,51,46,7,176,136,40,10,10,65,34,31
2021,Coventry 039B,E01009540,759,232,74,158,484,22,177,30,118,29,92,28,56,8,187,148,39,6,6,43,24,19
2021,Coventry 039C,E01009541,817,351,96,255,428,55,154,56,61,37,77,37,30,10,132,91,41,10,10,38,15,23
2021,Coventry 039D,E01009542,814,313,125,188,454,27,187,48,110,29,69,28,35,6,163,111,52,8,8,47,20,27
2021,Coventry 040A,E01009560,535,92,59,33,397,91,247,63,123,61,28,14,10,4,30,7,23,1,1,46,24,22
2021,Coventry 040B,E01009561,755,289,124,165,431,73,198,60,101,37,60,41,17,2,96,61,35,4,4,35,10,25
2021,Coventry 040C,E01009562,675,192,116,76,448,95,249,86,107,56,46,24,15,7,52,25,27,6,6,35,12,23
2021,Coventry 040D,E01009563,619,109,81,28,474,72,327,86,180,61,35,15,18,2,38,14,24,2,2,36,16,20
2021,Coventry 040E,E01009672,832,193,141,52,588,146,357,91,191,75,34,16,14,4,48,22,26,3,3,51,29,22
2021,Coventry 041A,E01009666,515,108,73,35,389,65,220,56,115,49,57,15,37,5,45,19,26,2,2,18,10,8
2021,Coventry 041B,E01009667,569,185,145,40,348,124,179,40,89,50,16,10,6,0,25,7,18,4,4,36,20,16
2021,Coventry 041C,E01009668,627,134,80,54,452,46,267,74,145,48,59,20,35,4,75,40,35,5,5,41,17,24
2021,Coventry 041D,E01009670,663,172,86,86,452,68,277,65,157,55,57,32,21,4,48,22,26,2,2,39,19,20
2021,Coventry 042A,E01009665,474,105,78,27,297,88,165,56,75,34,20,6,10,4,20,10,10,4,4,72,19,53
2021,Coventry 042B,E01009669,468,93,55,38,344,45,216,52,114,50,29,13,14,2,52,34,18,2,2,31,13,18
2021,Coventry 042C,E01009671,408,54,29,25,281,57,195,61,80,54,8,3,1,4,18,6,12,3,3,73,39,34
2021,Coventry 042F,E01033058,840,281,133,148,357,66,168,69,67,32,47,22,18,7,67,32,35,9,9,202,18,184
2021,Coventry 043A,E01009588,648,237,112,125,365,25,163,42,65,56,76,24,45,7,96,60,36,5,5,46,23,23
2021,Coventry 043B,E01009592,619,157,60,97,409,17,204,43,131,30,68,28,37,3,116,79,37,4,4,53,26,27
2021,Coventry 043C,E01009596,752,178,49,129,488,34,231,48,141,42,89,34,48,7,126,91,35,8,8,86,44,42
2021,Coventry 043D,E01009597,668,168,68,100,418,44,211,46,112,53,63,23,32,8,92,57,35,8,8,82,44,38
2021,Coventry 043E,E01032587,641,125,51,74,465,29,211,46,120,45,74,24,34,16,145,95,50,6,6,51,28,23
2021,Dudley 001A,E01009763,878,222,52,170,621,46,213,65,103,45,150,50,89,11,211,162,49,1,1,35,23,12
2021,Dudley 001B,E01009764,632,143,70,73,464,92,194,69,76,49,75,28,38,9,102,24,78,1,1,25,8,17
2021,Dudley 001C,E01009767,659,200,87,113,434,53,203,62,90,51,82,36,41,5,93,55,38,3,3,25,17,8
2021,Dudley 001D,E01009769,823,330,132,198,462,43,150,49,70,31,120,47,65,8,144,110,34,5,5,31,22,9
2021,Dudley 001E,E01009770,641,208,96,112,416,68,187,59,66,62,76,27,43,6,85,44,41,0,0,17,10,7
2021,Dudley 002A,E01009773,676,244,139,105,399,57,180,62,72,46,68,26,38,4,91,53,38,3,3,33,16,17
2021,Dudley 002B,E01009777,658,196,77,119,427,48,180,46,73,61,79,31,42,6,112,63,49,8,8,35,15,20
2021,Dudley 002C,E01009778,630,152,70,82,448,57,231,79,92,60,90,35,45,10,70,44,26,0,0,30,17,13
2021,Dudley 002D,E01009895,622,213,118,95,385,74,183,65,74,44,66,26,28,12,61,31,30,1,1,24,14,10
2021,Dudley 003A,E01009896,595,147,92,55,437,101,224,66,104,54,58,29,23,6,53,30,23,1,1,11,5,6
2021,Dudley 003B,E01009897,606,158,111,47,428,125,229,67,104,58,47,27,18,2,27,12,15,0,0,20,9,11
2021,Dudley 003C,E01009898,675,239,132,107,415,128,212,73,81,58,42,19,19,4,31,17,14,2,2,21,8,13
2021,Dudley 003D,E01009901,633,191,132,59,414,136,199,70,76,53,44,32,10,2,33,9,24,2,2,28,14,14
2021,Dudley 003E,E01009902,521,115,84,31,386,135,174,56,69,49,38,15,20,3,39,20,19,0,0,20,11,9
2021,Dudley 004A,E01009765,666,176,89,87,458,90,203,76,78,49,89,41,44,4,70,44,26,6,6,32,18,14
2021,Dudley 004B,E01009766,687,231,90,141,429,74,188,60,74,54,73,27,37,9,90,53,37,4,4,27,12,15
2021,Dudley 004C,E01009768,606,219,96,123,357,56,176,54,71,51,67,32,28,7,57,40,17,1,1,30,16,14
2021,Dudley 004D,E01009771,651,212,137,75,422,93,192,65,78,49,82,54,21,7,52,19,33,3,3,17,7,10
2021,Dudley 004E,E01009775,620,189,79,110,392,50,194,63,77,54,57,14,37,6,88,51,37,3,3,39,19,20
2021,Dudley 004F,E01009776,593,114,72,42,455,79,240,76,101,63,81,31,43,7,49,19,30,6,6,24,10,14
2021,Dudley 005A,E01009758,685,187,96,91,463,49,192,54,88,50,97,21,62,14,120,80,40,5,5,35,24,11
2021,Dudley 005B,E01009760,523,120,59,61,380,37,176,51,81,44,78,39,36,3,83,46,37,6,6,23,14,9
2021,Dudley 005C,E01009772,511,115,44,71,377,35,171,68,66,37,72,28,36,8,94,63,31,5,5,19,11,8
2021,Dudley 005D,E01009774,691,226,93,133,437,86,212,75,82,55,80,43,31,6,59,29,30,0,0,28,17,11
2021,Dudley 005E,E01009788,713,250,109,141,432,54,172,68,56,48,87,27,47,13,115,72,43,4,4,31,17,14
2021,Dudley 006B,E01009756,539,122,54,68,372,26,162,41,88,33,75,13,45,17,103,57,46,6,6,45,32,13
2021,Dudley 006C,E01009757,865,232,79,153,578,47,269,103,112,54,132,68,54,10,127,88,39,3,3,55,33,22
2021,Dudley 006D,E01009759,518,130,87,43,357,95,189,65,69,55,41,19,16,6,29,13,16,3,3,31,20,11
2021,Dudley 006F,E01009762,504,106,49,57,361,19,143,25,94,24,66,9,48,9,126,92,34,7,7,37,23,14
2021,Dudley 006H,E01034306,563,94,45,49,434,14,131,33,78,20,77,17,52,8,205,159,46,7,7,35,24,11
2021,Dudley 006I,E01034307,640,137,42,95,473,17,183,48,102,33,98,34,60,4,171,129,42,4,4,30,16,14
2021,Dudley 007A,E01009781,890,295,125,170,561,67,236,75,106,55,100,48,41,11,154,126,28,4,4,34,19,15
2021,Dudley 007B,E01009786,618,205,67,138,387,28,135,52,54,29,95,31,60,4,125,90,35,4,4,26,11,15
2021,Dudley 007C,E01009789,684,240,93,147,420,71,234,95,81,58,77,46,27,4,37,14,23,1,1,24,9,15
2021,Dudley 007D,E01009790,704,218,86,132,457,40,185,58,75,52,86,32,50,4,142,89,53,4,4,29,17,12
2021,Dudley 008A,E01009779,699,287,155,132,394,76,180,71,65,44,74,40,30,4,64,38,26,0,0,18,7,11
2021,Dudley 008B,E01009782,751,217,81,136,505,49,223,57,116,50,118,42,66,10,108,60,48,7,7,29,12,17
2021,Dudley 008C,E01009783,594,171,80,91,400,51,148,52,56,40,107,29,74,4,92,61,31,2,2,23,12,11
2021,Dudley 008D,E01009785,662,180,129,51,464,102,248,101,87,60,75,37,33,5,38,19,19,1,1,18,8,10
2021,Dudley 008E,E01009899,620,167,131,36,434,129,203,65,75,63,64,27,34,3,38,16,22,0,0,19,8,11
2021,Dudley 008F,E01009900,637,198,146,52,425,142,205,58,87,60,53,25,23,5,25,9,16,0,0,14,6,8
2021,Dudley 009A,E01009780,848,194,33,161,609,40,360,113,156,91,113,49,56,8,90,54,36,6,6,45,20,25
2021,Dudley 009B,E01009784,629,120,34,86,484,53,272,98,107,67,97,54,34,9,61,33,28,1,1,25,14,11
2021,Dudley 009C,E01009787,592,114,54,60,460,87,273,91,116,66,54,25,20,9,41,16,25,5,5,18,11,7
2021,Dudley 009D,E01009880,567,107,45,62,430,40,259,72,114,73,67,40,22,5,63,33,30,1,1,30,20,10
2021,Dudley 009E,E01009882,564,134,69,65,401,50,207,79,87,41,51,24,22,5,89,62,27,4,4,29,16,13
2021,Dudley 010A,E01009891,646,142,56,86,449,25,234,59,131,44,63,25,35,3,119,72,47,8,8,55,34,21
2021,Dudley 010B,E01009892,642,239,61,178,342,19,137,49,56,32,84,34,45,5,92,63,29,10,10,61,34,27
2021,Dudley 010C,E01009893,655,150,49,101,455,22,209,31,129,49,65,17,44,4,153,110,43,6,6,50,41,9
2021,Dudley 010D,E01009894,692,211,75,136,448,69,194,64,91,39,78,30,39,9,100,67,33,7,7,33,23,10
2021,Dudley 011A,E01009844,616,241,40,201,326,22,153,34,88,31,54,19,30,5,88,55,33,9,9,49,31,18
2021,Dudley 011B,E01009879,952,302,83,219,593,44,280,88,139,53,84,44,37,3,173,91,82,12,12,57,37,20
2021,Dudley 011D,E01009885,671,233,92,141,387,53,157,49,64,44,79,40,34,5,95,62,33,3,3,51,31,20
2021,Dudley 011E,E01034308,667,301,100,201,316,10,94,38,44,12,64,38,25,1,142,115,27,6,6,50,27,23
2021,Dudley 011F,E01034309,709,415,93,322,245,7,67,22,38,7,60,37,21,2,92,63,29,19,19,49,22,27
2021,Dudley 012A,E01009816,712,175,120,55,520,108,255,89,111,55,99,57,39,3,58,33,25,0,0,17,10,7
2021,Dudley 012B,E01009817,536,132,96,36,386,108,205,79,83,43,43,18,17,8,27,16,11,3,3,18,7,11
2021,Dudley 012C,E01009819,687,230,105,125,434,81,221,87,97,37,72,42,26,4,57,39,18,3,3,23,11,12
2021,Dudley 012D,E01009820,667,224,114,110,418,81,186,58,87,41,81,49,29,3,68,37,31,2,2,25,11,14
2021,Dudley 013A,E01009748,670,183,82,101,457,40,177,58,79,40,88,32,47,9,145,86,59,7,7,30,18,12
2021,Dudley 013B,E01009839,627,148,50,98,433,50,211,60,101,50,66,23,37,6,101,56,45,5,5,46,33,13
2021,Dudley 013C,E01009883,662,216,115,101,418,33,176,54,80,42,103,48,49,6,102,66,36,4,4,28,18,10
2021,Dudley 013D,E01009884,622,232,82,150,356,39,160,51,73,36,69,35,29,5,84,57,27,4,4,34,18,16
2021,Dudley 013E,E01009886,1035,520,255,265,487,80,183,73,80,30,90,49,35,6,126,85,41,8,8,28,16,12
2021,Dudley 014A,E01009814,516,121,85,36,383,97,201,66,91,44,50,21,26,3,34,10,24,1,1,12,3,9
2021,Dudley 014B,E01009815,494,89,64,25,393,88,238,69,104,65,39,11,23,5,28,17,11,0,0,12,4,8
2021,Dudley 014C,E01009818,549,182,92,90,344,43,164,56,58,50,63,32,28,3,73,56,17,1,1,23,10,13
2021,Dudley 014D,E01009821,606,171,120,51,426,134,209,78,89,42,44,23,18,3,39,21,18,0,0,9,4,5
2021,Dudley 014E,E01009822,652,212,137,75,415,114,207,71,91,45,53,29,21,3,41,24,17,0,0,25,9,16
2021,Dudley 015A,E01009887,639,170,67,103,399,51,191,52,94,45,63,23,38,2,86,54,32,8,8,70,51,19
2021,Dudley 015B,E01009888,669,172,66,106,449,63,220,63,112,45,80,31,42,7,86,55,31,0,0,48,29,19
2021,Dudley 015C,E01009889,1183,456,54,402,600,24,243,71,138,34,138,77,55,6,180,132,48,15,15,127,62,65
2021,Dudley 015D,E01009890,669,170,66,104,452,25,211,63,104,44,89,33,51,5,119,89,30,8,8,47,31,16
2021,Dudley 016A,E01009749,961,221,92,129,704,77,359,119,162,78,176,98,72,6,89,61,28,3,3,36,24,12
2021,Dudley 016B,E01009750,595,150,77,73,415,69,182,68,68,46,78,28,40,10,83,50,33,3,3,30,16,14
2021,Dudley 016C,E01009823,532,109,71,38,397,87,235,90,83,62,47,23,20,4,27,9,18,1,1,26,13,13
2021,Dudley 016D,E01009824,856,314,137,177,516,55,209,64,97,48,131,58,64,9,118,87,31,3,3,26,8,18
2021,Dudley 017A,E01009751,687,253,94,159,413,54,158,57,61,40,100,44,51,5,94,48,46,7,7,21,13,8
2021,Dudley 017B,E01009752,646,167,78,89,453,41,164,58,73,33,91,26,55,10,154,116,38,3,3,26,12,14
2021,Dudley 017C,E01009753,619,157,62,95,434,35,147,41,63,43,107,34,62,11,142,92,50,3,3,28,15,13
2021,Dudley 017D,E01009754,693,168,77,91,489,47,188,70,61,57,91,34,48,9,146,104,42,17,17,36,25,11
2021,Dudley 017E,E01009841,679,269,80,189,373,39,166,54,79,33,52,22,26,4,102,67,35,14,14,37,21,16
2021,Dudley 018A,E01009840,542,171,61,110,316,19,161,35,94,32,58,31,24,3,75,48,27,3,3,55,37,18
2021,Dudley 018B,E01009842,678,268,109,159,373,41,148,45,71,32,73,29,39,5,105,72,33,6,6,37,26,11
2021,Dudley 018C,E01009843,652,194,91,103,433,83,187,73,69,45,83,43,31,9,75,42,33,5,5,25,16,9
2021,Dudley 018D,E01009871,914,328,115,213,553,66,228,87,86,55,134,71,53,10,121,71,50,4,4,33,17,16
2021,Dudley 018E,E01009875,633,201,81,120,411,57,178,56,67,55,96,40,53,3,78,50,28,2,2,21,13,8
2021,Dudley 019A,E01009825,615,176,86,90,420,70,197,60,80,57,78,39,34,5,73,43,30,2,2,19,7,12
2021,Dudley 019B,E01009826,633,171,128,43,445,146,226,72,101,53,47,25,18,4,24,13,11,2,2,17,8,9
2021,Dudley 019C,E01009827,628,115,75,40,499,114,282,63,143,76,59,25,26,8,43,23,20,1,1,14,7,7
2021,Dudley 019D,E01009828,571,158,117,41,396,95,181,73,63,45,61,22,29,10,56,29,27,3,3,17,5,12
2021,Dudley 019E,E01009829,626,168,129,39,434,82,232,80,96,56,63,19,37,7,56,34,22,1,1,24,17,7
2021,Dudley 019F,E01009830,630,123,84,39,493,115,274,83,118,73,57,24,32,1,46,15,31,1,1,14,11,3
2021,Dudley 020A,E01009872,508,128,40,88,357,22,149,42,72,35,72,31,35,6,111,85,26,3,3,23,12,11
2021,Dudley 020B,E01009873,653,173,76,97,447,89,210,78,82,50,73,38,25,10,69,34,35,6,6,33,19,14
2021,Dudley 020C,E01009874,578,124,62,62,420,39,203,65,84,54,90,33,50,7,87,57,30,1,1,34,21,13
2021,Dudley 020D,E01009876,682,186,117,69,465,77,196,61,80,55,84,38,42,4,105,68,37,3,3,31,18,13
2021,Dudley 020E,E01009877,672,187,70,117,448,27,157,46,70,41,90,37,46,7,169,118,51,5,5,37,19,18
2021,Dudley 021A,E01009911,602,215,122,93,364,111,162,67,54,41,56,33,19,4,31,17,14,4,4,23,11,12
2021,Dudley 021B,E01009912,889,273,109,164,583,99,292,95,153,44,115,66,44,5,76,48,28,1,1,33,12,21
2021,Dudley 021C,E01009913,652,177,117,60,453,85,198,82,68,48,90,38,44,8,75,55,20,5,5,22,13,9
2021,Dudley 021D,E01009914,590,148,117,31,425,139,195,70,86,39,61,31,27,3,30,14,16,0,0,17,5,12
2021,Dudley 021E,E01009915,734,238,92,146,471,79,230,85,101,44,111,65,40,6,51,28,23,0,0,25,7,18
2021,Dudley 021F,E01009916,755,253,96,157,478,63,221,89,86,46,98,53,41,4,93,59,34,3,3,24,14,10
2021,Dudley 022A,E01009741,1085,557,105,452,494,33,166,68,70,28,133,76,52,5,148,108,40,14,14,34,11,23
2021,Dudley 022B,E01009744,1076,497,111,386,533,49,193,72,88,33,154,103,45,6,129,93,36,8,8,46,22,24
2021,Dudley 022C,E01009746,884,406,140,266,431,39,159,58,75,26,90,47,41,2,133,94,39,10,10,47,29,18
2021,Dudley 022D,E01009747,687,243,67,176,420,36,157,67,62,28,115,62,47,6,109,77,32,3,3,24,14,10
2021,Dudley 023A,E01009731,735,248,60,188,467,42,221,97,88,36,111,69,35,7,88,57,31,5,5,20,9,11
2021,Dudley 023B,E01009740,864,223,57,166,611,33,229,66,122,41,181,71,96,14,165,120,45,3,3,30,19,11
2021,Dudley 023C,E01009742,669,198,93,105,453,42,168,54,80,34,91,37,44,10,150,99,51,2,2,18,10,8
2021,Dudley 023D,E01009743,709,181,90,91,494,43,195,61,96,38,123,40,74,9,129,86,43,4,4,34,16,18
2021,Dudley 023E,E01009745,745,220,99,121,504,84,239,95,91,53,115,61,48,6,65,36,29,1,1,21,11,10
2021,Dudley 024A,E01009917,497,96,57,39,388,97,184,61,78,45,63,32,27,4,44,20,24,0,0,13,2,11
2021,Dudley 024B,E01009918,604,170,105,65,413,55,143,45,59,39,97,41,49,7,118,58,60,0,0,21,13,8
2021,Dudley 024C,E01009919,501,130,86,44,357,104,161,58,61,42,51,19,26,6,39,10,29,2,2,14,7,7
2021,Dudley 024D,E01009920,730,208,72,136,507,75,227,89,95,43,126,78,42,6,74,38,36,5,5,15,10,5
2021,Dudley 025A,E01009864,600,133,55,78,430,69,192,64,91,37,84,39,42,3,80,48,32,5,5,37,24,13
2021,Dudley 025B,E01009865,673,196,100,96,450,53,175,60,87,28,105,40,55,10,113,82,31,4,4,27,9,18
2021,Dudley 025C,E01009866,773,285,102,183,455,62,205,84,87,34,112,60,43,9,72,42,30,4,4,33,11,22
2021,Dudley 025D,E01009867,710,192,84,108,479,84,246,103,95,48,80,28,47,5,68,33,35,1,1,39,20,19
2021,Dudley 025E,E01009878,898,219,80,139,639,83,325,118,134,73,140,55,76,9,86,46,40,5,5,40,21,19
2021,Dudley 026A,E01009791,662,219,98,121,412,59,196,59,86,51,80,35,39,6,72,47,25,5,5,31,18,13
2021,Dudley 026B,E01009792,626,206,87,119,365,42,169,46,92,31,70,33,31,6,80,45,35,4,4,55,35,20
2021,Dudley 026C,E01009795,744,274,88,186,435,39,197,66,102,29,82,44,34,4,110,77,33,7,7,35,17,18
2021,Dudley 026D,E01009796,634,159,81,78,432,54,220,64,96,60,71,29,30,12,84,57,27,3,3,43,27,16
2021,Dudley 026E,E01009798,1003,267,97,170,681,64,312,131,131,50,157,87,63,7,140,100,40,8,8,55,28,27
2021,Dudley 027A,E01009719,566,136,62,74,400,72,196,67,88,41,73,34,33,6,55,31,24,4,4,30,23,7
2021,Dudley 027B,E01009722,611,194,100,94,403,99,183,90,59,34,62,25,28,9,58,28,30,1,1,14,6,8
2021,Dudley 027C,E01009727,555,149,114,35,388,60,234,97,87,50,56,24,26,6,38,18,20,0,0,18,12,6
2021,Dudley 027D,E01009728,492,107,69,38,364,76,191,66,75,50,54,21,30,3,42,17,25,1,1,21,13,8
2021,Dudley 027E,E01009729,638,159,81,78,452,82,193,73,62,58,77,26,41,10,97,70,27,3,3,27,17,10
2021,Dudley 028A,E01009720,532,96,52,44,420,88,252,93,100,59,54,32,20,2,24,15,9,2,2,16,6,10
2021,Dudley 028B,E01009723,461,83,40,43,353,69,212,86,79,47,46,15,29,2,26,13,13,0,0,25,14,11
2021,Dudley 028C,E01009724,619,161,74,87,450,87,259,94,105,60,74,40,26,8,29,8,21,1,1,8,2,6
2021,Dudley 028D,E01009730,635,186,37,149,430,46,255,102,83,70,79,49,29,1,50,28,22,0,0,19,11,8
2021,Dudley 029A,E01009903,623,163,102,61,436,129,223,76,96,51,57,35,21,1,27,13,14,0,0,24,11,13
2021,Dudley 029B,E01009904,615,188,116,72,405,92,201,85,77,39,64,38,20,6,44,22,22,4,4,22,7,15
2021,Dudley 029C,E01009909,673,234,115,119,418,76,203,92,76,35,79,46,26,7,59,28,31,1,1,21,11,10
2021,Dudley 029D,E01009910,717,257,112,145,437,65,152,59,55,38,106,47,51,8,108,75,33,6,6,23,17,6
2021,Dudley 030A,E01009793,612,122,62,60,463,52,243,75,108,60,87,38,41,8,80,50,30,1,1,27,12,15
2021,Dudley 030B,E01009794,626,159,109,50,441,99,213,67,104,42,62,34,26,2,64,31,33,3,3,26,15,11
2021,Dudley 030C,E01009797,650,258,132,126,373,76,155,47,73,35,65,31,29,5,76,44,32,1,1,19,8,11
2021,Dudley 030D,E01009801,700,152,96,56,523,123,244,84,98,62,46,16,26,4,107,68,39,3,3,25,13,12
2021,Dudley 031A,E01009721,1109,414,170,244,633,82,296,118,137,41,155,100,52,3,93,49,44,7,7,62,18,44
2021,Dudley 031B,E01009725,633,202,64,138,405,34,120,36,65,19,84,30,46,8,167,121,46,0,0,26,11,15
2021,Dudley 031C,E01009726,547,160,75,85,365,76,179,63,61,55,65,31,33,1,43,28,15,2,2,22,12,10
2021,Dudley 031D,E01009834,736,269,101,168,433,60,187,61,77,49,87,44,35,8,92,53,39,7,7,34,17,17
2021,Dudley 032A,E01009833,529,159,51,108,296,21,150,32,91,27,49,26,18,5,67,47,20,9,9,74,36,38
2021,Dudley 032B,E01009835,603,149,52,97,391,39,240,57,135,48,61,36,20,5,48,30,18,3,3,63,30,33
2021,Dudley 032C,E01009869,672,209,96,113,445,66,199,74,72,53,121,59,52,10,56,31,25,3,3,18,9,9
2021,Dudley 032D,E01009870,754,323,134,189,416,96,193,88,52,53,82,55,25,2,41,19,22,4,4,15,6,9
2021,Dudley 033A,E01009809,687,210,109,101,439,30,166,51,81,34,122,64,54,4,119,78,41,2,2,38,21,17
2021,Dudley 033B,E01009813,656,184,105,79,438,64,179,72,69,38,93,46,36,11,99,63,36,3,3,34,16,18
2021,Dudley 033C,E01009861,725,227,76,151,448,59,212,75,93,44,77,33,38,6,92,51,41,8,8,50,12,38
2021,Dudley 033D,E01009862,755,208,89,119,509,65,204,69,86,49,111,49,58,4,125,95,30,4,4,38,22,16
2021,Dudley 033E,E01009863,793,218,65,153,539,53,241,80,112,49,122,64,55,3,120,81,39,3,3,36,16,20
2021,Dudley 033F,E01009868,664,214,98,116,423,52,160,65,68,27,106,57,42,7,100,53,47,5,5,27,15,12
2021,Dudley 034A,E01009734,679,237,121,116,413,63,181,54,81,46,69,31,35,3,96,68,28,4,4,29,11,18
2021,Dudley 034B,E01009735,701,196,94,102,480,70,264,83,109,72,86,45,35,6,55,35,20,5,5,25,9,16
2021,Dudley 034C,E01009736,617,176,96,80,423,101,192,61,84,47,77,42,34,1,53,25,28,0,0,18,8,10
2021,Dudley 034D,E01009737,699,239,138,101,436,98,189,65,75,49,77,44,27,6,69,42,27,3,3,24,9,15
2021,Dudley 034E,E01009738,603,138,80,58,433,49,227,49,125,53,72,30,38,4,81,41,40,4,4,32,19,13
2021,Dudley 035A,E01009856,973,423,135,288,512,56,229,75,115,39,144,93,47,4,80,47,33,3,3,38,18,20
2021,Dudley 035B,E01009905,664,218,93,125,432,71,196,79,77,40,110,65,41,4,54,31,23,1,1,14,6,8
2021,Dudley 035C,E01009906,904,464,162,302,423,41,147,60,67,20,126,77,38,11,103,63,40,6,6,17,8,9
2021,Dudley 035D,E01009907,668,241,126,115,393,51,179,66,77,36,88,61,27,0,72,49,23,3,3,34,11,23
2021,Dudley 035E,E01009908,685,199,84,115,475,73,225,62,113,50,105,67,33,5,69,41,28,3,3,11,7,4
2021,Dudley 036A,E01009800,649,207,130,77,416,106,216,57,102,57,51,21,27,3,43,23,20,0,0,26,17,9
2021,Dudley 036B,E01009802,680,151,76,75,495,70,257,71,117,69,87,37,42,8,80,55,25,1,1,34,18,16
2021,Dudley 036C,E01009803,648,159,117,42,455,125,268,85,121,62,36,13,20,3,26,7,19,0,0,34,20,14
2021,Dudley 036D,E01009804,536,146,82,64,368,104,200,84,64,52,29,13,13,3,32,13,19,3,3,22,13,9
2021,Dudley 037A,E01009831,637,228,117,111,375,49,172,53,66,53,65,28,31,6,84,50,34,5,5,34,21,13
2021,Dudley 037B,E01009836,881,438,118,320,387,21,134,52,66,16,99,29,58,12,133,105,28,0,0,56,39,17
2021,Dudley 037C,E01009837,669,232,79,153,374,46,169,47,82,40,76,51,22,3,81,54,27,2,2,63,35,28
2021,Dudley 037D,E01009838,698,202,98,104,447,63,188,50,91,47,97,34,51,12,93,39,54,6,6,49,15,34
2021,Dudley 038A,E01009847,621,141,93,48,462,104,203,59,84,60,77,35,35,7,75,47,28,3,3,18,7,11
2021,Dudley 038B,E01009848,623,214,118,96,390,64,171,54,76,41,91,43,38,10,62,41,21,2,2,19,12,7
2021,Dudley 038C,E01009849,657,181,79,102,446,73,192,59,92,41,99,42,45,12,76,33,43,6,6,30,18,12
2021,Dudley 038D,E01009851,647,171,108,63,458,96,273,87,127,59,46,19,26,1,43,18,25,0,0,18,4,14
2021,Dudley 039A,E01009732,745,228,114,114,480,79,218,62,108,48,73,40,27,6,104,61,43,6,6,37,16,21
2021,Dudley 039B,E01009733,948,468,152,316,443,25,116,47,55,14,123,64,55,4,168,117,51,11,11,37,16,21
2021,Dudley 039C,E01009739,666,184,89,95,453,49,190,68,92,30,92,44,42,6,115,79,36,7,7,29,10,19
2021,Dudley 039D,E01009799,702,267,152,115,420,106,202,62,90,50,58,32,25,1,52,25,27,2,2,15,6,9
2021,Dudley 039E,E01009805,650,204,97,107,409,81,193,73,74,46,66,38,23,5,66,29,37,3,3,37,12,25
2021,Dudley 039F,E01009806,698,267,122,145,407,82,198,77,83,38,73,49,23,1,52,20,32,2,2,24,13,11
2021,Dudley 040A,E01009854,643,173,118,55,451,118,251,76,115,60,57,33,22,2,24,11,13,1,1,19,6,13
2021,Dudley 040B,E01009857,700,225,106,119,439,45,181,60,85,36,96,47,43,6,106,66,40,11,11,36,24,12
2021,Dudley 040C,E01009858,670,317,119,198,346,70,134,52,62,20,90,67,20,3,51,30,21,1,1,7,4,3
2021,Dudley 040D,E01009859,641,166,90,76,453,98,255,84,113,58,58,40,15,3,39,18,21,3,3,22,13,9
2021,Dudley 041A,E01009845,650,170,109,61,450,156,244,81,126,37,37,17,17,3,12,5,7,1,1,30,18,12
2021,Dudley 041B,E01009846,639,178,119,59,424,100,230,71,93,66,54,31,16,7,37,21,16,3,3,37,13,24
2021,Dudley 041C,E01009850,662,215,117,98,426,109,214,61,115,38,50,31,16,3,51,34,17,2,2,21,9,12
2021,Dudley 041D,E01009852,607,137,112,25,449,142,235,93,96,46,39,22,12,5,33,14,19,0,0,21,8,13
2021,Dudley 042A,E01009832,733,228,138,90,477,40,178,54,83,41,86,37,38,11,167,118,49,6,6,28,18,10
2021,Dudley 042B,E01009853,621,169,138,31,431,135,218,85,96,37,43,29,11,3,34,14,20,1,1,21,12,9
2021,Dudley 042C,E01009855,642,133,96,37,477,153,261,90,99,72,39,18,19,2,24,15,9,0,0,32,23,9
2021,Dudley 042D,E01009860,634,153,116,37,446,131,233,85,95,53,36,21,11,4,43,21,22,3,3,35,18,17
2021,Dudley 043A,E01009807,749,173,118,55,547,126,306,90,156,60,67,23,42,2,48,16,32,0,0,29,16,13
2021,Dudley 043B,E01009808,591,144,88,56,430,112,232,85,98,49,51,29,17,5,33,14,19,2,2,17,7,10
2021,Dudley 043C,E01009810,770,232,128,104,505,91,259,74,126,59,70,33,32,5,83,43,40,2,2,33,19,14
2021,Dudley 043D,E01009811,653,204,118,86,428,91,196,58,95,43,64,32,25,7,75,43,32,2,2,21,14,7
2021,Dudley 043E,E01009812,577,103,77,26,454,92,253,79,113,61,63,33,23,7,41,21,20,5,5,20,12,8
2021,Sandwell 001A,E01010085,665,194,71,123,437,48,225,77,104,44,97,34,58,5,66,39,27,1,1,34,14,20
2021,Sandwell 001B,E01010086,674,201,78,123,428,46,194,53,86,55,80,27,49,4,102,74,28,6,6,45,28,17
2021,Sandwell 001C,E01010087,621,124,63,61,459,57,221,73,101,47,87,27,51,9,89,53,36,5,5,38,20,18
2021,Sandwell 001D,E01010088,566,117,50,67,395,33,198,67,83,48,90,27,52,11,66,35,31,8,8,54,31,23
2021,Sandwell 001E,E01010089,694,167,84,83,485,47,214,58,106,50,105,41,52,12,110,63,47,9,9,42,30,12
2021,Sandwell 002A,E01009969,802,192,60,132,531,34,223,57,114,52,102,42,54,6,165,120,45,7,7,79,52,27
2021,Sandwell 002B,E01009970,687,177,80,97,475,46,248,66,128,54,70,27,37,6,107,76,31,4,4,35,24,11
2021,Sandwell 002C,E01009971,687,193,83,110,455,40,181,52,92,37,99,36,48,15,128,83,45,7,7,39,25,14
2021,Sandwell 002D,E01009973,770,140,55,85,517,31,323,64,175,84,62,22,33,7,96,52,44,5,5,113,86,27
2021,Sandwell 003A,E01009960,628,196,88,108,390,33,162,41,74,47,97,30,55,12,93,57,36,5,5,42,26,16
2021,Sandwell 003B,E01009961,530,140,77,63,366,60,188,72,75,41,66,24,36,6,49,23,26,3,3,24,14,10
2021,Sandwell 003C,E01009966,465,120,48,72,320,38,139,45,64,30,76,15,47,14,64,48,16,3,3,25,20,5
2021,Sandwell 003D,E01009967,771,218,81,137,518,49,250,82,121,47,109,45,53,11,105,68,37,5,5,35,21,14
2021,Sandwell 003E,E01010092,798,280,115,165,473,56,215,63,98,54,78,38,32,8,119,85,34,5,5,45,36,9
2021,Sandwell 004A,E01009962,516,137,66,71,346,34,152,43,67,42,49,15,29,5,107,63,44,4,4,33,21,12
2021,Sandwell 004B,E01009963,502,123,59,64,350,21,157,49,64,44,71,19,45,7,98,66,32,3,3,29,17,12
2021,Sandwell 004C,E01009964,584,132,56,76,418,36,152,41,73,38,91,11,67,13,131,97,34,8,8,34,18,16
2021,Sandwell 004D,E01009965,452,72,41,31,348,22,165,43,79,43,59,8,43,8,97,71,26,5,5,32,17,15
2021,Sandwell 005A,E01010090,816,250,73,177,522,47,193,62,97,34,131,51,72,8,145,112,33,6,6,44,24,20
2021,Sandwell 005B,E01010091,691,265,96,169,359,51,178,62,76,40,65,36,25,4,62,28,34,3,3,67,49,18
2021,Sandwell 005C,E01010096,797,299,147,152,458,82,204,90,67,47,73,27,38,8,98,71,27,1,1,40,32,8
2021,Sandwell 005D,E01010097,783,222,132,90,516,104,246,103,85,58,83,38,37,8,79,43,36,4,4,45,25,20
2021,Sandwell 006A,E01009968,636,214,102,112,375,68,194,35,96,63,45,26,16,3,65,33,32,3,3,47,30,17
2021,Sandwell 006B,E01009972,742,173,113,60,503,91,256,75,121,60,78,34,40,4,72,36,36,6,6,66,33,33
2021,Sandwell 006C,E01009974,667,177,92,85,435,88,225,62,92,71,60,25,28,7,59,29,30,3,3,55,24,31
2021,Sandwell 006D,E01009975,672,172,100,72,443,92,237,78,92,67,47,23,19,5,64,23,41,3,3,57,37,20
2021,Sandwell 007A,E01010030,714,246,66,180,426,39,137,44,61,32,90,24,56,10,154,124,30,6,6,42,30,12
2021,Sandwell 007B,E01010034,500,96,32,64,386,35,244,102,69,73,66,34,25,7,41,20,21,0,0,18,8,10
2021,Sandwell 007C,E01010035,599,171,105,66,409,110,196,77,61,58,51,22,26,3,50,27,23,2,2,19,11,8
2021,Sandwell 007D,E01010036,690,142,56,86,487,22,207,59,92,56,123,38,74,11,130,92,38,5,5,61,40,21
2021,Sandwell 009A,E01009982,557,112,45,67,398,23,196,53,93,50,82,26,48,8,91,62,29,6,6,47,29,18
2021,Sandwell 009B,E01009983,601,132,72,60,441,56,181,72,67,42,78,26,48,4,125,79,46,1,1,28,18,10
2021,Sandwell 009C,E01010029,596,165,75,90,386,31,122,36,53,33,97,14,79,4,132,107,25,4,4,45,29,16
2021,Sandwell 009D,E01010037,490,111,55,56,353,29,128,35,62,31,76,23,48,5,115,82,33,5,5,26,16,10
2021,Sandwell 010A,E01009991,844,226,67,159,535,38,271,62,125,84,90,26,55,9,133,78,55,3,3,83,54,29
2021,Sandwell 010B,E01009994,641,173,67,106,407,44,192,51,96,45,64,18,41,5,101,59,42,6,6,61,39,22
2021,Sandwell 010C,E01009995,627,162,74,88,423,51,191,58,85,48,69,18,46,5,109,84,25,3,3,42,25,17
2021,Sandwell 010D,E01009996,648,181,82,99,428,52,176,47,80,49,72,24,44,4,125,80,45,3,3,39,22,17
2021,Sandwell 010E,E01009997,660,155,54,101,444,42,187,54,96,37,68,20,38,10,142,98,44,5,5,61,37,24
2021,Sandwell 010F,E01009998,808,224,87,137,519,38,240,65,120,55,88,28,54,6,143,109,34,10,10,65,46,19
2021,Sandwell 011A,E01010008,627,163,81,82,412,49,210,51,99,60,49,13,30,6,101,49,52,3,3,52,36,16
2021,Sandwell 011B,E01010010,628,219,70,149,374,50,158,45,79,34,44,23,17,4,121,85,36,1,1,35,27,8
2021,Sandwell 011C,E01010011,719,222,111,111,442,56,212,49,106,57,66,25,31,10,103,50,53,5,5,55,34,21
2021,Sandwell 011D,E01010012,569,142,72,70,398,65,217,68,100,49,44,14,29,1,68,35,33,4,4,29,20,9
2021,Sandwell 012A,E01010007,545,159,68,91,347,47,155,36,76,43,42,18,16,8,97,60,37,6,6,39,20,19
2021,Sandwell 012B,E01010009,553,131,64,67,388,45,180,35,87,58,47,18,23,6,113,66,47,3,3,34,19,15
2021,Sandwell 012C,E01010013,522,150,87,63,329,71,147,35,57,55,50,24,25,1,54,20,34,7,7,43,29,14
2021,Sandwell 012D,E01010014,697,227,114,113,427,73,197,57,96,44,58,27,25,6,91,43,48,8,8,43,26,17
2021,Sandwell 013A,E01010093,713,293,108,185,375,19,204,57,123,24,66,33,29,4,74,41,33,12,12,45,26,19
2021,Sandwell 013B,E01010094,574,105,42,63,384,37,203,42,100,61,37,9,24,4,104,72,32,3,3,85,52,33
2021,Sandwell 013C,E01010095,687,125,37,88,478,36,219,42,130,47,91,29,55,7,129,84,45,3,3,84,65,19
2021,Sandwell 013D,E01010098,815,295,106,189,469,49,208,61,97,50,89,34,46,9,122,63,59,1,1,51,33,18
2021,Sandwell 013E,E01010099,668,186,80,106,436,51,241,65,125,51,61,21,34,6,83,51,32,0,0,46,28,18
2021,Sandwell 013F,E01010100,724,187,81,106,435,60,221,41,121,59,58,27,29,2,90,47,43,6,6,102,66,36
2021,Sandwell 014A,E01009978,652,127,78,49,479,59,232,53,100,79,79,18,52,9,101,48,53,8,8,46,28,18
2021,Sandwell 014B,E01010031,721,277,89,188,414,38,129,48,50,31,128,59,62,7,112,73,39,7,7,30,20,10
2021,Sandwell 014C,E01010032,521,102,43,59,381,16,141,29,86,26,71,12,50,9,146,105,41,7,7,38,27,11
2021,Sandwell 014D,E01010033,780,330,91,239,421,46,170,56,70,44,83,39,34,10,116,92,24,6,6,29,19,10
2021,Sandwell 014F,E01033886,573,123,37,86,415,17,196,53,125,18,93,33,50,10,108,69,39,1,1,35,25,10
2021,Sandwell 014G,E01033887,616,204,59,145,369,25,165,43,80,42,73,27,42,4,97,57,40,9,9,43,28,15
2021,Sandwell 015A,E01010066,696,282,144,138,357,49,183,51,99,33,49,23,22,4,69,43,26,7,7,57,46,11
2021,Sandwell 015B,E01010067,705,276,57,219,356,22,160,45,92,23,61,33,24,4,104,65,39,9,9,73,53,20
2021,Sandwell 015C,E01010068,697,198,91,107,456,40,207,68,100,39,89,27,53,9,117,81,36,3,3,43,29,14
2021,Sandwell 015D,E01010070,828,352,111,241,439,44,221,81,87,53,80,33,42,5,88,58,30,6,6,37,20,17
2021,Sandwell 015E,E01010075,489,68,22,46,357,15,218,59,101,58,53,25,25,3,67,42,25,4,4,64,44,20
2021,Sandwell 015F,E01010076,862,312,151,161,491,47,214,58,113,43,119,55,58,6,103,71,32,8,8,59,41,18
2021,Sandwell 016A,E01009976,1054,251,62,189,722,53,376,108,191,77,151,74,73,4,137,85,52,5,5,81,50,31
2021,Sandwell 016B,E01009977,799,214,68,146,521,27,282,68,158,56,84,36,45,3,124,80,44,4,4,64,32,32
2021,Sandwell 016C,E01009979,848,382,162,220,388,35,136,51,60,25,82,35,41,6,125,82,43,10,10,78,62,16
2021,Sandwell 016D,E01009980,859,271,63,208,504,33,253,59,135,59,69,35,29,5,139,86,53,10,10,84,54,30
2021,Sandwell 016E,E01010069,731,100,38,62,505,37,289,49,164,76,51,18,27,6,98,55,43,30,30,126,100,26
2021,Sandwell 016F,E01010071,681,216,51,165,396,28,191,52,93,46,66,33,30,3,104,61,43,7,7,69,47,22
2021,Sandwell 017A,E01009947,912,272,110,162,574,50,298,81,153,64,81,42,30,9,141,92,49,4,4,66,44,22
2021,Sandwell 017B,E01009992,615,163,84,79,357,29,206,41,106,59,45,18,23,4,77,45,32,0,0,95,59,36
2021,Sandwell 017C,E01009993,725,251,83,168,410,31,202,50,110,42,53,14,33,6,114,65,49,10,10,64,43,21
2021,Sandwell 017D,E01010103,960,415,94,321,484,33,222,44,143,35,76,37,33,6,144,85,59,9,9,61,40,21
2021,Sandwell 017E,E01010104,820,347,146,201,420,57,206,70,79,57,63,42,18,3,90,34,56,4,4,53,30,23
2021,Sandwell 017F,E01010105,543,136,36,100,312,38,169,32,83,54,41,25,15,1,56,28,28,8,8,95,65,30
2021,Sandwell 018A,E01009981,766,207,82,125,491,44,227,61,113,53,86,32,39,15,127,75,52,7,7,68,36,32
2021,Sandwell 018C,E01009985,667,209,94,115,405,41,200,37,112,51,46,18,21,7,110,70,40,8,8,53,41,12
2021,Sandwell 018F,E01033888,543,167,66,101,321,35,161,30,94,37,34,8,20,6,76,50,26,15,15,55,36,19
2021,Sandwell 018G,E01033889,660,156,40,116,447,19,238,57,140,41,66,19,41,6,114,75,39,10,10,57,43,14
2021,Sandwell 019A,E01009986,540,141,56,85,307,31,186,47,105,34,27,9,17,1,58,43,15,5,5,92,57,35
2021,Sandwell 019B,E01009987,593,238,108,130,310,31,181,33,89,59,31,14,17,0,63,42,21,4,4,45,35,10
2021,Sandwell 019C,E01009989,653,185,105,80,370,36,197,53,102,42,59,18,37,4,69,39,30,9,9,98,69,29
2021,Sandwell 019D,E01010106,636,198,46,152,312,25,165,44,91,30,34,22,12,0,82,50,32,6,6,126,78,48
2021,Sandwell 020A,E01009988,1060,311,124,187,651,37,342,88,199,55,92,29,49,14,171,101,70,9,9,98,55,43
2021,Sandwell 020B,E01010101,920,397,128,269,459,35,187,54,87,46,101,75,22,4,130,83,47,6,6,64,43,21
2021,Sandwell 020C,E01010102,707,222,76,146,404,44,192,41,97,54,63,19,40,4,96,55,41,9,9,81,54,27
2021,Sandwell 020D,E01010107,802,294,76,218,367,7,172,34,103,35,34,11,20,3,146,90,56,8,8,141,83,58
2021,Sandwell 021A,E01010015,718,170,77,93,472,52,277,74,146,57,56,14,38,4,83,42,41,4,4,76,43,33
2021,Sandwell 021B,E01010016,612,178,51,127,359,24,176,42,101,33,62,29,27,6,89,49,40,8,8,75,53,22
2021,Sandwell 021C,E01010018,1002,350,69,281,585,32,260,71,152,37,134,66,63,5,145,87,58,14,14,67,38,29
2021,Sandwell 021D,E01010072,972,347,59,288,554,24,264,84,151,29,110,53,50,7,151,103,48,5,5,71,41,30
2021,Sandwell 021E,E01010073,631,152,53,99,439,43,222,51,130,41,58,16,34,8,110,68,42,6,6,40,15,25
2021,Sandwell 022A,E01010077,672,215,76,139,418,45,162,46,72,44,79,29,42,8,128,95,33,4,4,39,24,15
2021,Sandwell 022B,E01010079,613,162,64,98,425,65,236,76,94,66,77,33,39,5,45,23,22,2,2,26,16,10
2021,Sandwell 022C,E01010080,768,224,48,176,503,27,198,33,126,39,102,36,52,14,169,131,38,7,7,41,28,13
2021,Sandwell 022D,E01010081,665,192,90,102,446,71,231,73,94,64,78,41,36,1,59,37,22,7,7,27,16,11
2021,Sandwell 022E,E01010082,852,178,59,119,614,47,368,112,173,83,88,47,36,5,106,66,40,5,5,60,49,11
2021,Sandwell 022F,E01010083,689,152,73,79,488,45,222,65,108,49,103,26,71,6,110,77,33,8,8,49,26,23
2021,Sandwell 022G,E01010084,555,99,44,55,411,23,174,54,84,36,79,20,49,10,131,100,31,4,4,45,20,25
2021,Sandwell 023A,E01010046,810,130,25,105,523,9,326,38,246,42,60,21,34,5,121,83,38,7,7,157,123,34
2021,Sandwell 023B,E01010047,589,114,34,80,334,27,208,32,132,44,25,5,16,4,65,34,31,9,9,141,93,48
2021,Sandwell 023C,E01010048,526,71,38,33,333,19,205,29,130,46,35,6,25,4,57,27,30,17,17,122,85,37
2021,Sandwell 023D,E01010049,561,125,57,68,316,22,186,27,114,45,21,10,9,2,74,41,33,13,13,120,60,60
2021,Sandwell 023E,E01010050,513,87,46,41,333,32,218,29,126,63,18,3,13,2,56,24,32,9,9,93,66,27
2021,Sandwell 023F,E01010052,477,129,55,74,282,16,161,26,108,27,29,13,15,1,68,34,34,8,8,66,46,20
2021,Sandwell 023G,E01010053,668,154,37,117,419,14,232,22,156,54,38,13,24,1,120,77,43,15,15,95,61,34
2021,Sandwell 024A,E01010017,882,385,141,244,426,32,177,49,95,33,63,37,23,3,121,84,37,33,33,71,36,35
2021,Sandwell 024B,E01010019,668,191,45,146,402,19,239,47,156,36,37,7,27,3,101,68,33,6,6,75,47,28
2021,Sandwell 024C,E01010020,702,129,68,61,474,44,253,38,153,62,45,18,20,7,122,66,56,10,10,99,52,47
2021,Sandwell 024D,E01010021,675,174,53,121,429,31,215,37,135,43,57,24,30,3,116,59,57,10,10,72,51,21
2021,Sandwell 025A,E01010039,773,160,69,91,570,31,242,51,144,47,158,70,82,6,132,100,32,7,7,43,25,18
2021,Sandwell 025B,E01010043,592,153,92,61,403,77,214,85,83,46,64,25,30,9,47,13,34,1,1,36,20,16
2021,Sandwell 025C,E01010044,621,166,80,86,432,44,185,52,93,40,98,48,44,6,104,68,36,1,1,23,14,9
2021,Sandwell 025D,E01010078,525,145,93,52,360,97,193,73,72,48,38,15,17,6,31,12,19,1,1,20,13,7
2021,Sandwell 027A,E01009934,595,177,78,99,391,40,142,39,76,27,58,20,31,7,141,100,41,10,10,27,17,10
2021,Sandwell 027B,E01009935,1041,397,109,288,608,34,233,67,116,50,122,41,67,14,209,167,42,10,10,36,24,12
2021,Sandwell 027C,E01009936,661,183,111,72,430,96,195,65,77,53,82,40,34,8,54,24,30,3,3,48,27,21
2021,Sandwell 027D,E01010004,878,387,122,265,439,45,186,65,79,42,94,48,42,4,112,76,36,2,2,52,31,21
2021,Sandwell 028A,E01010054,908,432,148,284,419,29,173,42,107,24,47,29,14,4,157,83,74,13,13,57,40,17
2021,Sandwell 028B,E01010055,631,128,37,91,416,20,227,36,152,39,56,21,31,4,103,81,22,10,10,87,62,25
2021,Sandwell 028C,E01010056,656,187,86,101,389,33,181,34,99,48,51,23,22,6,113,72,41,11,11,80,55,25
2021,Sandwell 028D,E01010057,698,200,96,104,386,31,212,29,145,38,41,17,24,0,91,59,32,11,11,112,78,34
2021,Sandwell 028E,E01010060,701,205,43,162,364,15,167,32,111,24,42,18,22,2,128,82,46,12,12,132,80,52
2021,Sandwell 029A,E01010038,705,165,72,93,509,45,210,59,96,55,118,43,64,11,133,100,33,3,3,31,17,14
2021,Sandwell 029B,E01010040,589,163,81,82,395,76,174,58,71,45,56,23,27,6,84,49,35,5,5,31,16,15
2021,Sandwell 029C,E01010041,792,280,163,117,484,68,154,49,74,31,106,39,59,8,151,106,45,5,5,28,13,15
2021,Sandwell 029D,E01010045,638,158,72,86,423,45,195,65,75,55,86,31,45,10,91,66,25,6,6,57,36,21
2021,Sandwell 030A,E01010000,752,264,125,139,439,51,220,60,111,49,74,39,27,8,88,50,38,6,6,49,27,22
2021,Sandwell 030B,E01010002,870,238,79,159,569,56,256,71,136,49,114,58,49,7,134,86,48,9,9,63,35,28
2021,Sandwell 030C,E01010003,706,313,99,214,340,22,150,50,62,38,72,33,36,3,93,60,33,3,3,53,27,26
2021,Sandwell 030D,E01010005,608,176,56,120,371,43,179,47,86,46,50,22,23,5,87,58,29,12,12,61,31,30
2021,Sandwell 030E,E01010006,679,185,74,111,431,61,227,60,106,61,62,30,26,6,75,41,34,6,6,63,35,28
2021,Sandwell 031A,E01009938,682,159,87,72,472,57,216,46,109,61,72,25,32,15,120,68,52,7,7,51,35,16
2021,Sandwell 031B,E01009943,489,93,61,32,330,22,173,33,96,44,39,15,19,5,89,53,36,7,7,66,49,17
2021,Sandwell 031C,E01009944,621,145,73,72,408,27,210,45,115,50,61,26,28,7,105,63,42,5,5,68,32,36
2021,Sandwell 031D,E01010051,493,123,53,70,313,30,158,33,89,36,43,10,26,7,82,48,34,0,0,57,36,21
2021,Sandwell 031E,E01010058,649,206,84,122,407,30,206,55,104,47,48,17,24,7,114,68,46,9,9,36,24,12
2021,Sandwell 032A,E01009937,613,151,64,87,426,33,185,62,84,39,80,27,41,12,121,66,55,7,7,36,24,12
2021,Sandwell 032B,E01009939,679,195,89,106,448,59,233,51,121,61,69,32,28,9,84,47,37,3,3,36,20,16
2021,Sandwell 032C,E01009940,607,186,99,87,374,36,176,46,92,38,59,19,34,6,95,57,38,8,8,47,31,16
2021,Sandwell 032D,E01009941,620,187,90,97,386,51,207,57,93,57,47,18,20,9,77,35,42,4,4,47,26,21
2021,Sandwell 032E,E01009942,652,157,78,79,455,64,214,47,105,62,62,18,33,11,111,60,51,4,4,40,25,15
2021,Sandwell 033A,E01009929,724,223,114,109,454,44,193,60,88,45,84,36,43,5,126,75,51,7,7,47,29,18
2021,Sandwell 033B,E01009930,644,196,83,113,416,34,157,58,73,26,83,25,51,7,134,86,48,8,8,32,21,11
2021,Sandwell 033C,E01009931,963,207,80,127,699,105,358,132,145,81,126,75,44,7,108,55,53,2,2,57,29,28
2021,Sandwell 033D,E01009932,792,400,197,203,345,40,133,52,54,27,81,48,27,6,88,45,43,3,3,47,21,26
2021,Sandwell 033E,E01009999,561,144,52,92,365,52,161,39,75,47,61,25,30,6,85,53,32,6,6,52,34,18
2021,Sandwell 034A,E01009921,757,227,61,166,466,23,185,57,99,29,131,92,36,3,106,79,27,21,21,64,29,35
2021,Sandwell 034B,E01009922,506,104,51,53,358,39,152,38,77,37,63,23,32,8,99,48,51,5,5,44,29,15
2021,Sandwell 034C,E01009924,630,199,69,130,378,32,158,46,85,27,107,71,30,6,74,43,31,7,7,53,12,41
2021,Sandwell 034D,E01009925,588,159,62,97,375,53,204,51,117,36,72,40,27,5,44,20,24,2,2,54,14,40
2021,Sandwell 034E,E01009926,621,202,50,152,370,25,179,54,95,30,90,50,38,2,72,43,29,4,4,49,16,33
2021,Sandwell 034F,E01009927,689,273,80,193,346,20,151,64,68,19,94,59,33,2,71,43,28,10,10,70,22,48
2021,Sandwell 034G,E01009928,751,256,86,170,443,17,184,70,95,19,82,51,31,0,144,100,44,16,16,52,24,28
2021,Sandwell 035A,E01009933,553,151,76,75,360,35,170,51,68,51,71,24,40,7,82,50,32,2,2,42,26,16
2021,Sandwell 035B,E01009952,942,360,111,249,527,22,166,55,81,30,115,58,51,6,217,150,67,7,7,55,29,26
2021,Sandwell 035C,E01009955,883,356,99,257,443,48,178,49,96,33,102,44,52,6,108,72,36,7,7,84,60,24
2021,Sandwell 035D,E01009956,720,260,106,154,419,43,179,59,74,46,91,43,42,6,104,66,38,2,2,41,21,20
2021,Sandwell 035E,E01009959,607,134,81,53,462,86,266,107,99,60,62,31,26,5,48,23,25,0,0,11,4,7
2021,Sandwell 035F,E01010042,809,286,139,147,480,55,217,71,104,42,94,55,32,7,107,55,52,7,7,43,24,19
2021,Sandwell 036A,E01009923,597,162,102,60,389,60,203,63,102,38,57,25,26,6,68,34,34,1,1,46,26,20
2021,Sandwell 036B,E01010024,655,210,108,102,417,74,216,49,109,58,61,25,31,5,61,38,23,5,5,28,20,8
2021,Sandwell 036C,E01010026,713,184,99,85,485,70,243,62,119,62,57,25,28,4,109,46,63,6,6,44,27,17
2021,Sandwell 036D,E01010027,616,149,70,79,418,63,241,69,120,52,52,25,25,2,61,28,33,1,1,49,35,14
2021,Sandwell 037A,E01010001,766,216,113,103,498,53,220,70,94,56,88,32,47,9,127,81,46,10,10,52,35,17
2021,Sandwell 037B,E01010022,624,150,63,87,437,59,235,71,107,57,61,28,28,5,80,34,46,2,2,37,20,17
2021,Sandwell 037C,E01010023,790,250,121,129,497,81,237,72,100,65,77,33,39,5,97,63,34,5,5,43,24,19
2021,Sandwell 037D,E01010025,706,251,152,99,407,38,184,59,94,31,78,27,44,7,104,67,37,3,3,48,31,17
2021,Sandwell 037E,E01010028,651,223,105,118,401,29,168,47,88,33,81,30,42,9,113,74,39,10,10,27,13,14
2021,Sandwell 038A,E01009953,974,364,128,236,579,50,212,91,86,35,150,78,62,10,163,128,35,4,4,31,14,17
2021,Sandwell 038B,E01009954,755,229,117,112,491,63,227,73,107,47,84,34,41,9,111,70,41,6,6,35,18,17
2021,Sandwell 038C,E01009957,696,220,69,151,430,32,177,58,95,24,82,24,52,6,135,100,35,4,4,46,28,18
2021,Sandwell 038D,E01009958,665,169,90,79,481,85,253,81,108,64,87,42,37,8,55,21,34,1,1,15,10,5
2021,Sandwell 039A,E01009946,691,183,87,96,445,75,221,60,101,60,69,26,36,7,74,37,37,6,6,63,34,29
2021,Sandwell 039B,E01009948,609,139,87,52,443,96,214,52,85,77,54,27,22,5,73,26,47,6,6,27,14,13
2021,Sandwell 039C,E01009949,573,118,77,41,389,90,222,58,108,56,31,17,13,1,41,20,21,5,5,66,51,15
2021,Sandwell 039D,E01009950,660,164,92,72,448,76,249,67,106,76,54,22,25,7,63,23,40,6,6,48,24,24
2021,Sandwell 039E,E01009951,1061,412,79,333,572,33,174,56,70,48,139,78,56,5,205,167,38,21,21,77,29,48
2021,Sandwell 039F,E01032592,726,188,93,95,502,93,223,88,91,44,72,29,33,10,111,64,47,3,3,36,23,13
2021,Sandwell 040A,E01010062,852,311,108,203,460,21,229,30,152,47,42,19,16,7,157,95,62,11,11,81,60,21
2021,Sandwell 040D,E01010064,800,285,84,201,425,20,240,50,157,33,48,31,16,1,102,64,38,15,15,90,53,37
2021,Sandwell 040B,E01033890,435,94,12,82,274,5,136,14,108,14,44,17,24,3,84,65,19,5,5,67,37,30
2021,Sandwell 040C,E01033891,561,211,36,175,285,1,123,18,91,14,52,22,29,1,99,65,34,10,10,65,47,18
2021,Sandwell 041D,E01010059,705,152,27,125,414,11,237,34,168,35,29,15,14,0,127,88,39,10,10,139,61,78
2021,Sandwell 041B,E01010061,541,83,29,54,364,14,214,22,156,36,28,7,20,1,99,67,32,9,9,94,63,31
2021,Sandwell 041A,E01033892,612,135,13,122,395,4,186,24,134,28,53,25,26,2,140,104,36,12,12,82,58,24
2021,Sandwell 041C,E01033893,497,95,9,86,330,3,186,21,141,24,53,18,31,4,82,63,19,6,6,72,54,18
2021,Solihull 001A,E01010118,504,135,78,57,343,70,177,63,67,47,50,17,19,14,44,23,21,2,2,26,13,13
2021,Solihull 001B,E01010120,648,280,128,152,352,59,132,56,41,35,60,32,23,5,100,70,30,1,1,16,8,8
2021,Solihull 001C,E01010121,609,152,91,61,410,99,208,71,88,49,60,22,31,7,39,14,25,4,4,47,23,24
2021,Solihull 001D,E01010122,600,180,111,69,392,102,190,66,79,45,64,35,26,3,34,10,24,2,2,28,16,12
2021,Solihull 002A,E01010235,562,146,62,84,368,42,103,35,45,23,71,20,43,8,145,96,49,7,7,48,31,17
2021,Solihull 002B,E01010236,574,175,66,109,366,27,108,34,48,26,56,18,32,6,172,117,55,3,3,33,22,11
2021,Solihull 002C,E01010239,622,164,74,90,411,51,152,50,66,36,59,21,28,10,146,96,50,3,3,47,23,24
2021,Solihull 002D,E01010240,561,186,67,119,341,22,129,37,59,33,70,26,36,8,117,84,33,3,3,34,16,18
2021,Solihull 003A,E01010117,566,116,82,34,423,74,249,81,89,79,49,17,29,3,51,24,27,0,0,27,12,15
2021,Solihull 003B,E01010119,599,136,96,40,434,78,236,69,99,68,84,25,48,11,33,21,12,3,3,29,17,12
2021,Solihull 003C,E01010123,628,185,135,50,407,70,228,74,90,64,57,22,28,7,50,29,21,2,2,36,16,20
2021,Solihull 003D,E01010124,619,137,76,61,456,96,232,80,91,61,74,32,34,8,52,24,28,2,2,26,13,13
2021,Solihull 004A,E01010146,622,134,65,69,454,41,158,50,70,38,93,26,50,17,158,90,68,4,4,34,17,17
2021,Solihull 004B,E01010234,743,247,64,183,457,41,156,39,91,26,79,27,45,7,176,140,36,5,5,39,20,19
2021,Solihull 004C,E01010237,756,208,115,93,507,69,198,63,71,64,96,30,52,14,136,81,55,8,8,41,14,27
2021,Solihull 004D,E01010238,630,241,61,180,357,48,106,26,54,26,72,26,40,6,128,89,39,3,3,32,19,13
2021,Solihull 005A,E01010145,679,192,103,89,442,54,206,63,101,42,87,36,35,16,91,58,33,4,4,45,18,27
2021,Solihull 005B,E01010147,650,169,50,119,445,22,122,34,63,25,93,25,55,13,207,168,39,1,1,36,16,20
2021,Solihull 005C,E01010148,700,218,107,111,435,24,159,33,86,40,78,18,49,11,168,114,54,6,6,47,31,16
2021,Solihull 005D,E01010149,632,156,93,63,444,79,191,63,75,53,97,40,48,9,75,24,51,2,2,32,18,14
2021,Solihull 006A,E01010125,840,318,119,199,488,34,168,55,60,53,100,28,68,4,183,132,51,3,3,34,15,19
2021,Solihull 006B,E01010129,746,304,114,190,400,41,121,35,54,32,83,31,40,12,151,116,35,4,4,42,20,22
2021,Solihull 006C,E01010139,431,129,69,60,279,52,104,31,38,35,51,22,24,5,71,52,19,1,1,23,11,12
2021,Solihull 006D,E01010141,636,279,74,205,338,23,95,33,39,23,60,21,33,6,159,118,41,1,1,19,9,10
2021,Solihull 007A,E01010140,607,207,78,129,370,30,129,37,44,48,60,14,33,13,148,101,47,3,3,30,20,10
2021,Solihull 007B,E01010142,636,231,70,161,371,18,100,27,41,32,71,18,47,6,177,135,42,5,5,34,15,19
2021,Solihull 007C,E01010143,701,237,98,139,445,39,129,34,70,25,77,20,48,9,195,145,50,5,5,19,10,9
2021,Solihull 007D,E01010144,739,224,100,124,481,52,187,64,74,49,98,35,47,16,141,94,47,3,3,34,16,18
2021,Solihull 008A,E01010111,638,221,57,164,377,27,110,33,50,27,66,22,38,6,165,115,50,9,9,40,23,17
2021,Solihull 008B,E01010126,633,224,81,143,387,38,102,39,39,24,77,21,48,8,167,119,48,3,3,22,10,12
2021,Solihull 008C,E01010127,748,209,84,125,494,54,193,52,105,36,104,42,58,4,140,102,38,3,3,45,19,26
2021,Solihull 008D,E01010128,656,204,89,115,415,49,144,46,57,41,54,23,25,6,162,105,57,6,6,37,18,19
2021,Solihull 008E,E01010130,776,262,96,166,481,36,129,34,55,40,105,37,55,13,202,137,65,9,9,33,17,16
2021,Solihull 008F,E01010131,689,273,94,179,371,34,116,45,48,23,68,28,32,8,142,99,43,11,11,45,26,19
2021,Solihull 009A,E01010109,654,155,85,70,462,84,215,70,88,57,90,40,42,8,72,49,23,1,1,37,18,19
2021,Solihull 009B,E01010110,576,125,69,56,413,81,226,66,92,68,62,27,27,8,41,27,14,3,3,38,15,23
2021,Solihull 009C,E01010112,684,215,73,142,439,40,172,61,64,47,122,61,44,17,103,66,37,2,2,30,19,11
2021,Solihull 009D,E01010113,552,172,91,81,349,47,136,44,55,37,80,36,34,10,85,57,28,1,1,31,15,16
2021,Solihull 009E,E01010114,778,228,121,107,498,97,252,73,120,59,83,45,29,9,66,33,33,0,0,52,26,26
2021,Solihull 010A,E01010157,592,140,47,93,440,42,209,65,99,45,99,53,41,5,86,48,38,4,4,12,7,5
2021,Solihull 010B,E01010159,540,131,65,66,367,31,207,46,103,58,63,32,28,3,61,29,32,5,5,42,23,19
2021,Solihull 010C,E01010162,619,159,96,63,429,71,251,86,113,52,47,21,23,3,55,24,31,5,5,31,17,14
2021,Solihull 010D,E01010163,563,117,54,63,411,50,236,60,119,57,64,26,32,6,58,25,33,3,3,35,20,15
2021,Solihull 011A,E01010132,627,172,99,73,416,57,211,70,100,41,72,36,25,11,72,37,35,4,4,39,20,19
2021,Solihull 011B,E01010133,687,209,128,81,431,90,217,52,103,62,57,29,27,1,63,31,32,4,4,47,23,24
2021,Solihull 011C,E01010134,578,135,83,52,415,52,222,63,117,42,81,42,30,9,57,30,27,3,3,28,14,14
2021,Solihull 011D,E01010135,650,196,99,97,418,64,204,74,75,55,78,31,42,5,72,39,33,0,0,36,13,23
2021,Solihull 011E,E01010138,588,166,90,76,393,53,209,62,99,48,77,42,30,5,52,31,21,2,2,29,17,12
2021,Solihull 012A,E01010136,509,125,58,67,369,46,205,61,106,38,67,36,28,3,48,29,19,3,3,15,9,6
2021,Solihull 012B,E01010137,645,276,136,140,328,67,140,37,66,37,53,26,24,3,66,39,27,2,2,41,20,21
2021,Solihull 012C,E01010158,635,227,101,126,365,29,151,48,71,32,67,23,39,5,113,69,44,5,5,43,26,17
2021,Solihull 012D,E01010160,627,175,90,85,428,76,214,63,95,56,58,31,22,5,77,38,39,3,3,24,15,9
2021,Solihull 012E,E01010161,614,161,97,64,417,65,225,53,118,54,67,32,27,8,56,24,32,4,4,36,22,14
2021,Solihull 013A,E01010174,689,172,80,92,488,66,254,74,122,58,79,47,29,3,84,47,37,5,5,29,17,12
2021,Solihull 013B,E01010175,709,201,104,97,457,115,235,69,110,56,58,39,14,5,48,33,15,1,1,51,20,31
2021,Solihull 013C,E01010177,572,188,82,106,361,53,178,52,82,44,57,29,25,3,67,42,25,6,6,23,7,16
2021,Solihull 013D,E01010178,973,493,170,323,433,47,209,77,101,31,81,56,23,2,90,54,36,6,6,47,16,31
2021,Solihull 014A,E01010172,578,119,89,30,428,78,281,72,145,64,37,16,17,4,29,19,10,3,3,31,17,14
2021,Solihull 014B,E01010173,539,113,72,41,402,93,257,68,136,53,25,15,9,1,24,13,11,3,3,24,16,8
2021,Solihull 014C,E01010176,485,77,50,27,371,82,221,64,101,56,35,11,23,1,31,13,18,2,2,37,22,15
2021,Solihull 014D,E01010179,786,354,235,119,398,101,189,72,82,35,54,35,13,6,52,26,26,2,2,34,12,22
2021,Solihull 015A,E01010115,669,224,106,118,414,70,236,73,109,54,52,25,24,3,53,24,29,3,3,31,17,14
2021,Solihull 015B,E01010116,519,85,62,23,405,105,238,74,109,55,23,12,9,2,36,13,23,3,3,29,22,7
2021,Solihull 015C,E01010227,775,209,130,79,532,126,300,100,145,55,58,35,17,6,45,22,23,3,3,34,17,17
2021,Solihull 015D,E01010228,661,174,98,76,457,78,235,67,118,50,74,37,29,8,66,43,23,4,4,30,9,21
2021,Solihull 015E,E01010232,1007,393,125,268,559,44,207,61,118,28,123,59,58,6,179,122,57,6,6,55,19,36
2021,Solihull 016A,E01010195,578,107,81,26,437,111,274,59,161,54,23,9,8,6,28,13,15,1,1,34,21,13
2021,Solihull 016B,E01010226,921,452,276,176,443,134,183,63,92,28,63,51,12,0,57,28,29,6,6,26,14,12
2021,Solihull 016C,E01010229,565,100,74,26,432,98,265,59,142,64,34,11,18,5,32,13,19,3,3,33,19,14
2021,Solihull 016D,E01010230,756,240,117,123,478,64,259,67,143,49,75,46,27,2,78,54,24,2,2,38,18,20
2021,Solihull 016E,E01010231,640,137,87,50,456,127,264,64,140,60,33,15,16,2,30,11,19,2,2,47,25,22
2021,Solihull 016F,E01010233,810,222,103,119,535,62,254,86,128,40,94,65,25,4,123,69,54,2,2,53,31,22
2021,Solihull 017A,E01010108,913,250,120,130,624,111,362,115,181,66,85,64,19,2,64,40,24,2,2,39,17,22
2021,Solihull 017B,E01010164,723,184,107,77,518,108,295,119,116,60,63,38,21,4,49,22,27,3,3,21,15,6
2021,Solihull 017C,E01010165,831,307,166,141,485,101,233,76,119,38,74,46,19,9,74,48,26,3,3,39,16,23
2021,Solihull 017D,E01010167,649,146,64,82,464,85,277,111,100,66,54,32,20,2,42,21,21,6,6,39,20,19
2021,Solihull 018A,E01010199,685,132,83,49,513,83,334,58,209,67,31,7,19,5,63,28,35,2,2,40,27,13
2021,Solihull 018B,E01010200,653,256,165,91,368,62,171,46,92,33,48,21,23,4,81,49,32,6,6,29,12,17
2021,Solihull 018C,E01010201,723,207,145,62,478,116,254,64,134,56,40,20,18,2,66,33,33,2,2,38,22,16
2021,Solihull 018D,E01010204,660,284,90,194,344,34,144,50,73,21,60,29,28,3,102,67,35,4,4,32,16,16
2021,Solihull 018E,E01010205,545,116,64,52,393,72,250,71,128,51,33,15,17,1,37,19,18,1,1,36,19,17
2021,Solihull 018F,E01010206,638,110,63,47,497,66,308,71,169,68,64,27,31,6,59,31,28,0,0,31,18,13
2021,Solihull 019A,E01010192,813,291,115,176,498,104,293,102,145,46,57,44,8,5,42,21,21,2,2,24,13,11
2021,Solihull 019B,E01010196,621,93,67,26,484,106,320,85,155,80,33,12,13,8,21,8,13,4,4,44,25,19
2021,Solihull 019C,E01010197,638,114,86,28,493,132,312,90,155,67,18,9,7,2,29,16,13,2,2,31,14,17
2021,Solihull 019D,E01010198,736,256,178,78,455,111,272,75,153,44,33,20,11,2,39,23,16,0,0,25,7,18
2021,Solihull 021A,E01010218,649,286,128,158,346,58,136,44,58,34,58,27,26,5,91,54,37,3,3,17,9,8
2021,Solihull 021B,E01010219,677,211,116,95,433,76,222,63,103,56,66,40,22,4,69,41,28,0,0,33,12,21
2021,Solihull 021C,E01010221,905,320,174,146,557,77,280,90,134,56,95,51,41,3,102,70,32,3,3,28,11,17
2021,Solihull 021D,E01010222,629,210,90,120,396,85,186,67,72,47,58,26,26,6,65,36,29,2,2,23,11,12
2021,Solihull 022A,E01010191,802,225,129,96,545,133,305,77,163,65,49,29,16,4,53,32,21,5,5,32,18,14
2021,Solihull 022B,E01010202,602,138,82,56,429,78,263,47,149,67,35,19,12,4,50,27,23,3,3,35,22,13
2021,Solihull 022C,E01010203,732,250,112,138,445,53,225,45,138,42,76,38,35,3,87,53,34,4,4,37,18,19
2021,Solihull 022D,E01010209,679,173,86,87,469,64,233,58,133,42,77,40,35,2,90,59,31,5,5,37,24,13
2021,Solihull 022E,E01010213,718,225,127,98,450,39,240,69,118,53,65,32,32,1,102,54,48,4,4,43,19,24
2021,Solihull 023A,E01010208,623,147,105,42,444,95,252,65,132,55,47,20,23,4,46,20,26,4,4,32,16,16
2021,Solihull 023B,E01010210,633,136,94,42,469,128,266,86,112,68,41,23,12,6,32,11,21,2,2,28,14,14
2021,Solihull 023C,E01010211,661,259,157,102,377,85,179,54,81,44,52,34,15,3,61,21,40,0,0,25,13,12
2021,Solihull 023D,E01010217,630,149,93,56,454,75,260,79,127,54,68,39,26,3,48,26,22,3,3,27,11,16
2021,Solihull 024A,E01010190,668,181,92,89,463,85,284,96,134,54,50,31,16,3,43,23,20,1,1,24,11,13
2021,Solihull 024B,E01010193,475,71,44,27,393,92,250,79,114,57,22,10,11,1,29,14,15,0,0,11,5,6
2021,Solihull 024C,E01010194,649,150,73,77,478,86,283,92,132,59,38,22,12,4,67,37,30,4,4,21,11,10
2021,Solihull 024D,E01010207,585,168,106,62,396,82,235,69,107,59,34,16,15,3,44,18,26,1,1,21,10,11
2021,Solihull 025A,E01010166,726,152,78,74,539,126,279,61,162,56,66,37,26,3,67,36,31,1,1,35,13,22
2021,Solihull 025B,E01010168,788,249,151,98,512,88,298,109,133,56,67,38,25,4,58,33,25,1,1,27,9,18
2021,Solihull 025C,E01010169,715,191,116,75,495,120,266,89,127,50,59,27,25,7,48,25,23,2,2,29,16,13
2021,Solihull 025D,E01010170,559,88,60,28,443,111,269,78,138,53,39,20,14,5,24,12,12,0,0,28,16,12
2021,Solihull 025E,E01010171,550,124,77,47,403,95,228,69,106,53,43,21,18,4,37,25,12,0,0,23,15,8
2021,Solihull 026A,E01010151,787,324,177,147,443,87,231,72,114,45,52,34,16,2,71,51,20,2,2,20,4,16
2021,Solihull 026B,E01010152,499,88,64,24,398,93,249,82,130,37,29,13,15,1,26,11,15,1,1,13,6,7
2021,Solihull 026C,E01010153,727,175,111,64,537,146,272,80,149,43,49,26,19,4,68,48,20,2,2,15,5,10
2021,Solihull 026D,E01010154,671,169,124,45,481,170,249,77,127,45,29,15,13,1,31,17,14,2,2,21,12,9
2021,Solihull 026E,E01010155,771,237,152,85,512,120,279,71,154,54,49,16,30,3,63,31,32,1,1,22,10,12
2021,Solihull 026F,E01010156,620,146,110,36,453,122,273,75,137,61,22,13,8,1,34,14,20,2,2,21,14,7
2021,Solihull 027A,E01010212,483,81,51,30,379,84,240,71,103,66,29,14,14,1,26,10,16,0,0,23,8,15
2021,Solihull 027B,E01010214,503,135,75,60,356,77,201,76,96,29,37,28,7,2,40,17,23,1,1,12,1,11
2021,Solihull 027C,E01010215,654,168,76,92,462,105,244,82,103,59,46,29,14,3,63,40,23,4,4,24,12,12
2021,Solihull 027D,E01010216,612,165,59,106,424,68,248,71,133,44,49,33,15,1,59,36,23,0,0,23,14,9
2021,Solihull 028A,E01010150,656,164,131,33,478,130,288,75,163,50,28,16,10,2,32,16,16,0,0,14,8,6
2021,Solihull 028B,E01010184,696,245,130,115,430,72,206,53,126,27,57,21,31,5,92,69,23,3,3,21,13,8
2021,Solihull 028C,E01010185,620,138,114,24,470,127,294,91,157,46,23,13,10,0,26,14,12,0,0,12,6,6
2021,Solihull 028D,E01010186,784,226,140,86,543,96,300,74,179,47,62,43,15,4,81,48,33,4,4,15,6,9
2021,Solihull 028E,E01010187,517,71,40,31,420,60,303,79,168,56,27,15,9,3,30,17,13,0,0,26,10,16
2021,Solihull 028F,E01010188,709,165,129,36,525,138,313,101,153,59,43,19,23,1,29,19,10,2,2,19,7,12
2021,Solihull 029A,E01010180,636,176,107,69,448,74,229,64,114,51,76,38,35,3,66,50,16,3,3,12,5,7
2021,Solihull 029B,E01010181,1052,208,76,132,794,97,446,113,258,75,135,81,50,4,114,92,22,2,2,50,22,28
2021,Solihull 029D,E01010183,742,133,58,75,579,112,298,81,150,67,99,71,27,1,70,54,16,0,0,30,14,16
2021,Solihull 029E,E01010189,664,154,98,56,491,100,281,88,142,51,56,30,23,3,50,26,24,4,4,19,9,10
2021,Solihull 029F,E01032885,862,412,31,381,416,14,158,57,87,14,160,141,19,0,77,57,20,7,7,34,7,27
2021,Solihull 029G,E01032886,1095,261,47,214,788,61,451,125,261,65,144,82,58,4,128,87,41,4,4,46,23,23
2021,Solihull 030A,E01010220,665,178,94,84,465,66,268,63,148,57,67,26,37,4,60,33,27,4,4,22,10,12
2021,Solihull 030B,E01010223,476,119,74,45,329,33,181,50,96,35,49,18,30,1,63,38,25,3,3,28,16,12
2021,Solihull 030C,E01010225,578,124,50,74,430,51,247,53,146,48,77,43,30,4,55,27,28,0,0,24,11,13
2021,Solihull 030D,E01032590,963,314,137,177,582,90,326,94,163,69,96,61,32,3,64,38,26,6,6,67,35,32
2021,Walsall 001A,E01010301,615,191,82,109,404,70,144,60,45,39,87,37,43,7,102,67,35,1,1,20,13,7
2021,Walsall 001B,E01010303,633,153,75,78,451,76,209,86,76,47,86,39,38,9,79,44,35,1,1,29,18,11
2021,Walsall 001C,E01010306,904,235,81,154,614,51,303,104,141,58,150,80,62,8,105,63,42,5,5,55,35,20
2021,Walsall 001D,E01010307,680,156,68,88,491,53,289,80,138,71,98,47,45,6,48,32,16,3,3,33,14,19
2021,Walsall 002A,E01010302,634,189,100,89,412,53,164,61,57,46,96,38,46,12,90,68,22,9,9,33,20,13
2021,Walsall 002B,E01010304,733,212,119,93,495,118,210,75,81,54,98,40,47,11,68,46,22,1,1,26,16,10
2021,Walsall 002C,E01010305,518,120,64,56,376,47,152,53,56,43,81,30,44,7,94,58,36,2,2,22,13,9
2021,Walsall 002D,E01010308,880,402,163,239,446,48,161,60,64,37,102,43,48,11,131,96,35,4,4,32,17,15
2021,Walsall 003A,E01010345,474,115,86,29,339,87,176,69,70,37,42,23,19,0,31,14,17,3,3,20,13,7
2021,Walsall 003B,E01010346,517,111,55,56,380,88,191,70,72,49,59,17,35,7,38,12,26,4,4,26,11,15
2021,Walsall 003C,E01010347,639,215,122,93,404,49,178,62,73,43,82,30,36,16,90,65,25,5,5,20,7,13
2021,Walsall 003D,E01010350,579,129,70,59,438,55,231,78,97,56,86,50,31,5,64,37,27,2,2,12,7,5
2021,Walsall 004A,E01010249,763,216,67,149,503,61,189,79,70,40,114,54,54,6,129,89,40,10,10,44,25,19
2021,Walsall 004B,E01010250,577,149,77,72,402,81,173,60,72,41,78,35,38,5,69,45,24,1,1,26,12,14
2021,Walsall 004C,E01010252,736,212,96,116,494,75,208,73,85,50,99,37,59,3,105,80,25,7,7,30,12,18
2021,Walsall 004D,E01010254,614,193,97,96,388,48,202,67,91,44,61,27,28,6,75,41,34,2,2,33,13,20
2021,Walsall 005A,E01010348,637,172,100,72,446,72,175,54,73,48,105,52,42,11,91,54,37,3,3,19,9,10
2021,Walsall 005B,E01010349,614,256,150,106,335,65,137,47,53,37,65,27,33,5,66,34,32,2,2,23,10,13
2021,Walsall 005C,E01010351,743,219,119,100,492,102,242,89,99,54,82,41,34,7,65,33,32,1,1,32,18,14
2021,Walsall 005D,E01010352,684,186,134,52,460,121,229,92,88,49,49,21,21,7,57,27,30,4,4,38,17,21
2021,Walsall 006A,E01010284,684,215,123,92,437,48,192,59,81,52,88,22,54,12,107,75,32,2,2,32,17,15
2021,Walsall 006B,E01010285,746,181,106,75,521,101,246,76,100,70,103,50,43,10,70,33,37,1,1,44,22,22
2021,Walsall 006C,E01010286,641,180,106,74,432,37,179,57,73,49,90,21,53,16,123,83,40,3,3,29,15,14
2021,Walsall 006D,E01010290,774,279,148,131,476,85,183,64,73,46,84,35,40,9,119,72,47,5,5,19,5,14
2021,Walsall 007A,E01010251,568,91,45,46,459,69,283,91,127,65,75,36,31,8,32,13,19,0,0,18,10,8
2021,Walsall 007B,E01010253,524,157,80,77,344,62,148,56,61,31,63,26,27,10,65,40,25,6,6,23,10,13
2021,Walsall 007C,E01010255,618,173,131,42,434,141,185,69,72,44,59,32,23,4,48,17,31,1,1,11,6,5
2021,Walsall 007D,E01010256,707,247,107,140,437,73,192,71,80,41,90,48,35,7,76,34,42,6,6,23,6,17
2021,Walsall 007E,E01010257,497,125,90,35,357,87,178,67,71,40,53,21,30,2,39,17,22,0,0,15,6,9
2021,Walsall 008A,E01010292,931,405,144,261,483,53,178,65,75,38,144,85,47,12,102,65,37,6,6,43,15,28
2021,Walsall 008B,E01010294,653,259,95,164,365,25,160,59,63,38,83,30,45,8,90,55,35,7,7,29,14,15
2021,Walsall 008C,E01010296,621,151,71,80,454,74,244,95,95,54,89,42,38,9,39,21,18,8,8,16,7,9
2021,Walsall 008D,E01010297,576,133,98,35,428,114,248,96,82,70,43,25,14,4,23,6,17,0,0,15,6,9
2021,Walsall 009A,E01010291,546,132,68,64,379,35,133,34,61,38,89,20,61,8,117,79,38,5,5,35,23,12
2021,Walsall 009B,E01010293,783,299,176,123,459,80,179,64,66,49,90,44,39,7,99,65,34,11,11,25,12,13
2021,Walsall 009C,E01010298,486,120,54,66,336,45,143,47,56,40,77,27,35,15,69,39,30,2,2,30,14,16
2021,Walsall 009D,E01010299,591,146,62,84,410,23,154,46,74,34,106,33,63,10,124,81,43,3,3,35,22,13
2021,Walsall 009E,E01010300,622,186,97,89,406,40,143,54,51,38,97,34,54,9,118,71,47,8,8,30,18,12
2021,Walsall 010A,E01010319,479,81,34,47,351,53,223,68,94,61,39,16,17,6,32,13,19,4,4,47,27,20
2021,Walsall 010B,E01010321,636,179,96,83,416,42,186,58,81,47,92,37,49,6,94,50,44,2,2,41,24,17
2021,Walsall 010C,E01010353,677,201,106,95,446,73,203,71,80,52,78,34,35,9,86,47,39,6,6,30,14,16
2021,Walsall 010D,E01010354,651,160,97,63,463,87,198,64,73,61,76,28,41,7,99,58,41,3,3,28,15,13
2021,Walsall 011A,E01010395,492,76,42,34,389,74,238,73,99,66,48,18,26,4,28,14,14,1,1,27,11,16
2021,Walsall 011B,E01010397,615,126,59,67,458,47,192,56,82,54,97,18,67,12,120,85,35,2,2,31,21,10
2021,Walsall 011C,E01010398,620,136,86,50,453,87,271,98,97,76,56,24,28,4,39,17,22,0,0,31,19,12
2021,Walsall 011D,E01010399,630,153,64,89,455,77,211,81,80,50,92,36,47,9,74,51,23,1,1,22,16,6
2021,Walsall 012A,E01010282,508,124,45,79,351,19,158,49,71,38,77,34,34,9,94,57,37,3,3,33,24,9
2021,Walsall 012B,E01010287,724,270,119,151,419,46,188,62,84,42,96,37,45,14,78,42,36,11,11,35,17,18
2021,Walsall 012C,E01010288,621,167,79,88,421,37,168,54,77,37,101,40,52,9,108,77,31,7,7,33,22,11
2021,Walsall 012D,E01010289,715,174,84,90,499,47,175,46,93,36,99,30,61,8,172,131,41,6,6,42,25,17
2021,Walsall 013B,E01010277,653,172,93,79,436,35,198,61,87,50,90,35,45,10,109,70,39,4,4,45,30,15
2021,Walsall 013D,E01010283,673,179,51,128,448,22,167,39,98,30,117,31,80,6,138,103,35,4,4,46,25,21
2021,Walsall 013F,E01033894,603,104,35,69,471,25,192,44,128,20,104,28,68,8,146,127,19,4,4,28,22,6
2021,Walsall 013G,E01033895,557,91,32,59,424,14,176,49,104,23,105,39,58,8,125,95,30,4,4,42,26,16
2021,Walsall 014A,E01010393,582,138,84,54,407,78,199,56,87,56,61,28,22,11,65,34,31,4,4,37,17,20
2021,Walsall 014B,E01010394,514,112,62,50,367,72,179,57,83,39,59,17,36,6,56,31,25,1,1,35,21,14
2021,Walsall 014C,E01010396,641,152,72,80,457,45,204,56,91,57,115,44,61,10,90,55,35,3,3,32,16,16
2021,Walsall 014D,E01010400,959,337,118,219,589,63,160,59,66,35,160,53,98,9,196,146,50,10,10,33,16,17
2021,Walsall 015A,E01010241,1113,456,262,194,621,154,284,116,116,52,93,56,33,4,88,38,50,2,2,36,10,26
2021,Walsall 015B,E01010242,783,319,165,154,433,50,150,44,64,42,109,46,51,12,116,85,31,8,8,31,13,18
2021,Walsall 015C,E01010243,691,233,169,64,443,106,211,66,91,54,59,28,27,4,65,36,29,2,2,15,4,11
2021,Walsall 015D,E01010244,608,159,77,82,419,34,158,61,58,39,100,44,50,6,118,89,29,9,9,30,21,9
2021,Walsall 016A,E01010320,584,181,78,103,376,52,143,56,47,40,76,37,33,6,104,64,40,1,1,27,13,14
2021,Walsall 016B,E01010322,709,208,81,127,464,51,197,67,99,31,104,49,50,5,107,73,34,5,5,37,22,15
2021,Walsall 016C,E01010323,620,182,100,82,399,76,185,57,76,52,68,28,32,8,68,35,33,2,2,39,27,12
2021,Walsall 016D,E01010324,832,268,91,177,541,40,218,77,92,49,111,49,56,6,120,80,40,52,52,23,12,11
2021,Walsall 017A,E01010271,793,202,68,134,551,38,230,72,108,50,115,37,67,11,165,126,39,3,3,40,26,14
2021,Walsall 017B,E01010272,693,270,81,189,386,21,113,50,39,24,95,34,59,2,153,106,47,4,4,37,17,20
2021,Walsall 017C,E01010273,604,179,86,93,384,35,115,36,41,38,103,31,58,14,131,90,41,0,0,41,31,10
2021,Walsall 017D,E01010295,635,203,104,99,401,36,154,53,62,39,90,25,50,15,116,77,39,5,5,31,15,16
2021,Walsall 018B,E01010279,789,229,89,140,514,40,235,85,127,23,93,34,50,9,143,103,40,3,3,46,35,11
2021,Walsall 018D,E01010374,905,193,45,148,616,32,288,70,178,40,125,50,61,14,159,121,38,12,12,96,61,35
2021,Walsall 018E,E01010375,731,175,39,136,453,13,246,44,165,37,58,21,34,3,121,83,38,15,15,103,81,22
2021,Walsall 018F,E01032888,1017,275,127,148,671,51,290,82,134,74,125,46,62,17,198,143,55,7,7,71,45,26
2021,Walsall 019A,E01010378,471,120,57,63,321,72,164,50,74,40,43,20,21,2,40,23,17,2,2,30,16,14
2021,Walsall 019B,E01010379,565,156,99,57,394,104,185,69,61,55,62,26,30,6,42,16,26,1,1,15,8,7
2021,Walsall 019C,E01010382,640,179,99,80,420,99,163,55,56,52,77,26,43,8,81,45,36,0,0,41,20,21
2021,Walsall 019D,E01010383,747,300,121,179,412,34,146,46,72,28,105,36,63,6,125,81,44,2,2,35,19,16
2021,Walsall 020A,E01010376,494,111,51,60,353,81,190,67,54,69,43,18,17,8,37,15,22,2,2,30,24,6
2021,Walsall 020B,E01010377,727,185,80,105,516,49,226,71,109,46,136,64,68,4,99,59,40,6,6,26,13,13
2021,Walsall 020C,E01010380,672,228,163,65,422,120,202,78,69,55,58,26,26,6,39,17,22,3,3,22,9,13
2021,Walsall 020D,E01010381,675,214,79,135,444,62,170,67,63,40,86,30,49,7,123,61,62,3,3,17,13,4
2021,Walsall 021A,E01010267,687,202,97,105,447,67,224,82,100,42,85,42,39,4,66,24,42,5,5,38,21,17
2021,Walsall 021B,E01010268,563,135,38,97,365,21,190,19,136,35,49,19,27,3,97,67,30,8,8,63,45,18
2021,Walsall 021C,E01010274,593,142,68,74,409,26,148,48,66,34,93,23,57,13,139,99,40,3,3,42,25,17
2021,Walsall 021D,E01010275,740,205,107,98,500,42,197,64,86,47,93,29,60,4,159,110,49,9,9,35,18,17
2021,Walsall 022A,E01010245,677,191,140,51,467,123,224,65,103,56,62,31,26,5,55,25,30,3,3,19,13,6
2021,Walsall 022B,E01010246,633,152,93,59,455,68,254,76,109,69,72,30,32,10,59,22,37,2,2,26,14,12
2021,Walsall 022C,E01010247,679,206,124,82,457,98,234,74,107,53,55,28,24,3,68,31,37,2,2,16,5,11
2021,Walsall 022D,E01010248,633,138,101,37,465,98,284,86,132,66,45,20,19,6,34,14,20,4,4,30,21,9
2021,Walsall 022E,E01010388,566,124,87,37,406,106,233,67,97,69,39,15,18,6,25,9,16,3,3,36,19,17
2021,Walsall 023A,E01010258,730,244,113,131,465,46,169,52,75,42,75,23,48,4,167,113,54,8,8,21,13,8
2021,Walsall 023B,E01010259,626,156,92,64,426,68,195,73,78,44,80,27,46,7,78,46,32,5,5,44,27,17
2021,Walsall 023C,E01010260,714,191,81,110,490,53,232,61,129,42,86,34,48,4,115,79,36,4,4,33,19,14
2021,Walsall 023D,E01010266,509,124,61,63,345,38,120,41,55,24,68,19,41,8,118,73,45,1,1,40,26,14
2021,Walsall 024A,E01010317,685,205,118,87,433,123,240,88,93,59,37,20,12,5,31,14,17,2,2,47,25,22
2021,Walsall 024B,E01010318,782,369,118,251,365,45,122,42,56,24,66,26,36,4,125,75,50,7,7,48,22,26
2021,Walsall 024C,E01010325,774,253,71,182,458,63,238,66,119,53,75,44,28,3,76,40,36,6,6,63,40,23
2021,Walsall 024D,E01010369,817,393,93,300,368,21,164,70,73,21,88,48,28,12,85,52,33,10,10,56,26,30
2021,Walsall 025A,E01010401,662,171,71,100,455,54,164,49,78,37,102,38,60,4,131,66,65,4,4,36,21,15
2021,Walsall 025B,E01010403,728,205,50,155,456,20,209,59,103,47,98,27,66,5,121,84,37,8,8,67,49,18
2021,Walsall 025C,E01010404,803,230,68,162,521,36,184,46,96,42,120,54,57,9,174,97,77,7,7,52,29,23
2021,Walsall 025D,E01010407,698,158,77,81,489,62,231,75,97,59,78,25,45,8,113,76,37,5,5,51,34,17
2021,Walsall 025E,E01010408,736,235,62,173,454,22,182,66,78,38,110,52,54,4,132,87,45,8,8,47,28,19
2021,Walsall 026A,E01010269,544,154,32,122,319,9,155,43,96,16,60,23,34,3,77,53,24,18,18,71,49,22
2021,Walsall 026B,E01010270,649,194,68,126,392,46,194,48,97,49,54,24,24,6,92,58,34,6,6,63,41,22
2021,Walsall 026C,E01010362,610,117,64,53,434,39,208,36,136,36,51,14,29,8,128,68,60,8,8,59,38,21
2021,Walsall 026D,E01010363,1125,440,80,360,590,19,249,77,142,30,129,75,47,7,159,110,49,34,34,95,49,46
2021,Walsall 027A,E01010402,665,161,69,92,443,49,243,76,113,54,83,30,49,4,64,43,21,4,4,61,38,23
2021,Walsall 027B,E01010405,777,278,71,207,446,40,194,54,92,48,99,48,48,3,100,56,44,13,13,53,30,23
2021,Walsall 027C,E01010406,1192,409,110,299,699,44,293,80,166,47,143,59,80,4,182,121,61,37,37,84,44,40
2021,Walsall 027D,E01010409,629,169,69,100,415,55,151,47,57,47,92,35,47,10,114,73,41,3,3,45,26,19
2021,Walsall 028A,E01010385,615,156,99,57,423,99,259,74,121,64,28,22,3,3,35,16,19,2,2,36,18,18
2021,Walsall 028B,E01010386,715,244,198,46,446,134,229,63,124,42,40,22,12,6,40,21,19,3,3,25,14,11
2021,Walsall 028C,E01010387,605,155,103,52,425,90,237,70,113,54,48,21,24,3,48,23,25,2,2,25,15,10
2021,Walsall 028D,E01010392,629,169,90,79,436,90,240,81,113,46,60,27,28,5,43,16,27,3,3,24,13,11
2021,Walsall 029A,E01010326,555,130,68,62,364,59,226,40,118,68,28,13,13,2,50,25,25,1,1,61,46,15
2021,Walsall 029B,E01010327,581,161,55,106,356,14,188,33,115,40,53,25,25,3,96,64,32,5,5,64,45,19
2021,Walsall 029C,E01010328,509,92,71,21,347,77,228,62,111,55,15,5,5,5,26,11,15,1,1,70,43,27
2021,Walsall 029D,E01010330,617,258,92,166,303,32,152,48,78,26,51,32,15,4,62,40,22,6,6,56,41,15
2021,Walsall 030A,E01010368,1177,661,131,530,451,22,157,47,88,22,133,96,34,3,121,74,47,18,18,65,39,26
2021,Walsall 030B,E01010370,871,355,85,270,459,32,170,40,101,29,95,49,40,6,152,115,37,10,10,57,37,20
2021,Walsall 030D,E01010372,602,191,66,125,344,30,172,48,91,33,53,29,20,4,83,53,30,6,6,67,35,32
2021,Walsall 030E,E01010373,522,111,47,64,344,37,200,50,96,54,23,10,10,3,80,54,26,4,4,67,47,20
2021,Walsall 030F,E01033896,658,288,51,237,306,4,135,36,87,12,45,25,19,1,113,91,22,9,9,64,45,19
2021,Walsall 030G,E01033897,486,139,25,114,297,3,139,26,92,21,45,26,17,2,102,78,24,8,8,50,31,19
2021,Walsall 031A,E01010361,572,143,56,87,388,36,207,68,90,49,43,32,10,1,93,49,44,9,9,41,20,21
2021,Walsall 031B,E01010364,473,82,41,41,331,24,177,27,117,33,41,6,28,7,80,49,31,9,9,60,42,18
2021,Walsall 031C,E01010365,672,250,75,175,370,17,193,44,121,28,39,24,15,0,115,96,19,6,6,52,31,21
2021,Walsall 031D,E01010366,624,167,82,85,399,23,229,33,163,33,38,14,21,3,103,66,37,6,6,58,43,15
2021,Walsall 031E,E01010367,621,144,76,68,398,33,238,48,152,38,46,15,25,6,75,52,23,6,6,79,45,34
2021,Walsall 032A,E01010384,562,129,79,50,415,76,220,53,113,54,64,30,27,7,54,23,31,1,1,18,10,8
2021,Walsall 032B,E01010389,577,130,78,52,401,105,228,70,100,58,36,16,17,3,31,12,19,1,1,46,26,20
2021,Walsall 032C,E01010390,704,193,103,90,483,95,263,74,127,62,68,25,38,5,52,30,22,5,5,28,15,13
2021,Walsall 032D,E01010391,754,175,101,74,540,96,280,85,134,61,87,40,41,6,74,36,38,3,3,39,19,20
2021,Walsall 033A,E01010261,728,180,76,104,522,30,168,49,86,33,107,43,59,5,211,159,52,6,6,26,18,8
2021,Walsall 033B,E01010263,533,137,31,106,338,27,202,42,109,51,36,11,23,2,69,44,25,4,4,58,43,15
2021,Walsall 033C,E01010264,764,214,84,130,494,36,219,62,105,52,103,50,47,6,132,92,40,4,4,56,38,18
2021,Walsall 033D,E01010265,700,178,42,136,448,21,214,33,136,45,71,27,42,2,135,96,39,7,7,74,51,23
2021,Walsall 034A,E01010336,503,112,42,70,334,28,213,40,123,50,30,14,14,2,55,35,20,8,8,57,41,16
2021,Walsall 034B,E01010340,581,176,50,126,340,17,173,25,119,29,28,12,16,0,119,87,32,3,3,65,44,21
2021,Walsall 034C,E01010341,473,92,35,57,318,28,212,25,148,39,13,4,6,3,61,29,32,4,4,63,44,19
2021,Walsall 034D,E01010342,517,87,29,58,350,6,214,27,162,25,30,10,20,0,95,65,30,5,5,80,56,24
2021,Walsall 034E,E01010343,463,91,41,50,315,14,201,30,141,30,22,7,14,1,72,44,28,6,6,57,33,24
2021,Walsall 034F,E01010344,583,139,71,68,387,26,223,35,155,33,37,19,16,2,93,58,35,8,8,57,41,16
2021,Walsall 035A,E01010331,623,147,111,36,424,111,249,57,123,69,19,10,6,3,44,23,21,1,1,52,32,20
2021,Walsall 035B,E01010332,649,127,76,51,399,97,243,55,124,64,15,10,2,3,40,19,21,4,4,123,82,41
2021,Walsall 035C,E01010333,626,186,124,62,382,76,219,55,101,63,32,18,10,4,47,27,20,8,8,58,35,23
2021,Walsall 035D,E01010334,573,125,100,25,385,89,242,65,113,64,19,8,11,0,32,13,19,3,3,63,39,24
2021,Walsall 036A,E01010262,689,180,59,121,457,36,212,62,85,65,90,37,50,3,112,71,41,7,7,52,34,18
2021,Walsall 036B,E01010309,884,315,67,248,521,40,247,56,150,41,81,24,52,5,146,102,44,7,7,48,23,25
2021,Walsall 036C,E01010311,1071,290,109,181,722,42,311,82,180,49,121,48,67,6,240,181,59,8,8,59,41,18
2021,Walsall 036D,E01010316,622,166,73,93,415,26,150,37,80,33,84,22,52,10,144,100,44,11,11,41,21,20
2021,Walsall 037A,E01010335,598,157,81,76,397,27,182,39,108,35,60,18,35,7,118,79,39,10,10,44,33,11
2021,Walsall 037B,E01010337,536,165,87,78,322,53,165,41,73,51,46,17,24,5,55,43,12,3,3,49,27,22
2021,Walsall 037C,E01010338,535,96,49,47,353,29,212,37,135,40,34,18,11,5,73,40,33,5,5,86,69,17
2021,Walsall 037D,E01010339,512,101,51,50,354,47,200,40,108,52,39,19,14,6,65,37,28,3,3,57,38,19
2021,Walsall 038A,E01010310,764,148,54,94,556,38,252,77,119,56,127,49,70,8,130,82,48,9,9,60,37,23
2021,Walsall 038B,E01010312,699,189,73,116,473,39,191,51,93,47,99,28,60,11,137,94,43,7,7,37,20,17
2021,Walsall 038C,E01010313,544,111,54,57,387,39,171,48,82,41,61,13,39,9,111,82,29,5,5,46,29,17
2021,Walsall 038D,E01010314,696,258,97,161,399,43,161,43,72,46,81,29,45,7,109,72,37,5,5,39,19,20
2021,Walsall 038E,E01010315,782,178,80,98,567,42,212,58,125,29,144,56,77,11,164,126,38,5,5,37,21,16
2021,Walsall 039A,E01010329,652,166,122,44,435,104,247,64,121,62,37,24,13,0,44,23,21,3,3,51,30,21
2021,Walsall 039B,E01010355,598,169,110,59,409,69,217,55,103,59,66,27,29,10,55,26,29,2,2,20,12,8
2021,Walsall 039C,E01010356,609,160,104,56,420,76,208,72,83,53,79,30,43,6,53,27,26,4,4,29,23,6
2021,Walsall 039D,E01010357,965,250,96,154,679,89,332,102,170,60,124,65,48,11,133,90,43,1,1,36,23,13
2021,Walsall 039E,E01010358,625,176,87,89,419,54,192,60,90,42,85,29,49,7,87,45,42,1,1,30,22,8
2021,Walsall 039F,E01010359,636,178,94,84,429,61,198,54,95,49,91,42,45,4,76,48,28,3,3,29,18,11
2021,Walsall 039G,E01010360,614,162,106,56,426,63,199,59,83,57,82,40,37,5,78,42,36,4,4,26,11,15
2021,Wolverhampton 001A,E01010434,743,215,95,120,481,55,194,66,88,40,98,34,54,10,129,76,53,5,5,47,24,23
2021,Wolverhampton 001B,E01010436,636,185,115,70,429,58,254,117,86,51,65,30,28,7,50,15,35,2,2,22,11,11
2021,Wolverhampton 001C,E01010437,502,116,44,72,360,63,183,79,54,50,75,38,29,8,37,16,21,2,2,26,17,9
2021,Wolverhampton 001D,E01010438,632,197,103,94,405,81,182,76,71,35,55,21,26,8,85,44,41,2,2,30,15,15
2021,Wolverhampton 001E,E01010439,523,149,82,67,356,41,148,52,70,26,72,18,44,10,93,49,44,2,2,18,10,8
2021,Wolverhampton 001F,E01010440,697,278,148,130,374,42,154,40,73,41,79,32,37,10,96,57,39,3,3,45,17,28
2021,Wolverhampton 001G,E01010441,542,124,75,49,390,46,140,54,51,35,70,20,45,5,128,87,41,6,6,28,14,14
2021,Wolverhampton 002A,E01010495,765,254,128,126,475,41,212,77,98,37,98,45,43,10,121,72,49,3,3,36,20,16
2021,Wolverhampton 002B,E01010497,457,107,54,53,321,56,186,65,68,53,46,22,19,5,32,17,15,1,1,29,9,20
2021,Wolverhampton 002C,E01010499,528,116,62,54,371,36,190,53,86,51,61,27,27,7,79,42,37,5,5,41,32,9
2021,Wolverhampton 002D,E01010500,508,113,39,74,342,25,142,38,74,30,46,10,28,8,124,91,33,5,5,53,34,19
2021,Wolverhampton 003A,E01010496,628,233,100,133,365,22,152,49,60,43,71,33,32,6,117,76,41,3,3,30,15,15
2021,Wolverhampton 003B,E01010498,653,243,83,160,389,44,204,108,54,42,85,47,33,5,51,21,30,5,5,21,12,9
2021,Wolverhampton 003C,E01010541,623,257,92,165,336,33,125,30,62,33,59,29,26,4,117,71,46,2,2,30,19,11
2021,Wolverhampton 003D,E01010543,555,161,47,114,363,25,136,48,66,22,81,23,55,3,115,81,34,6,6,31,20,11
2021,Wolverhampton 004A,E01010456,495,71,30,41,392,13,98,26,50,22,68,8,48,12,208,152,56,5,5,32,17,15
2021,Wolverhampton 004B,E01010457,649,169,82,87,436,65,224,75,100,49,60,25,30,5,80,45,35,7,7,44,21,23
2021,Wolverhampton 004C,E01010462,636,217,91,126,369,15,159,46,75,38,60,23,33,4,129,81,48,6,6,50,34,16
2021,Wolverhampton 004D,E01010481,526,119,58,61,366,31,143,30,69,44,65,17,39,9,119,83,36,8,8,41,26,15
2021,Wolverhampton 005A,E01010555,692,262,111,151,404,37,147,56,59,32,81,29,42,10,135,91,44,4,4,26,14,12
2021,Wolverhampton 005B,E01010556,594,166,69,97,413,52,193,66,66,61,93,41,46,6,74,52,22,1,1,15,11,4
2021,Wolverhampton 005C,E01010557,622,157,107,50,441,110,199,75,74,50,74,34,35,5,55,27,28,3,3,24,11,13
2021,Wolverhampton 005D,E01010559,648,232,91,141,391,45,145,53,54,38,99,44,47,8,96,54,42,6,6,25,10,15
2021,Wolverhampton 005E,E01010560,788,304,144,160,456,58,172,62,69,41,103,47,50,6,118,76,42,5,5,28,12,16
2021,Wolverhampton 006B,E01010501,584,167,67,100,389,49,172,66,71,35,75,28,37,10,90,52,38,3,3,28,17,11
2021,Wolverhampton 006C,E01010502,521,143,70,73,337,28,194,48,87,59,55,28,24,3,56,28,28,4,4,41,25,16
2021,Wolverhampton 006D,E01010503,571,238,84,154,299,22,125,47,49,29,68,36,29,3,82,51,31,2,2,34,18,16
2021,Wolverhampton 006E,E01034310,410,108,47,61,281,7,99,22,58,19,64,27,34,3,108,80,28,3,3,21,13,8
2021,Wolverhampton 006F,E01034311,848,185,27,158,602,19,314,86,193,35,168,93,74,1,93,61,32,8,8,61,37,24
2021,Wolverhampton 007A,E01010482,487,98,57,41,341,35,105,27,44,34,59,11,41,7,138,98,40,4,4,48,35,13
2021,Wolverhampton 007B,E01010483,548,142,78,64,373,15,108,24,57,27,78,17,53,8,171,116,55,1,1,33,19,14
2021,Wolverhampton 007C,E01010484,497,110,57,53,356,28,117,34,53,30,63,15,40,8,143,106,37,5,5,31,15,16
2021,Wolverhampton 007D,E01010485,815,210,78,132,558,22,197,41,131,25,90,21,66,3,240,190,50,9,9,47,33,14
2021,Wolverhampton 008A,E01010458,752,264,107,157,449,35,175,56,72,47,102,46,46,10,134,92,42,3,3,39,20,19
2021,Wolverhampton 008B,E01010459,604,157,69,88,401,48,209,54,94,61,70,26,37,7,74,42,32,0,0,46,23,23
2021,Wolverhampton 008C,E01010460,631,172,88,84,410,59,221,62,91,68,64,24,28,12,66,35,31,0,0,49,23,26
2021,Wolverhampton 008D,E01010461,606,150,97,53,417,62,259,81,109,69,49,21,25,3,47,19,28,0,0,39,21,18
2021,Wolverhampton 008E,E01010566,734,235,133,102,459,49,220,59,103,58,85,24,44,17,100,62,38,5,5,40,26,14
2021,Wolverhampton 009A,E01010539,647,181,59,122,438,29,202,57,100,45,90,43,39,8,110,64,46,7,7,28,16,12
2021,Wolverhampton 009B,E01010540,640,225,119,106,383,106,196,66,94,36,55,33,21,1,26,13,13,0,0,32,15,17
2021,Wolverhampton 009C,E01010542,643,171,67,104,434,41,214,66,110,38,80,34,40,6,96,51,45,3,3,38,18,20
2021,Wolverhampton 009D,E01010544,600,150,92,58,402,81,207,66,89,52,57,34,18,5,56,25,31,1,1,48,33,15
2021,Wolverhampton 009E,E01010545,655,146,60,86,471,70,238,70,113,55,79,36,39,4,80,36,44,4,4,38,23,15
2021,Wolverhampton 010A,E01010554,613,185,107,78,399,82,180,56,69,55,63,32,29,2,73,35,38,1,1,29,15,14
2021,Wolverhampton 010B,E01010558,663,172,116,56,448,104,214,76,80,58,57,28,25,4,72,34,38,1,1,43,27,16
2021,Wolverhampton 010C,E01010562,705,269,121,148,394,71,143,49,59,35,78,29,41,8,96,70,26,6,6,42,27,15
2021,Wolverhampton 010D,E01010563,655,266,126,140,359,43,140,44,55,41,67,23,42,2,107,75,32,2,2,30,15,15
2021,Wolverhampton 010E,E01010567,642,203,78,125,403,40,156,54,56,46,94,25,59,10,110,64,46,3,3,36,22,14
2021,Wolverhampton 011A,E01010478,514,135,33,102,317,10,149,30,97,22,40,15,23,2,104,71,33,14,14,62,33,29
2021,Wolverhampton 011B,E01010479,577,123,54,69,398,46,168,35,83,50,64,21,36,7,115,77,38,5,5,56,38,18
2021,Wolverhampton 011C,E01010480,512,123,47,76,346,18,154,43,78,33,96,21,72,3,76,49,27,2,2,43,27,16
2021,Wolverhampton 011D,E01010486,626,169,64,105,418,17,149,27,90,32,77,28,40,9,167,121,46,8,8,39,28,11
2021,Wolverhampton 012A,E01010474,613,158,100,58,398,45,176,50,74,52,79,22,45,12,94,65,29,4,4,57,28,29
2021,Wolverhampton 012B,E01010561,618,149,108,41,435,86,233,65,117,51,62,28,28,6,54,23,31,0,0,34,21,13
2021,Wolverhampton 012C,E01010564,971,279,53,226,606,32,303,73,174,56,116,51,57,8,144,98,46,11,11,86,48,38
2021,Wolverhampton 012D,E01010565,727,186,102,84,504,103,291,100,116,75,55,28,24,3,53,26,27,2,2,37,20,17
2021,Wolverhampton 013A,E01010522,625,180,38,142,388,13,186,35,130,21,67,33,31,3,116,69,47,6,6,57,34,23
2021,Wolverhampton 013B,E01010523,616,158,55,103,376,23,209,44,98,67,59,23,33,3,74,43,31,11,11,82,41,41
2021,Wolverhampton 013C,E01010524,668,234,58,176,374,16,191,31,118,42,72,13,53,6,91,49,42,4,4,60,34,26
2021,Wolverhampton 013D,E01010525,651,127,35,92,452,13,195,35,135,25,73,28,41,4,128,84,44,43,43,72,33,39
2021,Wolverhampton 014A,E01010546,599,124,66,58,422,101,263,74,119,70,30,14,13,3,26,10,16,2,2,53,33,20
2021,Wolverhampton 014B,E01010547,767,336,225,111,411,128,160,68,63,29,54,31,21,2,64,38,26,5,5,20,11,9
2021,Wolverhampton 014C,E01010548,724,314,212,102,386,91,143,52,64,27,59,24,30,5,90,53,37,3,3,24,12,12
2021,Wolverhampton 014D,E01010549,635,178,95,83,424,73,188,57,81,50,71,28,38,5,89,49,40,3,3,33,21,12
2021,Wolverhampton 014E,E01010553,644,169,100,69,433,88,228,66,105,57,67,38,24,5,48,27,21,2,2,42,23,19
2021,Wolverhampton 015A,E01010471,833,393,94,299,382,20,171,40,104,27,57,26,26,5,122,82,40,12,12,58,38,20
2021,Wolverhampton 015B,E01010472,1012,295,62,233,628,10,241,46,154,41,88,47,36,5,258,197,61,31,31,89,53,36
2021,Wolverhampton 015C,E01010473,965,462,81,381,449,15,176,34,126,16,83,28,51,4,163,115,48,12,12,54,33,21
2021,Wolverhampton 015D,E01010475,645,183,66,117,399,59,186,64,82,40,75,34,34,7,70,35,35,9,9,63,29,34
2021,Wolverhampton 015E,E01010476,874,331,118,213,480,32,178,49,107,22,81,33,38,10,174,124,50,15,15,63,33,30
2021,Wolverhampton 015F,E01010477,690,236,83,153,399,18,167,45,91,31,62,22,39,1,143,91,52,9,9,55,31,24
2021,Wolverhampton 016A,E01010526,496,124,20,104,302,14,138,20,91,27,46,17,24,5,96,64,32,8,8,70,32,38
2021,Wolverhampton 016B,E01010527,705,246,82,164,360,16,183,44,114,25,47,18,21,8,103,66,37,11,11,99,45,54
2021,Wolverhampton 016C,E01010528,491,268,45,223,171,2,64,11,45,8,40,29,11,0,54,34,20,11,11,52,18,34
2021,Wolverhampton 016D,E01010529,670,259,32,227,288,11,122,17,80,25,29,12,15,2,89,59,30,37,37,123,44,79
2021,Wolverhampton 017A,E01010506,829,455,65,390,322,19,131,48,57,26,74,55,16,3,91,67,24,7,7,52,23,29
2021,Wolverhampton 017B,E01010508,818,472,71,401,303,11,115,27,44,44,110,54,56,0,64,40,24,3,3,43,19,24
2021,Wolverhampton 017C,E01010510,725,318,75,243,353,33,155,53,71,31,65,50,14,1,95,48,47,5,5,54,29,25
2021,Wolverhampton 017D,E01010511,670,217,47,170,359,16,179,33,114,32,47,26,20,1,104,66,38,13,13,94,47,47
2021,Wolverhampton 017E,E01010512,617,244,68,176,316,22,144,56,62,26,62,31,29,2,83,63,20,5,5,57,21,36
2021,Wolverhampton 018A,E01010442,534,164,57,107,332,39,121,33,54,34,52,19,30,3,108,62,46,12,12,38,30,8
2021,Wolverhampton 018B,E01010443,627,188,62,126,416,25,140,30,77,33,91,23,53,15,159,120,39,1,1,23,14,9
2021,Wolverhampton 018C,E01010444,554,177,85,92,331,63,146,58,48,40,52,27,19,6,65,38,27,5,5,46,26,20
2021,Wolverhampton 018D,E01010445,489,102,34,68,339,18,119,17,77,25,50,12,31,7,147,96,51,5,5,48,29,19
2021,Wolverhampton 018E,E01010447,850,359,111,248,452,42,214,54,109,51,94,35,52,7,97,63,34,5,5,39,21,18
2021,Wolverhampton 018F,E01010448,757,279,139,140,446,45,169,58,73,38,78,28,42,8,149,95,54,5,5,32,19,13
2021,Wolverhampton 019A,E01010509,729,287,113,174,407,49,152,50,76,26,78,43,32,3,123,83,40,5,5,35,16,19
2021,Wolverhampton 019B,E01010550,655,144,95,49,465,121,268,89,105,74,47,32,11,4,29,13,16,0,0,46,25,21
2021,Wolverhampton 019C,E01010551,774,311,153,158,426,103,201,77,84,40,65,43,20,2,54,25,29,3,3,37,23,14
2021,Wolverhampton 019D,E01010552,801,231,116,115,531,74,229,80,102,47,114,47,58,9,111,63,48,3,3,39,15,24
2021,Wolverhampton 020A,E01010463,742,278,59,219,388,16,172,40,108,24,65,33,28,4,119,80,39,16,16,76,35,41
2021,Wolverhampton 020B,E01010464,887,525,146,379,319,22,113,43,54,16,67,39,25,3,112,62,50,5,5,43,24,19
2021,Wolverhampton 020C,E01010465,591,153,47,106,354,24,158,28,93,37,55,16,37,2,110,71,39,7,7,84,34,50
2021,Wolverhampton 020D,E01010466,537,141,33,108,316,5,155,16,112,27,47,20,25,2,96,70,26,13,13,80,48,32
2021,Wolverhampton 020E,E01010470,703,310,88,222,344,27,159,31,87,41,51,27,20,4,99,65,34,8,8,49,28,21
2021,Wolverhampton 020G,E01034312,580,242,36,206,293,12,75,18,47,10,98,78,18,2,95,59,36,13,13,45,19,26
2021,Wolverhampton 020H,E01034313,593,296,11,285,223,0,99,49,45,5,79,66,12,1,35,27,8,10,10,74,5,69
2021,Wolverhampton 021A,E01010487,607,151,88,63,416,65,242,69,109,64,52,20,26,6,56,32,24,1,1,40,28,12
2021,Wolverhampton 021B,E01010488,631,202,129,73,390,84,196,67,80,49,49,15,31,3,60,33,27,1,1,39,21,18
2021,Wolverhampton 021C,E01010493,622,170,65,105,423,64,244,75,113,56,56,15,37,4,56,32,24,3,3,29,20,9
2021,Wolverhampton 021D,E01010504,585,153,85,68,374,89,217,64,111,42,36,19,16,1,29,13,16,3,3,58,29,29
2021,Wolverhampton 021E,E01010505,503,141,77,64,327,81,155,40,78,37,43,22,15,6,46,17,29,2,2,35,21,14
2021,Wolverhampton 021F,E01010507,618,192,127,65,390,96,204,81,79,44,39,17,17,5,47,26,21,4,4,36,21,15
2021,Wolverhampton 022A,E01010418,576,126,67,59,407,62,238,85,85,68,60,24,30,6,45,26,19,2,2,43,23,20
2021,Wolverhampton 022B,E01010421,589,130,62,68,418,38,180,39,99,42,64,15,43,6,134,88,46,2,2,41,31,10
2021,Wolverhampton 022C,E01010423,654,227,104,123,374,39,150,32,77,41,67,18,41,8,113,65,48,5,5,53,29,24
2021,Wolverhampton 022D,E01010424,592,156,79,77,374,54,193,54,85,54,72,14,47,11,54,34,20,1,1,62,39,23
2021,Wolverhampton 023A,E01010417,695,229,98,131,417,48,139,33,67,39,80,36,38,6,142,77,65,8,8,49,25,24
2021,Wolverhampton 023B,E01010419,672,184,73,111,437,48,174,53,90,31,102,39,52,11,106,67,39,7,7,51,29,22
2021,Wolverhampton 023C,E01010420,526,145,76,69,334,39,147,37,76,34,55,10,41,4,87,53,34,6,6,47,23,24
2021,Wolverhampton 023D,E01010425,514,124,73,51,354,50,169,61,59,49,47,16,28,3,83,39,44,5,5,36,22,14
2021,Wolverhampton 023E,E01010446,696,251,89,162,392,53,170,51,76,43,70,27,38,5,95,56,39,4,4,53,30,23
2021,Wolverhampton 026A,E01010467,630,236,75,161,311,37,155,44,75,36,55,27,23,5,60,35,25,4,4,83,47,36
2021,Wolverhampton 026B,E01010468,603,166,89,77,387,37,200,66,79,55,59,25,32,2,88,46,42,3,3,50,32,18
2021,Wolverhampton 026C,E01010469,626,197,73,124,395,44,196,65,83,48,73,35,28,10,76,41,35,6,6,34,10,24
2021,Wolverhampton 026D,E01010516,516,91,54,37,382,63,218,48,97,73,45,13,30,2,53,15,38,3,3,43,24,19
2021,Wolverhampton 026E,E01010518,630,186,113,73,383,58,236,66,101,69,42,22,13,7,44,16,28,3,3,61,36,25
2021,Wolverhampton 027A,E01010414,997,393,141,252,550,38,238,97,91,50,115,55,52,8,149,108,41,10,10,54,38,16
2021,Wolverhampton 027B,E01010415,600,101,39,62,442,38,183,44,92,47,74,18,46,10,144,92,52,3,3,57,37,20
2021,Wolverhampton 027C,E01010416,743,247,89,158,420,50,174,40,93,41,73,27,38,8,116,73,43,7,7,76,53,23
2021,Wolverhampton 027D,E01010422,726,237,106,131,430,64,228,59,103,66,63,31,28,4,72,37,35,3,3,59,32,27
2021,Wolverhampton 028A,E01010489,657,221,105,116,397,77,184,71,73,40,55,25,27,3,80,43,37,1,1,39,22,17
2021,Wolverhampton 028B,E01010490,938,418,131,287,495,37,128,46,60,22,112,46,55,11,208,160,48,10,10,25,8,17
2021,Wolverhampton 028C,E01010491,610,174,73,101,403,55,170,38,92,40,76,28,40,8,97,53,44,5,5,33,14,19
2021,Wolverhampton 028D,E01010492,509,104,60,44,383,66,219,75,86,58,46,24,17,5,50,24,26,2,2,22,10,12
2021,Wolverhampton 028E,E01010494,602,139,88,51,433,63,239,73,109,57,74,27,43,4,56,34,22,1,1,30,19,11
2021,Wolverhampton 029A,E01010449,936,268,78,190,567,33,261,57,160,44,83,41,37,5,174,105,69,16,16,101,59,42
2021,Wolverhampton 029B,E01010450,1067,335,99,236,645,38,284,84,158,42,136,70,56,10,176,126,50,11,11,87,56,31
2021,Wolverhampton 029C,E01010451,789,189,46,143,542,37,239,70,106,63,131,74,50,7,125,79,46,10,10,58,37,21
2021,Wolverhampton 029D,E01010452,680,228,94,134,405,27,144,33,77,34,78,33,38,7,154,100,54,2,2,47,32,15
2021,Wolverhampton 029E,E01010455,1062,338,88,250,639,34,284,73,163,48,120,47,68,5,161,115,46,40,40,85,52,33
2021,Wolverhampton 030A,E01010427,545,102,44,58,359,53,219,39,111,69,22,8,12,2,58,22,36,7,7,84,59,25
2021,Wolverhampton 030B,E01010431,468,73,41,32,303,38,204,32,90,82,9,1,6,2,44,11,33,8,8,92,62,30
2021,Wolverhampton 030C,E01010432,504,120,56,64,312,40,209,38,91,80,17,5,11,1,44,11,33,2,2,72,48,24
2021,Wolverhampton 030D,E01010519,561,150,66,84,344,59,176,43,74,59,51,26,20,5,55,32,23,3,3,67,39,28
2021,Wolverhampton 030E,E01010520,662,156,96,60,457,92,252,82,110,60,45,25,20,0,62,26,36,6,6,49,30,19
2021,Wolverhampton 031A,E01010513,631,205,140,65,395,98,222,62,107,53,41,25,15,1,34,12,22,0,0,31,19,12
2021,Wolverhampton 031B,E01010514,646,153,72,81,460,70,261,72,132,57,73,38,30,5,50,29,21,6,6,33,22,11
2021,Wolverhampton 031C,E01010515,674,160,88,72,482,83,253,90,111,52,77,30,42,5,68,41,27,1,1,32,20,12
2021,Wolverhampton 031D,E01010517,655,185,80,105,418,47,243,71,117,55,42,16,20,6,79,45,34,7,7,52,31,21
2021,Wolverhampton 032A,E01010533,692,213,78,135,433,25,192,43,105,44,75,22,48,5,135,91,44,6,6,46,31,15
2021,Wolverhampton 032B,E01010535,620,175,76,99,402,36,165,43,81,41,63,20,34,9,132,85,47,6,6,43,25,18
2021,Wolverhampton 032C,E01010536,625,136,104,32,440,86,247,71,107,69,47,12,27,8,58,21,37,2,2,49,34,15
2021,Wolverhampton 032D,E01010537,660,214,133,81,427,112,210,77,79,54,59,29,23,7,46,16,30,0,0,19,14,5
2021,Wolverhampton 033A,E01010410,1049,342,114,228,658,52,257,73,138,46,156,65,80,11,184,128,56,9,9,49,20,29
2021,Wolverhampton 033B,E01010411,796,174,71,103,568,39,304,78,163,63,110,45,54,11,114,76,38,1,1,54,31,23
2021,Wolverhampton 033C,E01010412,836,242,85,157,529,62,221,74,107,40,112,39,67,6,127,84,43,7,7,65,38,27
2021,Wolverhampton 033D,E01010413,691,209,110,99,438,51,167,54,74,39,92,33,49,10,122,67,55,6,6,44,28,16
2021,Wolverhampton 034A,E01010531,712,222,93,129,444,66,162,43,76,43,91,36,48,7,122,75,47,3,3,46,24,22
2021,Wolverhampton 034B,E01010532,667,201,83,118,426,38,170,50,76,44,93,29,55,9,121,81,40,4,4,40,20,20
2021,Wolverhampton 034C,E01010534,477,70,25,45,322,39,213,44,84,85,24,12,12,0,44,20,24,2,2,85,54,31
2021,Wolverhampton 034D,E01010538,622,155,77,78,435,55,216,75,78,63,61,15,38,8,101,57,44,2,2,32,20,12
2021,Wolverhampton 035A,E01010426,541,170,54,116,311,40,152,44,56,52,46,25,20,1,62,31,31,11,11,60,32,28
2021,Wolverhampton 035B,E01010428,547,128,51,77,336,13,171,17,108,46,33,13,18,2,90,59,31,29,29,83,54,29
2021,Wolverhampton 035C,E01010429,476,134,46,88,291,26,159,24,90,45,25,7,16,2,78,47,31,3,3,51,36,15
2021,Wolverhampton 035D,E01010430,688,213,68,145,394,32,186,34,108,44,45,15,21,9,120,66,54,11,11,81,50,31
2021,Wolverhampton 035E,E01010433,498,145,81,64,286,23,154,25,102,27,23,13,7,3,75,45,30,11,11,67,48,19
2021,Wolverhampton 035G,E01010454,623,167,65,102,388,26,184,31,104,49,51,19,26,6,114,55,59,13,13,68,39,29
2021,Wolverhampton 035H,E01010530,660,145,33,112,430,9,210,44,131,35,63,21,34,8,135,98,37,13,13,85,44,41
2021,Wolverhampton 035I,E01034314,643,128,46,82,468,16,188,43,120,25,99,53,41,5,164,130,34,1,1,47,24,23
2021,Wolverhampton 035J,E01034315,431,98,44,54,286,15,152,29,94,29,37,14,20,3,73,47,26,9,9,47,30,17
